station_name,taken_vmag_space,free_vmag_space,total_vmag_space,year,day&month,hour&min
001 Rue Jules Ferry - Gare Saint-Roch,8,4,12,2022,01-16,17:53
002 Com�die,2,22,24,2022,01-16,17:53
003 Esplanade,5,27,32,2022,01-16,17:53
004 H�tel de Ville,12,4,16,2022,01-16,17:53
005 Corum,8,4,12,2022,01-16,17:53
006 Place Albert 1er - St Charles,8,23,31,2022,01-16,17:53
007 Foch,1,7,8,2022,01-16,17:53
008 Halles Castellane,0,12,12,2022,01-16,17:53
009 Observatoire,3,5,8,2022,01-16,17:53
010 Rondelet,3,13,16,2022,01-16,17:53
011 Plan Cabanes,4,8,12,2022,01-16,17:53
012 Boutonnet,1,11,12,2022,01-16,17:53
013 Emile Combes,3,5,8,2022,01-16,17:53
014 Beaux-Arts,5,3,8,2022,01-16,17:53
015 Les Aubes,4,4,8,2022,01-16,17:53
016 Antigone centre,10,6,16,2022,01-16,17:53
017 M�diath�que Emile Zola,3,13,16,2022,01-16,17:53
018 Nombre d'Or,14,2,16,2022,01-16,17:53
019 Louis Blanc,7,9,16,2022,01-16,17:53
020 Gambetta,1,7,8,2022,01-16,17:53
021 Port Marianne,14,2,16,2022,01-16,17:53
022 Clemenceau,3,9,12,2022,01-16,17:53
023 Les Arceaux,3,13,16,2022,01-16,17:53
024 Cit� Mion,4,4,8,2022,01-16,17:53
025 Nouveau Saint-Roch,5,3,8,2022,01-16,17:53
026 Renouvier,0,8,8,2022,01-16,17:53
027 Odysseum,5,3,8,2022,01-16,17:53
028 Saint-Denis,4,4,8,2022,01-16,17:53
029 Richter,6,10,16,2022,01-16,17:53
030 Charles Flahault,7,1,8,2022,01-16,17:53
031 Voltaire,0,8,8,2022,01-16,17:53
032 Pr�s d'Ar�nes,5,3,8,2022,01-16,17:53
033 Garcia Lorca,6,2,8,2022,01-16,17:53
034 Vert Bois,0,16,16,2022,01-16,17:53
035 Malbosc,1,7,8,2022,01-16,17:53
036 Occitanie,5,27,32,2022,01-16,17:53
037 FacdesSciences,12,12,24,2022,01-16,17:53
038 Fac de Lettres,6,10,16,2022,01-16,17:53
039 Aiguelongue,3,5,8,2022,01-16,17:53
040 Jeu de Mail des Abb�s,5,3,8,2022,01-16,17:53
041 Eurom�decine,1,7,8,2022,01-16,17:53
042 Marie Caizergues,2,6,8,2022,01-16,17:53
043 Sabines,3,5,8,2022,01-16,17:53
044 Celleneuve,4,4,8,2022,01-16,17:53
045 Jardin de la Lironde,5,3,8,2022,01-16,17:53
046 P�re Soulas,2,6,8,2022,01-16,17:53
047 Place Viala,1,7,8,2022,01-16,17:53
048 H�tel du D�partement,2,6,8,2022,01-16,17:53
049 Tonnelles,3,5,8,2022,01-16,17:53
050 Parvis Jules Ferry - Gare Saint-Roch,0,8,8,2022,01-16,17:53
051 Pont de Lattes - Gare Saint-Roch,0,12,12,2022,01-16,17:53
053 Deux Ponts - Gare Saint-Roch,2,6,8,2022,01-16,17:53
054 Providence - Ovalie,1,7,8,2022,01-16,17:53
055 P�rols Etang de l'Or,14,54,68,2022,01-16,17:53
056 Albert 1er - Cath�drale,5,7,12,2022,01-16,17:53
057 Saint-Guilhem - Courreau,2,6,8,2022,01-16,17:53
059 Sud De France,2,6,8,2022,01-16,17:53
001 Rue Jules Ferry - Gare Saint-Roch,9,3,12,2022,01-16,18:04
002 Com�die,2,22,24,2022,01-16,18:04
003 Esplanade,5,27,32,2022,01-16,18:04
004 H�tel de Ville,12,4,16,2022,01-16,18:04
005 Corum,8,4,12,2022,01-16,18:04
006 Place Albert 1er - St Charles,7,24,31,2022,01-16,18:04
007 Foch,1,7,8,2022,01-16,18:04
008 Halles Castellane,0,12,12,2022,01-16,18:04
009 Observatoire,3,5,8,2022,01-16,18:04
010 Rondelet,3,13,16,2022,01-16,18:04
011 Plan Cabanes,4,8,12,2022,01-16,18:04
012 Boutonnet,2,10,12,2022,01-16,18:04
013 Emile Combes,3,5,8,2022,01-16,18:04
014 Beaux-Arts,5,3,8,2022,01-16,18:04
015 Les Aubes,4,4,8,2022,01-16,18:04
016 Antigone centre,10,6,16,2022,01-16,18:04
017 M�diath�que Emile Zola,2,14,16,2022,01-16,18:04
018 Nombre d'Or,15,1,16,2022,01-16,18:04
019 Louis Blanc,7,9,16,2022,01-16,18:04
020 Gambetta,1,7,8,2022,01-16,18:04
021 Port Marianne,15,1,16,2022,01-16,18:04
022 Clemenceau,4,8,12,2022,01-16,18:04
023 Les Arceaux,3,13,16,2022,01-16,18:04
024 Cit� Mion,4,4,8,2022,01-16,18:04
025 Nouveau Saint-Roch,5,3,8,2022,01-16,18:04
026 Renouvier,0,8,8,2022,01-16,18:04
027 Odysseum,2,6,8,2022,01-16,18:04
028 Saint-Denis,4,4,8,2022,01-16,18:04
029 Richter,6,10,16,2022,01-16,18:04
030 Charles Flahault,7,1,8,2022,01-16,18:04
031 Voltaire,0,8,8,2022,01-16,18:04
032 Pr�s d'Ar�nes,5,3,8,2022,01-16,18:04
033 Garcia Lorca,6,2,8,2022,01-16,18:04
034 Vert Bois,0,16,16,2022,01-16,18:04
035 Malbosc,1,7,8,2022,01-16,18:04
036 Occitanie,4,28,32,2022,01-16,18:04
037 FacdesSciences,11,13,24,2022,01-16,18:04
038 Fac de Lettres,6,10,16,2022,01-16,18:04
039 Aiguelongue,5,3,8,2022,01-16,18:04
040 Jeu de Mail des Abb�s,5,3,8,2022,01-16,18:04
041 Eurom�decine,1,7,8,2022,01-16,18:04
042 Marie Caizergues,2,6,8,2022,01-16,18:04
043 Sabines,3,5,8,2022,01-16,18:04
044 Celleneuve,4,4,8,2022,01-16,18:04
045 Jardin de la Lironde,5,3,8,2022,01-16,18:04
046 P�re Soulas,2,6,8,2022,01-16,18:04
047 Place Viala,0,8,8,2022,01-16,18:04
048 H�tel du D�partement,2,6,8,2022,01-16,18:04
049 Tonnelles,3,5,8,2022,01-16,18:04
050 Parvis Jules Ferry - Gare Saint-Roch,0,8,8,2022,01-16,18:04
051 Pont de Lattes - Gare Saint-Roch,0,12,12,2022,01-16,18:04
053 Deux Ponts - Gare Saint-Roch,2,6,8,2022,01-16,18:04
054 Providence - Ovalie,1,7,8,2022,01-16,18:04
055 P�rols Etang de l'Or,13,55,68,2022,01-16,18:04
056 Albert 1er - Cath�drale,4,8,12,2022,01-16,18:04
057 Saint-Guilhem - Courreau,2,6,8,2022,01-16,18:04
059 Sud De France,2,6,8,2022,01-16,18:04
001 Rue Jules Ferry - Gare Saint-Roch,9,3,12,2022,01-16,18:14
002 Com�die,2,22,24,2022,01-16,18:14
003 Esplanade,5,27,32,2022,01-16,18:14
004 H�tel de Ville,12,4,16,2022,01-16,18:14
005 Corum,8,4,12,2022,01-16,18:14
006 Place Albert 1er - St Charles,7,24,31,2022,01-16,18:14
007 Foch,3,5,8,2022,01-16,18:14
008 Halles Castellane,0,12,12,2022,01-16,18:14
009 Observatoire,3,5,8,2022,01-16,18:14
010 Rondelet,3,13,16,2022,01-16,18:14
011 Plan Cabanes,4,8,12,2022,01-16,18:14
012 Boutonnet,2,10,12,2022,01-16,18:14
013 Emile Combes,3,5,8,2022,01-16,18:14
014 Beaux-Arts,5,3,8,2022,01-16,18:14
015 Les Aubes,4,4,8,2022,01-16,18:14
016 Antigone centre,10,6,16,2022,01-16,18:14
017 M�diath�que Emile Zola,2,14,16,2022,01-16,18:14
018 Nombre d'Or,15,1,16,2022,01-16,18:14
019 Louis Blanc,7,9,16,2022,01-16,18:14
020 Gambetta,1,7,8,2022,01-16,18:14
021 Port Marianne,16,0,16,2022,01-16,18:14
022 Clemenceau,5,7,12,2022,01-16,18:14
023 Les Arceaux,3,13,16,2022,01-16,18:14
024 Cit� Mion,4,4,8,2022,01-16,18:14
025 Nouveau Saint-Roch,5,3,8,2022,01-16,18:14
026 Renouvier,1,7,8,2022,01-16,18:14
027 Odysseum,2,6,8,2022,01-16,18:14
028 Saint-Denis,5,3,8,2022,01-16,18:14
029 Richter,6,10,16,2022,01-16,18:14
030 Charles Flahault,7,1,8,2022,01-16,18:14
031 Voltaire,0,8,8,2022,01-16,18:14
032 Pr�s d'Ar�nes,5,3,8,2022,01-16,18:14
033 Garcia Lorca,8,0,8,2022,01-16,18:14
034 Vert Bois,0,16,16,2022,01-16,18:14
035 Malbosc,1,7,8,2022,01-16,18:14
036 Occitanie,4,28,32,2022,01-16,18:14
037 FacdesSciences,11,13,24,2022,01-16,18:14
038 Fac de Lettres,6,10,16,2022,01-16,18:14
039 Aiguelongue,5,3,8,2022,01-16,18:14
040 Jeu de Mail des Abb�s,5,3,8,2022,01-16,18:14
041 Eurom�decine,1,7,8,2022,01-16,18:14
042 Marie Caizergues,2,6,8,2022,01-16,18:14
043 Sabines,3,5,8,2022,01-16,18:14
044 Celleneuve,4,4,8,2022,01-16,18:14
045 Jardin de la Lironde,5,3,8,2022,01-16,18:14
046 P�re Soulas,2,6,8,2022,01-16,18:14
047 Place Viala,1,7,8,2022,01-16,18:14
048 H�tel du D�partement,2,6,8,2022,01-16,18:14
049 Tonnelles,3,5,8,2022,01-16,18:14
050 Parvis Jules Ferry - Gare Saint-Roch,1,7,8,2022,01-16,18:14
051 Pont de Lattes - Gare Saint-Roch,0,12,12,2022,01-16,18:14
053 Deux Ponts - Gare Saint-Roch,2,6,8,2022,01-16,18:14
054 Providence - Ovalie,1,7,8,2022,01-16,18:14
055 P�rols Etang de l'Or,19,49,68,2022,01-16,18:14
056 Albert 1er - Cath�drale,4,8,12,2022,01-16,18:14
057 Saint-Guilhem - Courreau,2,6,8,2022,01-16,18:14
059 Sud De France,2,6,8,2022,01-16,18:14
001 Rue Jules Ferry - Gare Saint-Roch,9,3,12,2022,01-16,18:24
002 Com�die,2,22,24,2022,01-16,18:24
003 Esplanade,5,27,32,2022,01-16,18:24
004 H�tel de Ville,12,4,16,2022,01-16,18:24
005 Corum,8,4,12,2022,01-16,18:24
006 Place Albert 1er - St Charles,7,24,31,2022,01-16,18:24
007 Foch,3,5,8,2022,01-16,18:24
008 Halles Castellane,0,12,12,2022,01-16,18:24
009 Observatoire,3,5,8,2022,01-16,18:24
010 Rondelet,3,13,16,2022,01-16,18:24
011 Plan Cabanes,4,8,12,2022,01-16,18:24
012 Boutonnet,2,10,12,2022,01-16,18:24
013 Emile Combes,3,5,8,2022,01-16,18:24
014 Beaux-Arts,7,1,8,2022,01-16,18:24
015 Les Aubes,4,4,8,2022,01-16,18:24
016 Antigone centre,11,5,16,2022,01-16,18:24
017 M�diath�que Emile Zola,3,13,16,2022,01-16,18:24
018 Nombre d'Or,15,1,16,2022,01-16,18:24
019 Louis Blanc,7,9,16,2022,01-16,18:24
020 Gambetta,1,7,8,2022,01-16,18:24
021 Port Marianne,16,0,16,2022,01-16,18:24
022 Clemenceau,5,7,12,2022,01-16,18:24
023 Les Arceaux,3,13,16,2022,01-16,18:24
024 Cit� Mion,4,4,8,2022,01-16,18:24
025 Nouveau Saint-Roch,5,3,8,2022,01-16,18:24
026 Renouvier,1,7,8,2022,01-16,18:24
027 Odysseum,2,6,8,2022,01-16,18:24
028 Saint-Denis,5,3,8,2022,01-16,18:24
029 Richter,6,10,16,2022,01-16,18:24
030 Charles Flahault,7,1,8,2022,01-16,18:24
031 Voltaire,0,8,8,2022,01-16,18:24
032 Pr�s d'Ar�nes,5,3,8,2022,01-16,18:24
033 Garcia Lorca,8,0,8,2022,01-16,18:24
034 Vert Bois,0,16,16,2022,01-16,18:24
035 Malbosc,1,7,8,2022,01-16,18:24
036 Occitanie,4,28,32,2022,01-16,18:24
037 FacdesSciences,11,13,24,2022,01-16,18:24
038 Fac de Lettres,6,10,16,2022,01-16,18:24
039 Aiguelongue,5,3,8,2022,01-16,18:24
040 Jeu de Mail des Abb�s,5,3,8,2022,01-16,18:24
041 Eurom�decine,1,7,8,2022,01-16,18:24
042 Marie Caizergues,2,6,8,2022,01-16,18:24
043 Sabines,3,5,8,2022,01-16,18:24
044 Celleneuve,4,4,8,2022,01-16,18:24
045 Jardin de la Lironde,5,3,8,2022,01-16,18:24
046 P�re Soulas,2,6,8,2022,01-16,18:24
047 Place Viala,1,7,8,2022,01-16,18:24
048 H�tel du D�partement,2,6,8,2022,01-16,18:24
049 Tonnelles,2,6,8,2022,01-16,18:24
050 Parvis Jules Ferry - Gare Saint-Roch,1,7,8,2022,01-16,18:24
051 Pont de Lattes - Gare Saint-Roch,0,12,12,2022,01-16,18:24
053 Deux Ponts - Gare Saint-Roch,2,6,8,2022,01-16,18:24
054 Providence - Ovalie,1,7,8,2022,01-16,18:24
055 P�rols Etang de l'Or,19,49,68,2022,01-16,18:24
056 Albert 1er - Cath�drale,4,8,12,2022,01-16,18:24
057 Saint-Guilhem - Courreau,2,6,8,2022,01-16,18:24
059 Sud De France,2,6,8,2022,01-16,18:24
001 Rue Jules Ferry - Gare Saint-Roch,9,3,12,2022,01-16,18:34
002 Com�die,5,19,24,2022,01-16,18:34
003 Esplanade,5,27,32,2022,01-16,18:34
004 H�tel de Ville,13,3,16,2022,01-16,18:34
005 Corum,7,5,12,2022,01-16,18:34
006 Place Albert 1er - St Charles,8,23,31,2022,01-16,18:34
007 Foch,3,5,8,2022,01-16,18:34
008 Halles Castellane,0,12,12,2022,01-16,18:34
009 Observatoire,3,5,8,2022,01-16,18:34
010 Rondelet,3,13,16,2022,01-16,18:34
011 Plan Cabanes,3,9,12,2022,01-16,18:34
012 Boutonnet,2,10,12,2022,01-16,18:34
013 Emile Combes,3,5,8,2022,01-16,18:34
014 Beaux-Arts,7,1,8,2022,01-16,18:34
015 Les Aubes,5,3,8,2022,01-16,18:34
016 Antigone centre,12,4,16,2022,01-16,18:34
017 M�diath�que Emile Zola,3,13,16,2022,01-16,18:34
018 Nombre d'Or,15,1,16,2022,01-16,18:34
019 Louis Blanc,7,9,16,2022,01-16,18:34
020 Gambetta,1,7,8,2022,01-16,18:34
021 Port Marianne,16,0,16,2022,01-16,18:34
022 Clemenceau,5,7,12,2022,01-16,18:34
023 Les Arceaux,3,13,16,2022,01-16,18:34
024 Cit� Mion,2,6,8,2022,01-16,18:34
025 Nouveau Saint-Roch,5,3,8,2022,01-16,18:34
026 Renouvier,1,7,8,2022,01-16,18:34
027 Odysseum,2,6,8,2022,01-16,18:34
028 Saint-Denis,6,2,8,2022,01-16,18:34
029 Richter,7,9,16,2022,01-16,18:34
030 Charles Flahault,7,1,8,2022,01-16,18:34
031 Voltaire,0,8,8,2022,01-16,18:34
032 Pr�s d'Ar�nes,5,3,8,2022,01-16,18:34
033 Garcia Lorca,8,0,8,2022,01-16,18:34
034 Vert Bois,0,16,16,2022,01-16,18:34
035 Malbosc,1,7,8,2022,01-16,18:34
036 Occitanie,4,28,32,2022,01-16,18:34
037 FacdesSciences,11,13,24,2022,01-16,18:34
038 Fac de Lettres,6,10,16,2022,01-16,18:34
039 Aiguelongue,5,3,8,2022,01-16,18:34
040 Jeu de Mail des Abb�s,5,3,8,2022,01-16,18:34
041 Eurom�decine,1,7,8,2022,01-16,18:34
042 Marie Caizergues,2,6,8,2022,01-16,18:34
043 Sabines,3,5,8,2022,01-16,18:34
044 Celleneuve,4,4,8,2022,01-16,18:34
045 Jardin de la Lironde,5,3,8,2022,01-16,18:34
046 P�re Soulas,3,5,8,2022,01-16,18:34
047 Place Viala,1,7,8,2022,01-16,18:34
048 H�tel du D�partement,2,6,8,2022,01-16,18:34
049 Tonnelles,2,6,8,2022,01-16,18:34
050 Parvis Jules Ferry - Gare Saint-Roch,1,7,8,2022,01-16,18:34
051 Pont de Lattes - Gare Saint-Roch,0,12,12,2022,01-16,18:34
053 Deux Ponts - Gare Saint-Roch,2,6,8,2022,01-16,18:34
054 Providence - Ovalie,1,7,8,2022,01-16,18:34
055 P�rols Etang de l'Or,18,50,68,2022,01-16,18:34
056 Albert 1er - Cath�drale,4,8,12,2022,01-16,18:34
057 Saint-Guilhem - Courreau,2,6,8,2022,01-16,18:34
059 Sud De France,2,6,8,2022,01-16,18:34
001 Rue Jules Ferry - Gare Saint-Roch,9,3,12,2022,01-16,18:44
002 Com�die,5,19,24,2022,01-16,18:44
003 Esplanade,5,27,32,2022,01-16,18:44
004 H�tel de Ville,13,3,16,2022,01-16,18:44
005 Corum,8,4,12,2022,01-16,18:44
006 Place Albert 1er - St Charles,8,23,31,2022,01-16,18:44
007 Foch,3,5,8,2022,01-16,18:44
008 Halles Castellane,0,12,12,2022,01-16,18:44
009 Observatoire,3,5,8,2022,01-16,18:44
010 Rondelet,3,13,16,2022,01-16,18:44
011 Plan Cabanes,3,9,12,2022,01-16,18:44
012 Boutonnet,2,10,12,2022,01-16,18:44
013 Emile Combes,3,5,8,2022,01-16,18:44
014 Beaux-Arts,7,1,8,2022,01-16,18:44
015 Les Aubes,5,3,8,2022,01-16,18:44
016 Antigone centre,12,4,16,2022,01-16,18:44
017 M�diath�que Emile Zola,3,13,16,2022,01-16,18:44
018 Nombre d'Or,16,0,16,2022,01-16,18:44
019 Louis Blanc,8,8,16,2022,01-16,18:44
020 Gambetta,1,7,8,2022,01-16,18:44
021 Port Marianne,16,0,16,2022,01-16,18:44
022 Clemenceau,5,7,12,2022,01-16,18:44
023 Les Arceaux,3,13,16,2022,01-16,18:44
024 Cit� Mion,2,6,8,2022,01-16,18:44
025 Nouveau Saint-Roch,5,3,8,2022,01-16,18:44
026 Renouvier,1,7,8,2022,01-16,18:44
027 Odysseum,2,6,8,2022,01-16,18:44
028 Saint-Denis,7,1,8,2022,01-16,18:44
029 Richter,7,9,16,2022,01-16,18:44
030 Charles Flahault,7,1,8,2022,01-16,18:44
031 Voltaire,0,8,8,2022,01-16,18:44
032 Pr�s d'Ar�nes,5,3,8,2022,01-16,18:44
033 Garcia Lorca,8,0,8,2022,01-16,18:44
034 Vert Bois,0,16,16,2022,01-16,18:44
035 Malbosc,1,7,8,2022,01-16,18:44
036 Occitanie,4,28,32,2022,01-16,18:44
037 FacdesSciences,11,13,24,2022,01-16,18:44
038 Fac de Lettres,6,10,16,2022,01-16,18:44
039 Aiguelongue,5,3,8,2022,01-16,18:44
040 Jeu de Mail des Abb�s,5,3,8,2022,01-16,18:44
041 Eurom�decine,1,7,8,2022,01-16,18:44
042 Marie Caizergues,1,7,8,2022,01-16,18:44
043 Sabines,3,5,8,2022,01-16,18:44
044 Celleneuve,4,4,8,2022,01-16,18:44
045 Jardin de la Lironde,5,3,8,2022,01-16,18:44
046 P�re Soulas,3,5,8,2022,01-16,18:44
047 Place Viala,1,7,8,2022,01-16,18:44
048 H�tel du D�partement,2,6,8,2022,01-16,18:44
049 Tonnelles,3,5,8,2022,01-16,18:44
050 Parvis Jules Ferry - Gare Saint-Roch,1,7,8,2022,01-16,18:44
051 Pont de Lattes - Gare Saint-Roch,0,12,12,2022,01-16,18:44
053 Deux Ponts - Gare Saint-Roch,2,6,8,2022,01-16,18:44
054 Providence - Ovalie,1,7,8,2022,01-16,18:44
055 P�rols Etang de l'Or,20,48,68,2022,01-16,18:44
056 Albert 1er - Cath�drale,4,8,12,2022,01-16,18:44
057 Saint-Guilhem - Courreau,2,6,8,2022,01-16,18:44
059 Sud De France,2,6,8,2022,01-16,18:44
001 Rue Jules Ferry - Gare Saint-Roch,9,3,12,2022,01-16,18:54
002 Com�die,5,19,24,2022,01-16,18:54
003 Esplanade,5,27,32,2022,01-16,18:54
004 H�tel de Ville,13,3,16,2022,01-16,18:54
005 Corum,8,4,12,2022,01-16,18:54
006 Place Albert 1er - St Charles,12,19,31,2022,01-16,18:54
007 Foch,3,5,8,2022,01-16,18:54
008 Halles Castellane,0,12,12,2022,01-16,18:54
009 Observatoire,4,4,8,2022,01-16,18:54
010 Rondelet,3,13,16,2022,01-16,18:54
011 Plan Cabanes,3,9,12,2022,01-16,18:54
012 Boutonnet,2,10,12,2022,01-16,18:54
013 Emile Combes,3,5,8,2022,01-16,18:54
014 Beaux-Arts,7,1,8,2022,01-16,18:54
015 Les Aubes,5,3,8,2022,01-16,18:54
016 Antigone centre,13,3,16,2022,01-16,18:54
017 M�diath�que Emile Zola,6,10,16,2022,01-16,18:54
018 Nombre d'Or,14,2,16,2022,01-16,18:54
019 Louis Blanc,8,8,16,2022,01-16,18:54
020 Gambetta,1,7,8,2022,01-16,18:54
021 Port Marianne,16,0,16,2022,01-16,18:54
022 Clemenceau,5,7,12,2022,01-16,18:54
023 Les Arceaux,3,13,16,2022,01-16,18:54
024 Cit� Mion,2,6,8,2022,01-16,18:54
025 Nouveau Saint-Roch,5,3,8,2022,01-16,18:54
026 Renouvier,1,7,8,2022,01-16,18:54
027 Odysseum,2,6,8,2022,01-16,18:54
028 Saint-Denis,7,1,8,2022,01-16,18:54
029 Richter,7,9,16,2022,01-16,18:54
030 Charles Flahault,7,1,8,2022,01-16,18:54
031 Voltaire,0,8,8,2022,01-16,18:54
032 Pr�s d'Ar�nes,5,3,8,2022,01-16,18:54
033 Garcia Lorca,8,0,8,2022,01-16,18:54
034 Vert Bois,0,16,16,2022,01-16,18:54
035 Malbosc,1,7,8,2022,01-16,18:54
036 Occitanie,4,28,32,2022,01-16,18:54
037 FacdesSciences,11,13,24,2022,01-16,18:54
038 Fac de Lettres,6,10,16,2022,01-16,18:54
039 Aiguelongue,5,3,8,2022,01-16,18:54
040 Jeu de Mail des Abb�s,5,3,8,2022,01-16,18:54
041 Eurom�decine,1,7,8,2022,01-16,18:54
042 Marie Caizergues,1,7,8,2022,01-16,18:54
043 Sabines,3,5,8,2022,01-16,18:54
044 Celleneuve,4,4,8,2022,01-16,18:54
045 Jardin de la Lironde,5,3,8,2022,01-16,18:54
046 P�re Soulas,1,7,8,2022,01-16,18:54
047 Place Viala,1,7,8,2022,01-16,18:54
048 H�tel du D�partement,2,6,8,2022,01-16,18:54
049 Tonnelles,3,5,8,2022,01-16,18:54
050 Parvis Jules Ferry - Gare Saint-Roch,1,7,8,2022,01-16,18:54
051 Pont de Lattes - Gare Saint-Roch,0,12,12,2022,01-16,18:54
053 Deux Ponts - Gare Saint-Roch,2,6,8,2022,01-16,18:54
054 Providence - Ovalie,1,7,8,2022,01-16,18:54
055 P�rols Etang de l'Or,23,45,68,2022,01-16,18:54
056 Albert 1er - Cath�drale,4,8,12,2022,01-16,18:54
057 Saint-Guilhem - Courreau,2,6,8,2022,01-16,18:54
059 Sud De France,2,6,8,2022,01-16,18:54
001 Rue Jules Ferry - Gare Saint-Roch,9,3,12,2022,01-16,19:05
002 Com�die,5,19,24,2022,01-16,19:05
003 Esplanade,7,25,32,2022,01-16,19:05
004 H�tel de Ville,13,3,16,2022,01-16,19:05
005 Corum,8,4,12,2022,01-16,19:05
006 Place Albert 1er - St Charles,12,19,31,2022,01-16,19:05
007 Foch,3,5,8,2022,01-16,19:05
008 Halles Castellane,0,12,12,2022,01-16,19:05
009 Observatoire,4,4,8,2022,01-16,19:05
010 Rondelet,3,13,16,2022,01-16,19:05
011 Plan Cabanes,3,9,12,2022,01-16,19:05
012 Boutonnet,3,9,12,2022,01-16,19:05
013 Emile Combes,3,5,8,2022,01-16,19:05
014 Beaux-Arts,7,1,8,2022,01-16,19:05
015 Les Aubes,5,3,8,2022,01-16,19:05
016 Antigone centre,13,3,16,2022,01-16,19:05
017 M�diath�que Emile Zola,7,9,16,2022,01-16,19:05
018 Nombre d'Or,14,2,16,2022,01-16,19:05
019 Louis Blanc,8,8,16,2022,01-16,19:05
020 Gambetta,1,7,8,2022,01-16,19:05
021 Port Marianne,16,0,16,2022,01-16,19:05
022 Clemenceau,5,7,12,2022,01-16,19:05
023 Les Arceaux,2,14,16,2022,01-16,19:05
024 Cit� Mion,2,6,8,2022,01-16,19:05
025 Nouveau Saint-Roch,5,3,8,2022,01-16,19:05
026 Renouvier,1,7,8,2022,01-16,19:05
027 Odysseum,2,6,8,2022,01-16,19:05
028 Saint-Denis,7,1,8,2022,01-16,19:05
029 Richter,7,9,16,2022,01-16,19:05
030 Charles Flahault,7,1,8,2022,01-16,19:05
031 Voltaire,0,8,8,2022,01-16,19:05
032 Pr�s d'Ar�nes,5,3,8,2022,01-16,19:05
033 Garcia Lorca,8,0,8,2022,01-16,19:05
034 Vert Bois,0,16,16,2022,01-16,19:05
035 Malbosc,1,7,8,2022,01-16,19:05
036 Occitanie,4,28,32,2022,01-16,19:05
037 FacdesSciences,10,14,24,2022,01-16,19:05
038 Fac de Lettres,6,10,16,2022,01-16,19:05
039 Aiguelongue,5,3,8,2022,01-16,19:05
040 Jeu de Mail des Abb�s,5,3,8,2022,01-16,19:05
041 Eurom�decine,1,7,8,2022,01-16,19:05
042 Marie Caizergues,1,7,8,2022,01-16,19:05
043 Sabines,3,5,8,2022,01-16,19:05
044 Celleneuve,4,4,8,2022,01-16,19:05
045 Jardin de la Lironde,5,3,8,2022,01-16,19:05
046 P�re Soulas,1,7,8,2022,01-16,19:05
047 Place Viala,1,7,8,2022,01-16,19:05
048 H�tel du D�partement,2,6,8,2022,01-16,19:05
049 Tonnelles,3,5,8,2022,01-16,19:05
050 Parvis Jules Ferry - Gare Saint-Roch,1,7,8,2022,01-16,19:05
051 Pont de Lattes - Gare Saint-Roch,0,12,12,2022,01-16,19:05
053 Deux Ponts - Gare Saint-Roch,2,6,8,2022,01-16,19:05
054 Providence - Ovalie,1,7,8,2022,01-16,19:05
055 P�rols Etang de l'Or,23,45,68,2022,01-16,19:05
056 Albert 1er - Cath�drale,4,8,12,2022,01-16,19:05
057 Saint-Guilhem - Courreau,2,6,8,2022,01-16,19:05
059 Sud De France,2,6,8,2022,01-16,19:05
001 Rue Jules Ferry - Gare Saint-Roch,9,3,12,2022,01-16,19:15
002 Com�die,2,22,24,2022,01-16,19:15
003 Esplanade,5,27,32,2022,01-16,19:15
004 H�tel de Ville,13,3,16,2022,01-16,19:15
005 Corum,9,3,12,2022,01-16,19:15
006 Place Albert 1er - St Charles,12,19,31,2022,01-16,19:15
007 Foch,3,5,8,2022,01-16,19:15
008 Halles Castellane,0,12,12,2022,01-16,19:15
009 Observatoire,4,4,8,2022,01-16,19:15
010 Rondelet,3,13,16,2022,01-16,19:15
011 Plan Cabanes,3,9,12,2022,01-16,19:15
012 Boutonnet,3,9,12,2022,01-16,19:15
013 Emile Combes,3,5,8,2022,01-16,19:15
014 Beaux-Arts,7,1,8,2022,01-16,19:15
015 Les Aubes,5,3,8,2022,01-16,19:15
016 Antigone centre,13,3,16,2022,01-16,19:15
017 M�diath�que Emile Zola,7,9,16,2022,01-16,19:15
018 Nombre d'Or,14,2,16,2022,01-16,19:15
019 Louis Blanc,9,7,16,2022,01-16,19:15
020 Gambetta,1,7,8,2022,01-16,19:15
021 Port Marianne,16,0,16,2022,01-16,19:15
022 Clemenceau,3,9,12,2022,01-16,19:15
023 Les Arceaux,2,14,16,2022,01-16,19:15
024 Cit� Mion,2,6,8,2022,01-16,19:15
025 Nouveau Saint-Roch,6,2,8,2022,01-16,19:15
026 Renouvier,1,7,8,2022,01-16,19:15
027 Odysseum,2,6,8,2022,01-16,19:15
028 Saint-Denis,7,1,8,2022,01-16,19:15
029 Richter,7,9,16,2022,01-16,19:15
030 Charles Flahault,7,1,8,2022,01-16,19:15
031 Voltaire,0,8,8,2022,01-16,19:15
032 Pr�s d'Ar�nes,5,3,8,2022,01-16,19:15
033 Garcia Lorca,8,0,8,2022,01-16,19:15
034 Vert Bois,0,16,16,2022,01-16,19:15
035 Malbosc,1,7,8,2022,01-16,19:15
036 Occitanie,4,28,32,2022,01-16,19:15
037 FacdesSciences,10,14,24,2022,01-16,19:15
038 Fac de Lettres,6,10,16,2022,01-16,19:15
039 Aiguelongue,5,3,8,2022,01-16,19:15
040 Jeu de Mail des Abb�s,5,3,8,2022,01-16,19:15
041 Eurom�decine,1,7,8,2022,01-16,19:15
042 Marie Caizergues,1,7,8,2022,01-16,19:15
043 Sabines,3,5,8,2022,01-16,19:15
044 Celleneuve,4,4,8,2022,01-16,19:15
045 Jardin de la Lironde,5,3,8,2022,01-16,19:15
046 P�re Soulas,1,7,8,2022,01-16,19:15
047 Place Viala,1,7,8,2022,01-16,19:15
048 H�tel du D�partement,2,6,8,2022,01-16,19:15
049 Tonnelles,3,5,8,2022,01-16,19:15
050 Parvis Jules Ferry - Gare Saint-Roch,1,7,8,2022,01-16,19:15
051 Pont de Lattes - Gare Saint-Roch,0,12,12,2022,01-16,19:15
053 Deux Ponts - Gare Saint-Roch,2,6,8,2022,01-16,19:15
054 Providence - Ovalie,1,7,8,2022,01-16,19:15
055 P�rols Etang de l'Or,24,44,68,2022,01-16,19:15
056 Albert 1er - Cath�drale,4,8,12,2022,01-16,19:15
057 Saint-Guilhem - Courreau,2,6,8,2022,01-16,19:15
059 Sud De France,2,6,8,2022,01-16,19:15
001 Rue Jules Ferry - Gare Saint-Roch,9,3,12,2022,01-16,19:25
002 Com�die,2,22,24,2022,01-16,19:25
003 Esplanade,5,27,32,2022,01-16,19:25
004 H�tel de Ville,13,3,16,2022,01-16,19:25
005 Corum,9,3,12,2022,01-16,19:25
006 Place Albert 1er - St Charles,12,19,31,2022,01-16,19:25
007 Foch,3,5,8,2022,01-16,19:25
008 Halles Castellane,0,12,12,2022,01-16,19:25
009 Observatoire,4,4,8,2022,01-16,19:25
010 Rondelet,3,13,16,2022,01-16,19:25
011 Plan Cabanes,3,9,12,2022,01-16,19:25
012 Boutonnet,3,9,12,2022,01-16,19:25
013 Emile Combes,4,4,8,2022,01-16,19:25
014 Beaux-Arts,7,1,8,2022,01-16,19:25
015 Les Aubes,5,3,8,2022,01-16,19:25
016 Antigone centre,13,3,16,2022,01-16,19:25
017 M�diath�que Emile Zola,7,9,16,2022,01-16,19:25
018 Nombre d'Or,14,2,16,2022,01-16,19:25
019 Louis Blanc,9,7,16,2022,01-16,19:25
020 Gambetta,1,7,8,2022,01-16,19:25
021 Port Marianne,16,0,16,2022,01-16,19:25
022 Clemenceau,3,9,12,2022,01-16,19:25
023 Les Arceaux,2,14,16,2022,01-16,19:25
024 Cit� Mion,3,5,8,2022,01-16,19:25
025 Nouveau Saint-Roch,6,2,8,2022,01-16,19:25
026 Renouvier,1,7,8,2022,01-16,19:25
027 Odysseum,2,6,8,2022,01-16,19:25
028 Saint-Denis,7,1,8,2022,01-16,19:25
029 Richter,7,9,16,2022,01-16,19:25
030 Charles Flahault,7,1,8,2022,01-16,19:25
031 Voltaire,0,8,8,2022,01-16,19:25
032 Pr�s d'Ar�nes,5,3,8,2022,01-16,19:25
033 Garcia Lorca,8,0,8,2022,01-16,19:25
034 Vert Bois,0,16,16,2022,01-16,19:25
035 Malbosc,1,7,8,2022,01-16,19:25
036 Occitanie,4,28,32,2022,01-16,19:25
037 FacdesSciences,10,14,24,2022,01-16,19:25
038 Fac de Lettres,6,10,16,2022,01-16,19:25
039 Aiguelongue,5,3,8,2022,01-16,19:25
040 Jeu de Mail des Abb�s,5,3,8,2022,01-16,19:25
041 Eurom�decine,1,7,8,2022,01-16,19:25
042 Marie Caizergues,1,7,8,2022,01-16,19:25
043 Sabines,3,5,8,2022,01-16,19:25
044 Celleneuve,4,4,8,2022,01-16,19:25
045 Jardin de la Lironde,5,3,8,2022,01-16,19:25
046 P�re Soulas,1,7,8,2022,01-16,19:25
047 Place Viala,1,7,8,2022,01-16,19:25
048 H�tel du D�partement,2,6,8,2022,01-16,19:25
049 Tonnelles,3,5,8,2022,01-16,19:25
050 Parvis Jules Ferry - Gare Saint-Roch,1,7,8,2022,01-16,19:25
051 Pont de Lattes - Gare Saint-Roch,0,12,12,2022,01-16,19:25
053 Deux Ponts - Gare Saint-Roch,2,6,8,2022,01-16,19:25
054 Providence - Ovalie,1,7,8,2022,01-16,19:25
055 P�rols Etang de l'Or,28,40,68,2022,01-16,19:25
056 Albert 1er - Cath�drale,4,8,12,2022,01-16,19:25
057 Saint-Guilhem - Courreau,2,6,8,2022,01-16,19:25
059 Sud De France,2,6,8,2022,01-16,19:25
001 Rue Jules Ferry - Gare Saint-Roch,8,4,12,2022,01-16,19:35
002 Com�die,2,22,24,2022,01-16,19:35
003 Esplanade,5,27,32,2022,01-16,19:35
004 H�tel de Ville,13,3,16,2022,01-16,19:35
005 Corum,9,3,12,2022,01-16,19:35
006 Place Albert 1er - St Charles,12,19,31,2022,01-16,19:35
007 Foch,3,5,8,2022,01-16,19:35
008 Halles Castellane,0,12,12,2022,01-16,19:35
009 Observatoire,4,4,8,2022,01-16,19:35
010 Rondelet,3,13,16,2022,01-16,19:35
011 Plan Cabanes,4,8,12,2022,01-16,19:35
012 Boutonnet,3,9,12,2022,01-16,19:35
013 Emile Combes,4,4,8,2022,01-16,19:35
014 Beaux-Arts,7,1,8,2022,01-16,19:35
015 Les Aubes,5,3,8,2022,01-16,19:35
016 Antigone centre,13,3,16,2022,01-16,19:35
017 M�diath�que Emile Zola,7,9,16,2022,01-16,19:35
018 Nombre d'Or,15,1,16,2022,01-16,19:35
019 Louis Blanc,10,6,16,2022,01-16,19:35
020 Gambetta,1,7,8,2022,01-16,19:35
021 Port Marianne,16,0,16,2022,01-16,19:35
022 Clemenceau,3,9,12,2022,01-16,19:35
023 Les Arceaux,1,15,16,2022,01-16,19:35
024 Cit� Mion,3,5,8,2022,01-16,19:35
025 Nouveau Saint-Roch,6,2,8,2022,01-16,19:35
026 Renouvier,2,6,8,2022,01-16,19:35
027 Odysseum,2,6,8,2022,01-16,19:35
028 Saint-Denis,8,0,8,2022,01-16,19:35
029 Richter,7,9,16,2022,01-16,19:35
030 Charles Flahault,6,2,8,2022,01-16,19:35
031 Voltaire,0,8,8,2022,01-16,19:35
032 Pr�s d'Ar�nes,5,3,8,2022,01-16,19:35
033 Garcia Lorca,8,0,8,2022,01-16,19:35
034 Vert Bois,0,16,16,2022,01-16,19:35
035 Malbosc,1,7,8,2022,01-16,19:35
036 Occitanie,4,28,32,2022,01-16,19:35
037 FacdesSciences,10,14,24,2022,01-16,19:35
038 Fac de Lettres,6,10,16,2022,01-16,19:35
039 Aiguelongue,4,4,8,2022,01-16,19:35
040 Jeu de Mail des Abb�s,5,3,8,2022,01-16,19:35
041 Eurom�decine,1,7,8,2022,01-16,19:35
042 Marie Caizergues,1,7,8,2022,01-16,19:35
043 Sabines,3,5,8,2022,01-16,19:35
044 Celleneuve,4,4,8,2022,01-16,19:35
045 Jardin de la Lironde,5,3,8,2022,01-16,19:35
046 P�re Soulas,1,7,8,2022,01-16,19:35
047 Place Viala,0,8,8,2022,01-16,19:35
048 H�tel du D�partement,2,6,8,2022,01-16,19:35
049 Tonnelles,3,5,8,2022,01-16,19:35
050 Parvis Jules Ferry - Gare Saint-Roch,2,6,8,2022,01-16,19:35
051 Pont de Lattes - Gare Saint-Roch,0,12,12,2022,01-16,19:35
053 Deux Ponts - Gare Saint-Roch,2,6,8,2022,01-16,19:35
054 Providence - Ovalie,1,7,8,2022,01-16,19:35
055 P�rols Etang de l'Or,28,40,68,2022,01-16,19:35
056 Albert 1er - Cath�drale,5,7,12,2022,01-16,19:35
057 Saint-Guilhem - Courreau,2,6,8,2022,01-16,19:35
059 Sud De France,2,6,8,2022,01-16,19:35
001 Rue Jules Ferry - Gare Saint-Roch,9,3,12,2022,01-16,19:45
002 Com�die,2,22,24,2022,01-16,19:45
003 Esplanade,5,27,32,2022,01-16,19:45
004 H�tel de Ville,13,3,16,2022,01-16,19:45
005 Corum,9,3,12,2022,01-16,19:45
006 Place Albert 1er - St Charles,12,19,31,2022,01-16,19:45
007 Foch,3,5,8,2022,01-16,19:45
008 Halles Castellane,0,12,12,2022,01-16,19:45
009 Observatoire,4,4,8,2022,01-16,19:45
010 Rondelet,3,13,16,2022,01-16,19:45
011 Plan Cabanes,4,8,12,2022,01-16,19:45
012 Boutonnet,3,9,12,2022,01-16,19:45
013 Emile Combes,4,4,8,2022,01-16,19:45
014 Beaux-Arts,7,1,8,2022,01-16,19:45
015 Les Aubes,5,3,8,2022,01-16,19:45
016 Antigone centre,14,2,16,2022,01-16,19:45
017 M�diath�que Emile Zola,7,9,16,2022,01-16,19:45
018 Nombre d'Or,15,1,16,2022,01-16,19:45
019 Louis Blanc,10,6,16,2022,01-16,19:45
020 Gambetta,1,7,8,2022,01-16,19:45
021 Port Marianne,15,1,16,2022,01-16,19:45
022 Clemenceau,3,9,12,2022,01-16,19:45
023 Les Arceaux,1,15,16,2022,01-16,19:45
024 Cit� Mion,3,5,8,2022,01-16,19:45
025 Nouveau Saint-Roch,6,2,8,2022,01-16,19:45
026 Renouvier,2,6,8,2022,01-16,19:45
027 Odysseum,2,6,8,2022,01-16,19:45
028 Saint-Denis,8,0,8,2022,01-16,19:45
029 Richter,7,9,16,2022,01-16,19:45
030 Charles Flahault,6,2,8,2022,01-16,19:45
031 Voltaire,0,8,8,2022,01-16,19:45
032 Pr�s d'Ar�nes,5,3,8,2022,01-16,19:45
033 Garcia Lorca,8,0,8,2022,01-16,19:45
034 Vert Bois,0,16,16,2022,01-16,19:45
035 Malbosc,1,7,8,2022,01-16,19:45
036 Occitanie,3,29,32,2022,01-16,19:45
037 FacdesSciences,10,14,24,2022,01-16,19:45
038 Fac de Lettres,6,10,16,2022,01-16,19:45
039 Aiguelongue,4,4,8,2022,01-16,19:45
040 Jeu de Mail des Abb�s,5,3,8,2022,01-16,19:45
041 Eurom�decine,1,7,8,2022,01-16,19:45
042 Marie Caizergues,1,7,8,2022,01-16,19:45
043 Sabines,3,5,8,2022,01-16,19:45
044 Celleneuve,4,4,8,2022,01-16,19:45
045 Jardin de la Lironde,5,3,8,2022,01-16,19:45
046 P�re Soulas,1,7,8,2022,01-16,19:45
047 Place Viala,0,8,8,2022,01-16,19:45
048 H�tel du D�partement,2,6,8,2022,01-16,19:45
049 Tonnelles,3,5,8,2022,01-16,19:45
050 Parvis Jules Ferry - Gare Saint-Roch,2,6,8,2022,01-16,19:45
051 Pont de Lattes - Gare Saint-Roch,0,12,12,2022,01-16,19:45
053 Deux Ponts - Gare Saint-Roch,2,6,8,2022,01-16,19:45
054 Providence - Ovalie,1,7,8,2022,01-16,19:45
055 P�rols Etang de l'Or,28,40,68,2022,01-16,19:45
056 Albert 1er - Cath�drale,7,5,12,2022,01-16,19:45
057 Saint-Guilhem - Courreau,3,5,8,2022,01-16,19:45
059 Sud De France,1,7,8,2022,01-16,19:45
001 Rue Jules Ferry - Gare Saint-Roch,9,3,12,2022,01-16,19:56
002 Com�die,2,22,24,2022,01-16,19:56
003 Esplanade,4,28,32,2022,01-16,19:56
004 H�tel de Ville,13,3,16,2022,01-16,19:56
005 Corum,8,4,12,2022,01-16,19:56
006 Place Albert 1er - St Charles,14,17,31,2022,01-16,19:56
007 Foch,3,5,8,2022,01-16,19:56
008 Halles Castellane,0,12,12,2022,01-16,19:56
009 Observatoire,5,3,8,2022,01-16,19:56
010 Rondelet,3,13,16,2022,01-16,19:56
011 Plan Cabanes,4,8,12,2022,01-16,19:56
012 Boutonnet,3,9,12,2022,01-16,19:56
013 Emile Combes,4,4,8,2022,01-16,19:56
014 Beaux-Arts,7,1,8,2022,01-16,19:56
015 Les Aubes,5,3,8,2022,01-16,19:56
016 Antigone centre,14,2,16,2022,01-16,19:56
017 M�diath�que Emile Zola,7,9,16,2022,01-16,19:56
018 Nombre d'Or,15,1,16,2022,01-16,19:56
019 Louis Blanc,10,6,16,2022,01-16,19:56
020 Gambetta,1,7,8,2022,01-16,19:56
021 Port Marianne,15,1,16,2022,01-16,19:56
022 Clemenceau,3,9,12,2022,01-16,19:56
023 Les Arceaux,1,15,16,2022,01-16,19:56
024 Cit� Mion,3,5,8,2022,01-16,19:56
025 Nouveau Saint-Roch,6,2,8,2022,01-16,19:56
026 Renouvier,2,6,8,2022,01-16,19:56
027 Odysseum,2,6,8,2022,01-16,19:56
028 Saint-Denis,8,0,8,2022,01-16,19:56
029 Richter,7,9,16,2022,01-16,19:56
030 Charles Flahault,6,2,8,2022,01-16,19:56
031 Voltaire,1,7,8,2022,01-16,19:56
032 Pr�s d'Ar�nes,5,3,8,2022,01-16,19:56
033 Garcia Lorca,8,0,8,2022,01-16,19:56
034 Vert Bois,0,16,16,2022,01-16,19:56
035 Malbosc,1,7,8,2022,01-16,19:56
036 Occitanie,3,29,32,2022,01-16,19:56
037 FacdesSciences,10,14,24,2022,01-16,19:56
038 Fac de Lettres,6,10,16,2022,01-16,19:56
039 Aiguelongue,4,4,8,2022,01-16,19:56
040 Jeu de Mail des Abb�s,5,3,8,2022,01-16,19:56
041 Eurom�decine,1,7,8,2022,01-16,19:56
042 Marie Caizergues,1,7,8,2022,01-16,19:56
043 Sabines,3,5,8,2022,01-16,19:56
044 Celleneuve,4,4,8,2022,01-16,19:56
045 Jardin de la Lironde,5,3,8,2022,01-16,19:56
046 P�re Soulas,1,7,8,2022,01-16,19:56
047 Place Viala,0,8,8,2022,01-16,19:56
048 H�tel du D�partement,2,6,8,2022,01-16,19:56
049 Tonnelles,3,5,8,2022,01-16,19:56
050 Parvis Jules Ferry - Gare Saint-Roch,2,6,8,2022,01-16,19:56
051 Pont de Lattes - Gare Saint-Roch,0,12,12,2022,01-16,19:56
053 Deux Ponts - Gare Saint-Roch,2,6,8,2022,01-16,19:56
054 Providence - Ovalie,1,7,8,2022,01-16,19:56
055 P�rols Etang de l'Or,28,40,68,2022,01-16,19:56
056 Albert 1er - Cath�drale,7,5,12,2022,01-16,19:56
057 Saint-Guilhem - Courreau,3,5,8,2022,01-16,19:56
059 Sud De France,1,7,8,2022,01-16,19:56
001 Rue Jules Ferry - Gare Saint-Roch,9,3,12,2022,01-16,20:06
002 Com�die,4,20,24,2022,01-16,20:06
003 Esplanade,4,28,32,2022,01-16,20:06
004 H�tel de Ville,13,3,16,2022,01-16,20:06
005 Corum,9,3,12,2022,01-16,20:06
006 Place Albert 1er - St Charles,15,16,31,2022,01-16,20:06
007 Foch,3,5,8,2022,01-16,20:06
008 Halles Castellane,0,12,12,2022,01-16,20:06
009 Observatoire,5,3,8,2022,01-16,20:06
010 Rondelet,3,13,16,2022,01-16,20:06
011 Plan Cabanes,3,9,12,2022,01-16,20:06
012 Boutonnet,2,10,12,2022,01-16,20:06
013 Emile Combes,5,3,8,2022,01-16,20:06
014 Beaux-Arts,7,1,8,2022,01-16,20:06
015 Les Aubes,5,3,8,2022,01-16,20:06
016 Antigone centre,14,2,16,2022,01-16,20:06
017 M�diath�que Emile Zola,7,9,16,2022,01-16,20:06
018 Nombre d'Or,15,1,16,2022,01-16,20:06
019 Louis Blanc,10,6,16,2022,01-16,20:06
020 Gambetta,1,7,8,2022,01-16,20:06
021 Port Marianne,16,0,16,2022,01-16,20:06
022 Clemenceau,5,7,12,2022,01-16,20:06
023 Les Arceaux,1,15,16,2022,01-16,20:06
024 Cit� Mion,3,5,8,2022,01-16,20:06
025 Nouveau Saint-Roch,3,5,8,2022,01-16,20:06
026 Renouvier,1,7,8,2022,01-16,20:06
027 Odysseum,2,6,8,2022,01-16,20:06
028 Saint-Denis,8,0,8,2022,01-16,20:06
029 Richter,7,9,16,2022,01-16,20:06
030 Charles Flahault,6,2,8,2022,01-16,20:06
031 Voltaire,1,7,8,2022,01-16,20:06
032 Pr�s d'Ar�nes,5,3,8,2022,01-16,20:06
033 Garcia Lorca,8,0,8,2022,01-16,20:06
034 Vert Bois,0,16,16,2022,01-16,20:06
035 Malbosc,1,7,8,2022,01-16,20:06
036 Occitanie,3,29,32,2022,01-16,20:06
037 FacdesSciences,9,15,24,2022,01-16,20:06
038 Fac de Lettres,6,10,16,2022,01-16,20:06
039 Aiguelongue,5,3,8,2022,01-16,20:06
040 Jeu de Mail des Abb�s,5,3,8,2022,01-16,20:06
041 Eurom�decine,1,7,8,2022,01-16,20:06
042 Marie Caizergues,1,7,8,2022,01-16,20:06
043 Sabines,3,5,8,2022,01-16,20:06
044 Celleneuve,3,5,8,2022,01-16,20:06
045 Jardin de la Lironde,5,3,8,2022,01-16,20:06
046 P�re Soulas,1,7,8,2022,01-16,20:06
047 Place Viala,0,8,8,2022,01-16,20:06
048 H�tel du D�partement,2,6,8,2022,01-16,20:06
049 Tonnelles,3,5,8,2022,01-16,20:06
050 Parvis Jules Ferry - Gare Saint-Roch,2,6,8,2022,01-16,20:06
051 Pont de Lattes - Gare Saint-Roch,0,12,12,2022,01-16,20:06
053 Deux Ponts - Gare Saint-Roch,2,6,8,2022,01-16,20:06
054 Providence - Ovalie,1,7,8,2022,01-16,20:06
055 P�rols Etang de l'Or,30,38,68,2022,01-16,20:06
056 Albert 1er - Cath�drale,7,5,12,2022,01-16,20:06
057 Saint-Guilhem - Courreau,3,5,8,2022,01-16,20:06
059 Sud De France,1,7,8,2022,01-16,20:06
001 Rue Jules Ferry - Gare Saint-Roch,8,4,12,2022,01-16,20:16
002 Com�die,3,21,24,2022,01-16,20:16
003 Esplanade,4,28,32,2022,01-16,20:16
004 H�tel de Ville,13,3,16,2022,01-16,20:16
005 Corum,9,3,12,2022,01-16,20:16
006 Place Albert 1er - St Charles,15,16,31,2022,01-16,20:16
007 Foch,3,5,8,2022,01-16,20:16
008 Halles Castellane,0,12,12,2022,01-16,20:16
009 Observatoire,5,3,8,2022,01-16,20:16
010 Rondelet,3,13,16,2022,01-16,20:16
011 Plan Cabanes,3,9,12,2022,01-16,20:16
012 Boutonnet,2,10,12,2022,01-16,20:16
013 Emile Combes,5,3,8,2022,01-16,20:16
014 Beaux-Arts,7,1,8,2022,01-16,20:16
015 Les Aubes,5,3,8,2022,01-16,20:16
016 Antigone centre,14,2,16,2022,01-16,20:16
017 M�diath�que Emile Zola,7,9,16,2022,01-16,20:16
018 Nombre d'Or,15,1,16,2022,01-16,20:16
019 Louis Blanc,10,6,16,2022,01-16,20:16
020 Gambetta,1,7,8,2022,01-16,20:16
021 Port Marianne,16,0,16,2022,01-16,20:16
022 Clemenceau,5,7,12,2022,01-16,20:16
023 Les Arceaux,1,15,16,2022,01-16,20:16
024 Cit� Mion,3,5,8,2022,01-16,20:16
025 Nouveau Saint-Roch,3,5,8,2022,01-16,20:16
026 Renouvier,1,7,8,2022,01-16,20:16
027 Odysseum,2,6,8,2022,01-16,20:16
028 Saint-Denis,8,0,8,2022,01-16,20:16
029 Richter,7,9,16,2022,01-16,20:16
030 Charles Flahault,6,2,8,2022,01-16,20:16
031 Voltaire,1,7,8,2022,01-16,20:16
032 Pr�s d'Ar�nes,5,3,8,2022,01-16,20:16
033 Garcia Lorca,8,0,8,2022,01-16,20:16
034 Vert Bois,0,16,16,2022,01-16,20:16
035 Malbosc,1,7,8,2022,01-16,20:16
036 Occitanie,4,28,32,2022,01-16,20:16
037 FacdesSciences,9,15,24,2022,01-16,20:16
038 Fac de Lettres,6,10,16,2022,01-16,20:16
039 Aiguelongue,5,3,8,2022,01-16,20:16
040 Jeu de Mail des Abb�s,5,3,8,2022,01-16,20:16
041 Eurom�decine,1,7,8,2022,01-16,20:16
042 Marie Caizergues,1,7,8,2022,01-16,20:16
043 Sabines,3,5,8,2022,01-16,20:16
044 Celleneuve,3,5,8,2022,01-16,20:16
045 Jardin de la Lironde,5,3,8,2022,01-16,20:16
046 P�re Soulas,1,7,8,2022,01-16,20:16
047 Place Viala,0,8,8,2022,01-16,20:16
048 H�tel du D�partement,2,6,8,2022,01-16,20:16
049 Tonnelles,3,5,8,2022,01-16,20:16
050 Parvis Jules Ferry - Gare Saint-Roch,3,5,8,2022,01-16,20:16
051 Pont de Lattes - Gare Saint-Roch,0,12,12,2022,01-16,20:16
053 Deux Ponts - Gare Saint-Roch,2,6,8,2022,01-16,20:16
054 Providence - Ovalie,1,7,8,2022,01-16,20:16
055 P�rols Etang de l'Or,30,38,68,2022,01-16,20:16
056 Albert 1er - Cath�drale,7,5,12,2022,01-16,20:16
057 Saint-Guilhem - Courreau,3,5,8,2022,01-16,20:16
059 Sud De France,1,7,8,2022,01-16,20:16
001 Rue Jules Ferry - Gare Saint-Roch,8,4,12,2022,01-16,20:26
002 Com�die,3,21,24,2022,01-16,20:26
003 Esplanade,2,30,32,2022,01-16,20:26
004 H�tel de Ville,13,3,16,2022,01-16,20:26
005 Corum,9,3,12,2022,01-16,20:26
006 Place Albert 1er - St Charles,15,16,31,2022,01-16,20:26
007 Foch,3,5,8,2022,01-16,20:26
008 Halles Castellane,1,11,12,2022,01-16,20:26
009 Observatoire,5,3,8,2022,01-16,20:26
010 Rondelet,3,13,16,2022,01-16,20:26
011 Plan Cabanes,3,9,12,2022,01-16,20:26
012 Boutonnet,2,10,12,2022,01-16,20:26
013 Emile Combes,5,3,8,2022,01-16,20:26
014 Beaux-Arts,7,1,8,2022,01-16,20:26
015 Les Aubes,5,3,8,2022,01-16,20:26
016 Antigone centre,14,2,16,2022,01-16,20:26
017 M�diath�que Emile Zola,7,9,16,2022,01-16,20:26
018 Nombre d'Or,15,1,16,2022,01-16,20:26
019 Louis Blanc,10,6,16,2022,01-16,20:26
020 Gambetta,1,7,8,2022,01-16,20:26
021 Port Marianne,16,0,16,2022,01-16,20:26
022 Clemenceau,5,7,12,2022,01-16,20:26
023 Les Arceaux,1,15,16,2022,01-16,20:26
024 Cit� Mion,3,5,8,2022,01-16,20:26
025 Nouveau Saint-Roch,3,5,8,2022,01-16,20:26
026 Renouvier,1,7,8,2022,01-16,20:26
027 Odysseum,2,6,8,2022,01-16,20:26
028 Saint-Denis,8,0,8,2022,01-16,20:26
029 Richter,7,9,16,2022,01-16,20:26
030 Charles Flahault,6,2,8,2022,01-16,20:26
031 Voltaire,1,7,8,2022,01-16,20:26
032 Pr�s d'Ar�nes,5,3,8,2022,01-16,20:26
033 Garcia Lorca,8,0,8,2022,01-16,20:26
034 Vert Bois,0,16,16,2022,01-16,20:26
035 Malbosc,1,7,8,2022,01-16,20:26
036 Occitanie,4,28,32,2022,01-16,20:26
037 FacdesSciences,9,15,24,2022,01-16,20:26
038 Fac de Lettres,6,10,16,2022,01-16,20:26
039 Aiguelongue,5,3,8,2022,01-16,20:26
040 Jeu de Mail des Abb�s,5,3,8,2022,01-16,20:26
041 Eurom�decine,1,7,8,2022,01-16,20:26
042 Marie Caizergues,1,7,8,2022,01-16,20:26
043 Sabines,4,4,8,2022,01-16,20:26
044 Celleneuve,3,5,8,2022,01-16,20:26
045 Jardin de la Lironde,5,3,8,2022,01-16,20:26
046 P�re Soulas,1,7,8,2022,01-16,20:26
047 Place Viala,0,8,8,2022,01-16,20:26
048 H�tel du D�partement,2,6,8,2022,01-16,20:26
049 Tonnelles,3,5,8,2022,01-16,20:26
050 Parvis Jules Ferry - Gare Saint-Roch,3,5,8,2022,01-16,20:26
051 Pont de Lattes - Gare Saint-Roch,0,12,12,2022,01-16,20:26
053 Deux Ponts - Gare Saint-Roch,2,6,8,2022,01-16,20:26
054 Providence - Ovalie,1,7,8,2022,01-16,20:26
055 P�rols Etang de l'Or,30,38,68,2022,01-16,20:26
056 Albert 1er - Cath�drale,7,5,12,2022,01-16,20:26
057 Saint-Guilhem - Courreau,3,5,8,2022,01-16,20:26
059 Sud De France,1,7,8,2022,01-16,20:26
001 Rue Jules Ferry - Gare Saint-Roch,7,5,12,2022,01-16,20:36
002 Com�die,3,21,24,2022,01-16,20:36
003 Esplanade,2,30,32,2022,01-16,20:36
004 H�tel de Ville,13,3,16,2022,01-16,20:36
005 Corum,9,3,12,2022,01-16,20:36
006 Place Albert 1er - St Charles,15,16,31,2022,01-16,20:36
007 Foch,3,5,8,2022,01-16,20:36
008 Halles Castellane,1,11,12,2022,01-16,20:36
009 Observatoire,5,3,8,2022,01-16,20:36
010 Rondelet,3,13,16,2022,01-16,20:36
011 Plan Cabanes,3,9,12,2022,01-16,20:36
012 Boutonnet,2,10,12,2022,01-16,20:36
013 Emile Combes,5,3,8,2022,01-16,20:36
014 Beaux-Arts,7,1,8,2022,01-16,20:36
015 Les Aubes,5,3,8,2022,01-16,20:36
016 Antigone centre,14,2,16,2022,01-16,20:36
017 M�diath�que Emile Zola,7,9,16,2022,01-16,20:36
018 Nombre d'Or,15,1,16,2022,01-16,20:36
019 Louis Blanc,10,6,16,2022,01-16,20:36
020 Gambetta,1,7,8,2022,01-16,20:36
021 Port Marianne,16,0,16,2022,01-16,20:36
022 Clemenceau,5,7,12,2022,01-16,20:36
023 Les Arceaux,1,15,16,2022,01-16,20:36
024 Cit� Mion,3,5,8,2022,01-16,20:36
025 Nouveau Saint-Roch,3,5,8,2022,01-16,20:36
026 Renouvier,1,7,8,2022,01-16,20:36
027 Odysseum,2,6,8,2022,01-16,20:36
028 Saint-Denis,8,0,8,2022,01-16,20:36
029 Richter,7,9,16,2022,01-16,20:36
030 Charles Flahault,6,2,8,2022,01-16,20:36
031 Voltaire,1,7,8,2022,01-16,20:36
032 Pr�s d'Ar�nes,5,3,8,2022,01-16,20:36
033 Garcia Lorca,8,0,8,2022,01-16,20:36
034 Vert Bois,0,16,16,2022,01-16,20:36
035 Malbosc,0,8,8,2022,01-16,20:36
036 Occitanie,4,28,32,2022,01-16,20:36
037 FacdesSciences,7,17,24,2022,01-16,20:36
038 Fac de Lettres,6,10,16,2022,01-16,20:36
039 Aiguelongue,5,3,8,2022,01-16,20:36
040 Jeu de Mail des Abb�s,5,3,8,2022,01-16,20:36
041 Eurom�decine,1,7,8,2022,01-16,20:36
042 Marie Caizergues,1,7,8,2022,01-16,20:36
043 Sabines,4,4,8,2022,01-16,20:36
044 Celleneuve,3,5,8,2022,01-16,20:36
045 Jardin de la Lironde,5,3,8,2022,01-16,20:36
046 P�re Soulas,2,6,8,2022,01-16,20:36
047 Place Viala,1,7,8,2022,01-16,20:36
048 H�tel du D�partement,2,6,8,2022,01-16,20:36
049 Tonnelles,3,5,8,2022,01-16,20:36
050 Parvis Jules Ferry - Gare Saint-Roch,2,6,8,2022,01-16,20:36
051 Pont de Lattes - Gare Saint-Roch,0,12,12,2022,01-16,20:36
053 Deux Ponts - Gare Saint-Roch,2,6,8,2022,01-16,20:36
054 Providence - Ovalie,1,7,8,2022,01-16,20:36
055 P�rols Etang de l'Or,30,38,68,2022,01-16,20:36
056 Albert 1er - Cath�drale,7,5,12,2022,01-16,20:36
057 Saint-Guilhem - Courreau,3,5,8,2022,01-16,20:36
059 Sud De France,1,7,8,2022,01-16,20:36
001 Rue Jules Ferry - Gare Saint-Roch,7,5,12,2022,01-16,20:46
002 Com�die,4,20,24,2022,01-16,20:46
003 Esplanade,2,30,32,2022,01-16,20:46
004 H�tel de Ville,13,3,16,2022,01-16,20:46
005 Corum,9,3,12,2022,01-16,20:46
006 Place Albert 1er - St Charles,15,16,31,2022,01-16,20:46
007 Foch,3,5,8,2022,01-16,20:46
008 Halles Castellane,1,11,12,2022,01-16,20:46
009 Observatoire,1,7,8,2022,01-16,20:46
010 Rondelet,3,13,16,2022,01-16,20:46
011 Plan Cabanes,3,9,12,2022,01-16,20:46
012 Boutonnet,2,10,12,2022,01-16,20:46
013 Emile Combes,5,3,8,2022,01-16,20:46
014 Beaux-Arts,7,1,8,2022,01-16,20:46
015 Les Aubes,5,3,8,2022,01-16,20:46
016 Antigone centre,14,2,16,2022,01-16,20:46
017 M�diath�que Emile Zola,7,9,16,2022,01-16,20:46
018 Nombre d'Or,15,1,16,2022,01-16,20:46
019 Louis Blanc,10,6,16,2022,01-16,20:46
020 Gambetta,1,7,8,2022,01-16,20:46
021 Port Marianne,16,0,16,2022,01-16,20:46
022 Clemenceau,4,8,12,2022,01-16,20:46
023 Les Arceaux,1,15,16,2022,01-16,20:46
024 Cit� Mion,3,5,8,2022,01-16,20:46
025 Nouveau Saint-Roch,3,5,8,2022,01-16,20:46
026 Renouvier,1,7,8,2022,01-16,20:46
027 Odysseum,2,6,8,2022,01-16,20:46
028 Saint-Denis,8,0,8,2022,01-16,20:46
029 Richter,7,9,16,2022,01-16,20:46
030 Charles Flahault,6,2,8,2022,01-16,20:46
031 Voltaire,1,7,8,2022,01-16,20:46
032 Pr�s d'Ar�nes,6,2,8,2022,01-16,20:46
033 Garcia Lorca,8,0,8,2022,01-16,20:46
034 Vert Bois,0,16,16,2022,01-16,20:46
035 Malbosc,0,8,8,2022,01-16,20:46
036 Occitanie,4,28,32,2022,01-16,20:46
037 FacdesSciences,7,17,24,2022,01-16,20:46
038 Fac de Lettres,6,10,16,2022,01-16,20:46
039 Aiguelongue,5,3,8,2022,01-16,20:46
040 Jeu de Mail des Abb�s,5,3,8,2022,01-16,20:46
041 Eurom�decine,1,7,8,2022,01-16,20:46
042 Marie Caizergues,1,7,8,2022,01-16,20:46
043 Sabines,4,4,8,2022,01-16,20:46
044 Celleneuve,3,5,8,2022,01-16,20:46
045 Jardin de la Lironde,5,3,8,2022,01-16,20:46
046 P�re Soulas,2,6,8,2022,01-16,20:46
047 Place Viala,1,7,8,2022,01-16,20:46
048 H�tel du D�partement,2,6,8,2022,01-16,20:46
049 Tonnelles,3,5,8,2022,01-16,20:46
050 Parvis Jules Ferry - Gare Saint-Roch,2,6,8,2022,01-16,20:46
051 Pont de Lattes - Gare Saint-Roch,0,12,12,2022,01-16,20:46
053 Deux Ponts - Gare Saint-Roch,2,6,8,2022,01-16,20:46
054 Providence - Ovalie,1,7,8,2022,01-16,20:46
055 P�rols Etang de l'Or,30,38,68,2022,01-16,20:46
056 Albert 1er - Cath�drale,7,5,12,2022,01-16,20:46
057 Saint-Guilhem - Courreau,3,5,8,2022,01-16,20:46
059 Sud De France,1,7,8,2022,01-16,20:46
001 Rue Jules Ferry - Gare Saint-Roch,6,6,12,2022,01-16,20:57
002 Com�die,4,20,24,2022,01-16,20:57
003 Esplanade,2,30,32,2022,01-16,20:57
004 H�tel de Ville,13,3,16,2022,01-16,20:57
005 Corum,9,3,12,2022,01-16,20:57
006 Place Albert 1er - St Charles,15,16,31,2022,01-16,20:57
007 Foch,3,5,8,2022,01-16,20:57
008 Halles Castellane,1,11,12,2022,01-16,20:57
009 Observatoire,3,5,8,2022,01-16,20:57
010 Rondelet,3,13,16,2022,01-16,20:57
011 Plan Cabanes,3,9,12,2022,01-16,20:57
012 Boutonnet,2,10,12,2022,01-16,20:57
013 Emile Combes,5,3,8,2022,01-16,20:57
014 Beaux-Arts,7,1,8,2022,01-16,20:57
015 Les Aubes,5,3,8,2022,01-16,20:57
016 Antigone centre,15,1,16,2022,01-16,20:57
017 M�diath�que Emile Zola,7,9,16,2022,01-16,20:57
018 Nombre d'Or,15,1,16,2022,01-16,20:57
019 Louis Blanc,10,6,16,2022,01-16,20:57
020 Gambetta,1,7,8,2022,01-16,20:57
021 Port Marianne,16,0,16,2022,01-16,20:57
022 Clemenceau,4,8,12,2022,01-16,20:57
023 Les Arceaux,1,15,16,2022,01-16,20:57
024 Cit� Mion,3,5,8,2022,01-16,20:57
025 Nouveau Saint-Roch,3,5,8,2022,01-16,20:57
026 Renouvier,1,7,8,2022,01-16,20:57
027 Odysseum,2,6,8,2022,01-16,20:57
028 Saint-Denis,8,0,8,2022,01-16,20:57
029 Richter,7,9,16,2022,01-16,20:57
030 Charles Flahault,6,2,8,2022,01-16,20:57
031 Voltaire,1,7,8,2022,01-16,20:57
032 Pr�s d'Ar�nes,6,2,8,2022,01-16,20:57
033 Garcia Lorca,8,0,8,2022,01-16,20:57
034 Vert Bois,0,16,16,2022,01-16,20:57
035 Malbosc,0,8,8,2022,01-16,20:57
036 Occitanie,3,29,32,2022,01-16,20:57
037 FacdesSciences,7,17,24,2022,01-16,20:57
038 Fac de Lettres,6,10,16,2022,01-16,20:57
039 Aiguelongue,5,3,8,2022,01-16,20:57
040 Jeu de Mail des Abb�s,5,3,8,2022,01-16,20:57
041 Eurom�decine,1,7,8,2022,01-16,20:57
042 Marie Caizergues,1,7,8,2022,01-16,20:57
043 Sabines,4,4,8,2022,01-16,20:57
044 Celleneuve,3,5,8,2022,01-16,20:57
045 Jardin de la Lironde,5,3,8,2022,01-16,20:57
046 P�re Soulas,2,6,8,2022,01-16,20:57
047 Place Viala,1,7,8,2022,01-16,20:57
048 H�tel du D�partement,2,6,8,2022,01-16,20:57
049 Tonnelles,3,5,8,2022,01-16,20:57
050 Parvis Jules Ferry - Gare Saint-Roch,2,6,8,2022,01-16,20:57
051 Pont de Lattes - Gare Saint-Roch,0,12,12,2022,01-16,20:57
053 Deux Ponts - Gare Saint-Roch,2,6,8,2022,01-16,20:57
054 Providence - Ovalie,1,7,8,2022,01-16,20:57
055 P�rols Etang de l'Or,30,38,68,2022,01-16,20:57
056 Albert 1er - Cath�drale,7,5,12,2022,01-16,20:57
057 Saint-Guilhem - Courreau,3,5,8,2022,01-16,20:57
059 Sud De France,1,7,8,2022,01-16,20:57
001 Rue Jules Ferry - Gare Saint-Roch,6,6,12,2022,01-16,21:07
002 Com�die,10,14,24,2022,01-16,21:07
003 Esplanade,2,30,32,2022,01-16,21:07
004 H�tel de Ville,13,3,16,2022,01-16,21:07
005 Corum,9,3,12,2022,01-16,21:07
006 Place Albert 1er - St Charles,15,16,31,2022,01-16,21:07
007 Foch,3,5,8,2022,01-16,21:07
008 Halles Castellane,1,11,12,2022,01-16,21:07
009 Observatoire,3,5,8,2022,01-16,21:07
010 Rondelet,3,13,16,2022,01-16,21:07
011 Plan Cabanes,3,9,12,2022,01-16,21:07
012 Boutonnet,2,10,12,2022,01-16,21:07
013 Emile Combes,5,3,8,2022,01-16,21:07
014 Beaux-Arts,7,1,8,2022,01-16,21:07
015 Les Aubes,5,3,8,2022,01-16,21:07
016 Antigone centre,15,1,16,2022,01-16,21:07
017 M�diath�que Emile Zola,7,9,16,2022,01-16,21:07
018 Nombre d'Or,15,1,16,2022,01-16,21:07
019 Louis Blanc,10,6,16,2022,01-16,21:07
020 Gambetta,1,7,8,2022,01-16,21:07
021 Port Marianne,16,0,16,2022,01-16,21:07
022 Clemenceau,4,8,12,2022,01-16,21:07
023 Les Arceaux,1,15,16,2022,01-16,21:07
024 Cit� Mion,3,5,8,2022,01-16,21:07
025 Nouveau Saint-Roch,3,5,8,2022,01-16,21:07
026 Renouvier,1,7,8,2022,01-16,21:07
027 Odysseum,2,6,8,2022,01-16,21:07
028 Saint-Denis,8,0,8,2022,01-16,21:07
029 Richter,7,9,16,2022,01-16,21:07
030 Charles Flahault,6,2,8,2022,01-16,21:07
031 Voltaire,1,7,8,2022,01-16,21:07
032 Pr�s d'Ar�nes,6,2,8,2022,01-16,21:07
033 Garcia Lorca,8,0,8,2022,01-16,21:07
034 Vert Bois,0,16,16,2022,01-16,21:07
035 Malbosc,0,8,8,2022,01-16,21:07
036 Occitanie,3,29,32,2022,01-16,21:07
037 FacdesSciences,8,16,24,2022,01-16,21:07
038 Fac de Lettres,6,10,16,2022,01-16,21:07
039 Aiguelongue,5,3,8,2022,01-16,21:07
040 Jeu de Mail des Abb�s,5,3,8,2022,01-16,21:07
041 Eurom�decine,1,7,8,2022,01-16,21:07
042 Marie Caizergues,1,7,8,2022,01-16,21:07
043 Sabines,4,4,8,2022,01-16,21:07
044 Celleneuve,3,5,8,2022,01-16,21:07
045 Jardin de la Lironde,5,3,8,2022,01-16,21:07
046 P�re Soulas,2,6,8,2022,01-16,21:07
047 Place Viala,1,7,8,2022,01-16,21:07
048 H�tel du D�partement,2,6,8,2022,01-16,21:07
049 Tonnelles,3,5,8,2022,01-16,21:07
050 Parvis Jules Ferry - Gare Saint-Roch,2,6,8,2022,01-16,21:07
051 Pont de Lattes - Gare Saint-Roch,0,12,12,2022,01-16,21:07
053 Deux Ponts - Gare Saint-Roch,2,6,8,2022,01-16,21:07
054 Providence - Ovalie,1,7,8,2022,01-16,21:07
055 P�rols Etang de l'Or,30,38,68,2022,01-16,21:07
056 Albert 1er - Cath�drale,7,5,12,2022,01-16,21:07
057 Saint-Guilhem - Courreau,3,5,8,2022,01-16,21:07
059 Sud De France,1,7,8,2022,01-16,21:07
001 Rue Jules Ferry - Gare Saint-Roch,6,6,12,2022,01-16,21:17
002 Com�die,10,14,24,2022,01-16,21:17
003 Esplanade,2,30,32,2022,01-16,21:17
004 H�tel de Ville,13,3,16,2022,01-16,21:17
005 Corum,8,4,12,2022,01-16,21:17
006 Place Albert 1er - St Charles,15,16,31,2022,01-16,21:17
007 Foch,3,5,8,2022,01-16,21:17
008 Halles Castellane,1,11,12,2022,01-16,21:17
009 Observatoire,3,5,8,2022,01-16,21:17
010 Rondelet,3,13,16,2022,01-16,21:17
011 Plan Cabanes,3,9,12,2022,01-16,21:17
012 Boutonnet,1,11,12,2022,01-16,21:17
013 Emile Combes,5,3,8,2022,01-16,21:17
014 Beaux-Arts,7,1,8,2022,01-16,21:17
015 Les Aubes,5,3,8,2022,01-16,21:17
016 Antigone centre,15,1,16,2022,01-16,21:17
017 M�diath�que Emile Zola,7,9,16,2022,01-16,21:17
018 Nombre d'Or,15,1,16,2022,01-16,21:17
019 Louis Blanc,10,6,16,2022,01-16,21:17
020 Gambetta,1,7,8,2022,01-16,21:17
021 Port Marianne,16,0,16,2022,01-16,21:17
022 Clemenceau,4,8,12,2022,01-16,21:17
023 Les Arceaux,1,15,16,2022,01-16,21:17
024 Cit� Mion,3,5,8,2022,01-16,21:17
025 Nouveau Saint-Roch,3,5,8,2022,01-16,21:17
026 Renouvier,1,7,8,2022,01-16,21:17
027 Odysseum,2,6,8,2022,01-16,21:17
028 Saint-Denis,8,0,8,2022,01-16,21:17
029 Richter,7,9,16,2022,01-16,21:17
030 Charles Flahault,6,2,8,2022,01-16,21:17
031 Voltaire,1,7,8,2022,01-16,21:17
032 Pr�s d'Ar�nes,6,2,8,2022,01-16,21:17
033 Garcia Lorca,8,0,8,2022,01-16,21:17
034 Vert Bois,0,16,16,2022,01-16,21:17
035 Malbosc,0,8,8,2022,01-16,21:17
036 Occitanie,3,29,32,2022,01-16,21:17
037 FacdesSciences,8,16,24,2022,01-16,21:17
038 Fac de Lettres,5,11,16,2022,01-16,21:17
039 Aiguelongue,5,3,8,2022,01-16,21:17
040 Jeu de Mail des Abb�s,5,3,8,2022,01-16,21:17
041 Eurom�decine,1,7,8,2022,01-16,21:17
042 Marie Caizergues,1,7,8,2022,01-16,21:17
043 Sabines,4,4,8,2022,01-16,21:17
044 Celleneuve,3,5,8,2022,01-16,21:17
045 Jardin de la Lironde,5,3,8,2022,01-16,21:17
046 P�re Soulas,2,6,8,2022,01-16,21:17
047 Place Viala,1,7,8,2022,01-16,21:17
048 H�tel du D�partement,2,6,8,2022,01-16,21:17
049 Tonnelles,3,5,8,2022,01-16,21:17
050 Parvis Jules Ferry - Gare Saint-Roch,4,4,8,2022,01-16,21:17
051 Pont de Lattes - Gare Saint-Roch,0,12,12,2022,01-16,21:17
053 Deux Ponts - Gare Saint-Roch,2,6,8,2022,01-16,21:17
054 Providence - Ovalie,1,7,8,2022,01-16,21:17
055 P�rols Etang de l'Or,30,38,68,2022,01-16,21:17
056 Albert 1er - Cath�drale,7,5,12,2022,01-16,21:17
057 Saint-Guilhem - Courreau,3,5,8,2022,01-16,21:17
059 Sud De France,1,7,8,2022,01-16,21:17
001 Rue Jules Ferry - Gare Saint-Roch,6,6,12,2022,01-16,21:27
002 Com�die,10,14,24,2022,01-16,21:27
003 Esplanade,4,28,32,2022,01-16,21:27
004 H�tel de Ville,13,3,16,2022,01-16,21:27
005 Corum,8,4,12,2022,01-16,21:27
006 Place Albert 1er - St Charles,15,16,31,2022,01-16,21:27
007 Foch,3,5,8,2022,01-16,21:27
008 Halles Castellane,1,11,12,2022,01-16,21:27
009 Observatoire,3,5,8,2022,01-16,21:27
010 Rondelet,3,13,16,2022,01-16,21:27
011 Plan Cabanes,3,9,12,2022,01-16,21:27
012 Boutonnet,1,11,12,2022,01-16,21:27
013 Emile Combes,5,3,8,2022,01-16,21:27
014 Beaux-Arts,7,1,8,2022,01-16,21:27
015 Les Aubes,5,3,8,2022,01-16,21:27
016 Antigone centre,15,1,16,2022,01-16,21:27
017 M�diath�que Emile Zola,7,9,16,2022,01-16,21:27
018 Nombre d'Or,15,1,16,2022,01-16,21:27
019 Louis Blanc,10,6,16,2022,01-16,21:27
020 Gambetta,1,7,8,2022,01-16,21:27
021 Port Marianne,16,0,16,2022,01-16,21:27
022 Clemenceau,4,8,12,2022,01-16,21:27
023 Les Arceaux,2,14,16,2022,01-16,21:27
024 Cit� Mion,3,5,8,2022,01-16,21:27
025 Nouveau Saint-Roch,3,5,8,2022,01-16,21:27
026 Renouvier,1,7,8,2022,01-16,21:27
027 Odysseum,2,6,8,2022,01-16,21:27
028 Saint-Denis,8,0,8,2022,01-16,21:27
029 Richter,7,9,16,2022,01-16,21:27
030 Charles Flahault,6,2,8,2022,01-16,21:27
031 Voltaire,1,7,8,2022,01-16,21:27
032 Pr�s d'Ar�nes,6,2,8,2022,01-16,21:27
033 Garcia Lorca,8,0,8,2022,01-16,21:27
034 Vert Bois,0,16,16,2022,01-16,21:27
035 Malbosc,0,8,8,2022,01-16,21:27
036 Occitanie,3,29,32,2022,01-16,21:27
037 FacdesSciences,8,16,24,2022,01-16,21:27
038 Fac de Lettres,6,10,16,2022,01-16,21:27
039 Aiguelongue,5,3,8,2022,01-16,21:27
040 Jeu de Mail des Abb�s,5,3,8,2022,01-16,21:27
041 Eurom�decine,1,7,8,2022,01-16,21:27
042 Marie Caizergues,1,7,8,2022,01-16,21:27
043 Sabines,4,4,8,2022,01-16,21:27
044 Celleneuve,3,5,8,2022,01-16,21:27
045 Jardin de la Lironde,5,3,8,2022,01-16,21:27
046 P�re Soulas,3,5,8,2022,01-16,21:27
047 Place Viala,1,7,8,2022,01-16,21:27
048 H�tel du D�partement,1,7,8,2022,01-16,21:27
049 Tonnelles,3,5,8,2022,01-16,21:27
050 Parvis Jules Ferry - Gare Saint-Roch,7,1,8,2022,01-16,21:27
051 Pont de Lattes - Gare Saint-Roch,0,12,12,2022,01-16,21:27
053 Deux Ponts - Gare Saint-Roch,2,6,8,2022,01-16,21:27
054 Providence - Ovalie,1,7,8,2022,01-16,21:27
055 P�rols Etang de l'Or,30,38,68,2022,01-16,21:27
056 Albert 1er - Cath�drale,7,5,12,2022,01-16,21:27
057 Saint-Guilhem - Courreau,3,5,8,2022,01-16,21:27
059 Sud De France,1,7,8,2022,01-16,21:27
001 Rue Jules Ferry - Gare Saint-Roch,6,6,12,2022,01-16,21:37
002 Com�die,10,14,24,2022,01-16,21:37
003 Esplanade,4,28,32,2022,01-16,21:37
004 H�tel de Ville,13,3,16,2022,01-16,21:37
005 Corum,8,4,12,2022,01-16,21:37
006 Place Albert 1er - St Charles,15,16,31,2022,01-16,21:37
007 Foch,3,5,8,2022,01-16,21:37
008 Halles Castellane,1,11,12,2022,01-16,21:37
009 Observatoire,3,5,8,2022,01-16,21:37
010 Rondelet,3,13,16,2022,01-16,21:37
011 Plan Cabanes,3,9,12,2022,01-16,21:37
012 Boutonnet,1,11,12,2022,01-16,21:37
013 Emile Combes,5,3,8,2022,01-16,21:37
014 Beaux-Arts,7,1,8,2022,01-16,21:37
015 Les Aubes,5,3,8,2022,01-16,21:37
016 Antigone centre,15,1,16,2022,01-16,21:37
017 M�diath�que Emile Zola,7,9,16,2022,01-16,21:37
018 Nombre d'Or,15,1,16,2022,01-16,21:37
019 Louis Blanc,10,6,16,2022,01-16,21:37
020 Gambetta,1,7,8,2022,01-16,21:37
021 Port Marianne,16,0,16,2022,01-16,21:37
022 Clemenceau,4,8,12,2022,01-16,21:37
023 Les Arceaux,2,14,16,2022,01-16,21:37
024 Cit� Mion,3,5,8,2022,01-16,21:37
025 Nouveau Saint-Roch,3,5,8,2022,01-16,21:37
026 Renouvier,1,7,8,2022,01-16,21:37
027 Odysseum,2,6,8,2022,01-16,21:37
028 Saint-Denis,8,0,8,2022,01-16,21:37
029 Richter,7,9,16,2022,01-16,21:37
030 Charles Flahault,6,2,8,2022,01-16,21:37
031 Voltaire,1,7,8,2022,01-16,21:37
032 Pr�s d'Ar�nes,6,2,8,2022,01-16,21:37
033 Garcia Lorca,8,0,8,2022,01-16,21:37
034 Vert Bois,0,16,16,2022,01-16,21:37
035 Malbosc,0,8,8,2022,01-16,21:37
036 Occitanie,3,29,32,2022,01-16,21:37
037 FacdesSciences,8,16,24,2022,01-16,21:37
038 Fac de Lettres,6,10,16,2022,01-16,21:37
039 Aiguelongue,5,3,8,2022,01-16,21:37
040 Jeu de Mail des Abb�s,5,3,8,2022,01-16,21:37
041 Eurom�decine,1,7,8,2022,01-16,21:37
042 Marie Caizergues,1,7,8,2022,01-16,21:37
043 Sabines,4,4,8,2022,01-16,21:37
044 Celleneuve,3,5,8,2022,01-16,21:37
045 Jardin de la Lironde,5,3,8,2022,01-16,21:37
046 P�re Soulas,3,5,8,2022,01-16,21:37
047 Place Viala,1,7,8,2022,01-16,21:37
048 H�tel du D�partement,1,7,8,2022,01-16,21:37
049 Tonnelles,3,5,8,2022,01-16,21:37
050 Parvis Jules Ferry - Gare Saint-Roch,7,1,8,2022,01-16,21:37
051 Pont de Lattes - Gare Saint-Roch,0,12,12,2022,01-16,21:37
053 Deux Ponts - Gare Saint-Roch,2,6,8,2022,01-16,21:37
054 Providence - Ovalie,1,7,8,2022,01-16,21:37
055 P�rols Etang de l'Or,30,38,68,2022,01-16,21:37
056 Albert 1er - Cath�drale,7,5,12,2022,01-16,21:37
057 Saint-Guilhem - Courreau,3,5,8,2022,01-16,21:37
059 Sud De France,0,8,8,2022,01-16,21:37
001 Rue Jules Ferry - Gare Saint-Roch,7,5,12,2022,01-16,21:47
002 Com�die,10,14,24,2022,01-16,21:47
003 Esplanade,4,28,32,2022,01-16,21:47
004 H�tel de Ville,13,3,16,2022,01-16,21:47
005 Corum,8,4,12,2022,01-16,21:47
006 Place Albert 1er - St Charles,15,16,31,2022,01-16,21:47
007 Foch,3,5,8,2022,01-16,21:47
008 Halles Castellane,1,11,12,2022,01-16,21:47
009 Observatoire,4,4,8,2022,01-16,21:47
010 Rondelet,3,13,16,2022,01-16,21:47
011 Plan Cabanes,3,9,12,2022,01-16,21:47
012 Boutonnet,1,11,12,2022,01-16,21:47
013 Emile Combes,5,3,8,2022,01-16,21:47
014 Beaux-Arts,7,1,8,2022,01-16,21:47
015 Les Aubes,5,3,8,2022,01-16,21:47
016 Antigone centre,15,1,16,2022,01-16,21:47
017 M�diath�que Emile Zola,7,9,16,2022,01-16,21:47
018 Nombre d'Or,15,1,16,2022,01-16,21:47
019 Louis Blanc,10,6,16,2022,01-16,21:47
020 Gambetta,1,7,8,2022,01-16,21:47
021 Port Marianne,16,0,16,2022,01-16,21:47
022 Clemenceau,4,8,12,2022,01-16,21:47
023 Les Arceaux,2,14,16,2022,01-16,21:47
024 Cit� Mion,3,5,8,2022,01-16,21:47
025 Nouveau Saint-Roch,3,5,8,2022,01-16,21:47
026 Renouvier,1,7,8,2022,01-16,21:47
027 Odysseum,3,5,8,2022,01-16,21:47
028 Saint-Denis,8,0,8,2022,01-16,21:47
029 Richter,7,9,16,2022,01-16,21:47
030 Charles Flahault,6,2,8,2022,01-16,21:47
031 Voltaire,1,7,8,2022,01-16,21:47
032 Pr�s d'Ar�nes,6,2,8,2022,01-16,21:47
033 Garcia Lorca,8,0,8,2022,01-16,21:47
034 Vert Bois,0,16,16,2022,01-16,21:47
035 Malbosc,0,8,8,2022,01-16,21:47
036 Occitanie,3,29,32,2022,01-16,21:47
037 FacdesSciences,8,16,24,2022,01-16,21:47
038 Fac de Lettres,6,10,16,2022,01-16,21:47
039 Aiguelongue,5,3,8,2022,01-16,21:47
040 Jeu de Mail des Abb�s,5,3,8,2022,01-16,21:47
041 Eurom�decine,1,7,8,2022,01-16,21:47
042 Marie Caizergues,1,7,8,2022,01-16,21:47
043 Sabines,4,4,8,2022,01-16,21:47
044 Celleneuve,3,5,8,2022,01-16,21:47
045 Jardin de la Lironde,4,4,8,2022,01-16,21:47
046 P�re Soulas,3,5,8,2022,01-16,21:47
047 Place Viala,1,7,8,2022,01-16,21:47
048 H�tel du D�partement,1,7,8,2022,01-16,21:47
049 Tonnelles,3,5,8,2022,01-16,21:47
050 Parvis Jules Ferry - Gare Saint-Roch,7,1,8,2022,01-16,21:47
051 Pont de Lattes - Gare Saint-Roch,0,12,12,2022,01-16,21:47
053 Deux Ponts - Gare Saint-Roch,2,6,8,2022,01-16,21:47
054 Providence - Ovalie,1,7,8,2022,01-16,21:47
055 P�rols Etang de l'Or,32,36,68,2022,01-16,21:47
056 Albert 1er - Cath�drale,7,5,12,2022,01-16,21:47
057 Saint-Guilhem - Courreau,3,5,8,2022,01-16,21:47
059 Sud De France,0,8,8,2022,01-16,21:47
001 Rue Jules Ferry - Gare Saint-Roch,7,5,12,2022,01-16,21:58
002 Com�die,10,14,24,2022,01-16,21:58
003 Esplanade,4,28,32,2022,01-16,21:58
004 H�tel de Ville,13,3,16,2022,01-16,21:58
005 Corum,8,4,12,2022,01-16,21:58
006 Place Albert 1er - St Charles,15,16,31,2022,01-16,21:58
007 Foch,3,5,8,2022,01-16,21:58
008 Halles Castellane,1,11,12,2022,01-16,21:58
009 Observatoire,4,4,8,2022,01-16,21:58
010 Rondelet,3,13,16,2022,01-16,21:58
011 Plan Cabanes,3,9,12,2022,01-16,21:58
012 Boutonnet,1,11,12,2022,01-16,21:58
013 Emile Combes,5,3,8,2022,01-16,21:58
014 Beaux-Arts,7,1,8,2022,01-16,21:58
015 Les Aubes,5,3,8,2022,01-16,21:58
016 Antigone centre,15,1,16,2022,01-16,21:58
017 M�diath�que Emile Zola,7,9,16,2022,01-16,21:58
018 Nombre d'Or,15,1,16,2022,01-16,21:58
019 Louis Blanc,10,6,16,2022,01-16,21:58
020 Gambetta,1,7,8,2022,01-16,21:58
021 Port Marianne,16,0,16,2022,01-16,21:58
022 Clemenceau,4,8,12,2022,01-16,21:58
023 Les Arceaux,2,14,16,2022,01-16,21:58
024 Cit� Mion,3,5,8,2022,01-16,21:58
025 Nouveau Saint-Roch,3,5,8,2022,01-16,21:58
026 Renouvier,1,7,8,2022,01-16,21:58
027 Odysseum,3,5,8,2022,01-16,21:58
028 Saint-Denis,8,0,8,2022,01-16,21:58
029 Richter,7,9,16,2022,01-16,21:58
030 Charles Flahault,6,2,8,2022,01-16,21:58
031 Voltaire,1,7,8,2022,01-16,21:58
032 Pr�s d'Ar�nes,6,2,8,2022,01-16,21:58
033 Garcia Lorca,8,0,8,2022,01-16,21:58
034 Vert Bois,0,16,16,2022,01-16,21:58
035 Malbosc,0,8,8,2022,01-16,21:58
036 Occitanie,3,29,32,2022,01-16,21:58
037 FacdesSciences,8,16,24,2022,01-16,21:58
038 Fac de Lettres,6,10,16,2022,01-16,21:58
039 Aiguelongue,5,3,8,2022,01-16,21:58
040 Jeu de Mail des Abb�s,5,3,8,2022,01-16,21:58
041 Eurom�decine,1,7,8,2022,01-16,21:58
042 Marie Caizergues,1,7,8,2022,01-16,21:58
043 Sabines,4,4,8,2022,01-16,21:58
044 Celleneuve,3,5,8,2022,01-16,21:58
045 Jardin de la Lironde,4,4,8,2022,01-16,21:58
046 P�re Soulas,3,5,8,2022,01-16,21:58
047 Place Viala,1,7,8,2022,01-16,21:58
048 H�tel du D�partement,1,7,8,2022,01-16,21:58
049 Tonnelles,3,5,8,2022,01-16,21:58
050 Parvis Jules Ferry - Gare Saint-Roch,7,1,8,2022,01-16,21:58
051 Pont de Lattes - Gare Saint-Roch,0,12,12,2022,01-16,21:58
053 Deux Ponts - Gare Saint-Roch,2,6,8,2022,01-16,21:58
054 Providence - Ovalie,1,7,8,2022,01-16,21:58
055 P�rols Etang de l'Or,32,36,68,2022,01-16,21:58
056 Albert 1er - Cath�drale,7,5,12,2022,01-16,21:58
057 Saint-Guilhem - Courreau,3,5,8,2022,01-16,21:58
059 Sud De France,0,8,8,2022,01-16,21:58
001 Rue Jules Ferry - Gare Saint-Roch,7,5,12,2022,01-16,22:08
002 Com�die,10,14,24,2022,01-16,22:08
003 Esplanade,4,28,32,2022,01-16,22:08
004 H�tel de Ville,13,3,16,2022,01-16,22:08
005 Corum,8,4,12,2022,01-16,22:08
006 Place Albert 1er - St Charles,16,15,31,2022,01-16,22:08
007 Foch,3,5,8,2022,01-16,22:08
008 Halles Castellane,1,11,12,2022,01-16,22:08
009 Observatoire,4,4,8,2022,01-16,22:08
010 Rondelet,3,13,16,2022,01-16,22:08
011 Plan Cabanes,3,9,12,2022,01-16,22:08
012 Boutonnet,1,11,12,2022,01-16,22:08
013 Emile Combes,5,3,8,2022,01-16,22:08
014 Beaux-Arts,7,1,8,2022,01-16,22:08
015 Les Aubes,5,3,8,2022,01-16,22:08
016 Antigone centre,14,2,16,2022,01-16,22:08
017 M�diath�que Emile Zola,7,9,16,2022,01-16,22:08
018 Nombre d'Or,15,1,16,2022,01-16,22:08
019 Louis Blanc,10,6,16,2022,01-16,22:08
020 Gambetta,1,7,8,2022,01-16,22:08
021 Port Marianne,16,0,16,2022,01-16,22:08
022 Clemenceau,4,8,12,2022,01-16,22:08
023 Les Arceaux,2,14,16,2022,01-16,22:08
024 Cit� Mion,3,5,8,2022,01-16,22:08
025 Nouveau Saint-Roch,3,5,8,2022,01-16,22:08
026 Renouvier,1,7,8,2022,01-16,22:08
027 Odysseum,3,5,8,2022,01-16,22:08
028 Saint-Denis,8,0,8,2022,01-16,22:08
029 Richter,7,9,16,2022,01-16,22:08
030 Charles Flahault,6,2,8,2022,01-16,22:08
031 Voltaire,1,7,8,2022,01-16,22:08
032 Pr�s d'Ar�nes,6,2,8,2022,01-16,22:08
033 Garcia Lorca,8,0,8,2022,01-16,22:08
034 Vert Bois,0,16,16,2022,01-16,22:08
035 Malbosc,0,8,8,2022,01-16,22:08
036 Occitanie,3,29,32,2022,01-16,22:08
037 FacdesSciences,8,16,24,2022,01-16,22:08
038 Fac de Lettres,6,10,16,2022,01-16,22:08
039 Aiguelongue,5,3,8,2022,01-16,22:08
040 Jeu de Mail des Abb�s,5,3,8,2022,01-16,22:08
041 Eurom�decine,1,7,8,2022,01-16,22:08
042 Marie Caizergues,1,7,8,2022,01-16,22:08
043 Sabines,4,4,8,2022,01-16,22:08
044 Celleneuve,3,5,8,2022,01-16,22:08
045 Jardin de la Lironde,4,4,8,2022,01-16,22:08
046 P�re Soulas,3,5,8,2022,01-16,22:08
047 Place Viala,1,7,8,2022,01-16,22:08
048 H�tel du D�partement,1,7,8,2022,01-16,22:08
049 Tonnelles,3,5,8,2022,01-16,22:08
050 Parvis Jules Ferry - Gare Saint-Roch,7,1,8,2022,01-16,22:08
051 Pont de Lattes - Gare Saint-Roch,0,12,12,2022,01-16,22:08
053 Deux Ponts - Gare Saint-Roch,2,6,8,2022,01-16,22:08
054 Providence - Ovalie,1,7,8,2022,01-16,22:08
055 P�rols Etang de l'Or,32,36,68,2022,01-16,22:08
056 Albert 1er - Cath�drale,7,5,12,2022,01-16,22:08
057 Saint-Guilhem - Courreau,3,5,8,2022,01-16,22:08
059 Sud De France,0,8,8,2022,01-16,22:08
001 Rue Jules Ferry - Gare Saint-Roch,7,5,12,2022,01-16,22:18
002 Com�die,9,15,24,2022,01-16,22:18
003 Esplanade,4,28,32,2022,01-16,22:18
004 H�tel de Ville,13,3,16,2022,01-16,22:18
005 Corum,8,4,12,2022,01-16,22:18
006 Place Albert 1er - St Charles,16,15,31,2022,01-16,22:18
007 Foch,3,5,8,2022,01-16,22:18
008 Halles Castellane,1,11,12,2022,01-16,22:18
009 Observatoire,4,4,8,2022,01-16,22:18
010 Rondelet,3,13,16,2022,01-16,22:18
011 Plan Cabanes,3,9,12,2022,01-16,22:18
012 Boutonnet,1,11,12,2022,01-16,22:18
013 Emile Combes,5,3,8,2022,01-16,22:18
014 Beaux-Arts,7,1,8,2022,01-16,22:18
015 Les Aubes,5,3,8,2022,01-16,22:18
016 Antigone centre,14,2,16,2022,01-16,22:18
017 M�diath�que Emile Zola,7,9,16,2022,01-16,22:18
018 Nombre d'Or,15,1,16,2022,01-16,22:18
019 Louis Blanc,10,6,16,2022,01-16,22:18
020 Gambetta,1,7,8,2022,01-16,22:18
021 Port Marianne,16,0,16,2022,01-16,22:18
022 Clemenceau,5,7,12,2022,01-16,22:18
023 Les Arceaux,2,14,16,2022,01-16,22:18
024 Cit� Mion,3,5,8,2022,01-16,22:18
025 Nouveau Saint-Roch,3,5,8,2022,01-16,22:18
026 Renouvier,1,7,8,2022,01-16,22:18
027 Odysseum,3,5,8,2022,01-16,22:18
028 Saint-Denis,8,0,8,2022,01-16,22:18
029 Richter,7,9,16,2022,01-16,22:18
030 Charles Flahault,6,2,8,2022,01-16,22:18
031 Voltaire,1,7,8,2022,01-16,22:18
032 Pr�s d'Ar�nes,7,1,8,2022,01-16,22:18
033 Garcia Lorca,8,0,8,2022,01-16,22:18
034 Vert Bois,0,16,16,2022,01-16,22:18
035 Malbosc,0,8,8,2022,01-16,22:18
036 Occitanie,3,29,32,2022,01-16,22:18
037 FacdesSciences,8,16,24,2022,01-16,22:18
038 Fac de Lettres,6,10,16,2022,01-16,22:18
039 Aiguelongue,5,3,8,2022,01-16,22:18
040 Jeu de Mail des Abb�s,5,3,8,2022,01-16,22:18
041 Eurom�decine,1,7,8,2022,01-16,22:18
042 Marie Caizergues,1,7,8,2022,01-16,22:18
043 Sabines,4,4,8,2022,01-16,22:18
044 Celleneuve,3,5,8,2022,01-16,22:18
045 Jardin de la Lironde,4,4,8,2022,01-16,22:18
046 P�re Soulas,2,6,8,2022,01-16,22:18
047 Place Viala,1,7,8,2022,01-16,22:18
048 H�tel du D�partement,1,7,8,2022,01-16,22:18
049 Tonnelles,3,5,8,2022,01-16,22:18
050 Parvis Jules Ferry - Gare Saint-Roch,8,0,8,2022,01-16,22:18
051 Pont de Lattes - Gare Saint-Roch,0,12,12,2022,01-16,22:18
053 Deux Ponts - Gare Saint-Roch,2,6,8,2022,01-16,22:18
054 Providence - Ovalie,1,7,8,2022,01-16,22:18
055 P�rols Etang de l'Or,32,36,68,2022,01-16,22:18
056 Albert 1er - Cath�drale,7,5,12,2022,01-16,22:18
057 Saint-Guilhem - Courreau,3,5,8,2022,01-16,22:18
059 Sud De France,0,8,8,2022,01-16,22:18
001 Rue Jules Ferry - Gare Saint-Roch,7,5,12,2022,01-16,22:28
002 Com�die,9,15,24,2022,01-16,22:28
003 Esplanade,4,28,32,2022,01-16,22:28
004 H�tel de Ville,13,3,16,2022,01-16,22:28
005 Corum,6,6,12,2022,01-16,22:28
006 Place Albert 1er - St Charles,16,15,31,2022,01-16,22:28
007 Foch,3,5,8,2022,01-16,22:28
008 Halles Castellane,1,11,12,2022,01-16,22:28
009 Observatoire,4,4,8,2022,01-16,22:28
010 Rondelet,3,13,16,2022,01-16,22:28
011 Plan Cabanes,3,9,12,2022,01-16,22:28
012 Boutonnet,1,11,12,2022,01-16,22:28
013 Emile Combes,5,3,8,2022,01-16,22:28
014 Beaux-Arts,7,1,8,2022,01-16,22:28
015 Les Aubes,5,3,8,2022,01-16,22:28
016 Antigone centre,14,2,16,2022,01-16,22:28
017 M�diath�que Emile Zola,7,9,16,2022,01-16,22:28
018 Nombre d'Or,15,1,16,2022,01-16,22:28
019 Louis Blanc,10,6,16,2022,01-16,22:28
020 Gambetta,1,7,8,2022,01-16,22:28
021 Port Marianne,16,0,16,2022,01-16,22:28
022 Clemenceau,5,7,12,2022,01-16,22:28
023 Les Arceaux,2,14,16,2022,01-16,22:28
024 Cit� Mion,3,5,8,2022,01-16,22:28
025 Nouveau Saint-Roch,3,5,8,2022,01-16,22:28
026 Renouvier,1,7,8,2022,01-16,22:28
027 Odysseum,3,5,8,2022,01-16,22:28
028 Saint-Denis,8,0,8,2022,01-16,22:28
029 Richter,7,9,16,2022,01-16,22:28
030 Charles Flahault,6,2,8,2022,01-16,22:28
031 Voltaire,1,7,8,2022,01-16,22:28
032 Pr�s d'Ar�nes,7,1,8,2022,01-16,22:28
033 Garcia Lorca,8,0,8,2022,01-16,22:28
034 Vert Bois,0,16,16,2022,01-16,22:28
035 Malbosc,0,8,8,2022,01-16,22:28
036 Occitanie,3,29,32,2022,01-16,22:28
037 FacdesSciences,8,16,24,2022,01-16,22:28
038 Fac de Lettres,6,10,16,2022,01-16,22:28
039 Aiguelongue,4,4,8,2022,01-16,22:28
040 Jeu de Mail des Abb�s,5,3,8,2022,01-16,22:28
041 Eurom�decine,1,7,8,2022,01-16,22:28
042 Marie Caizergues,1,7,8,2022,01-16,22:28
043 Sabines,4,4,8,2022,01-16,22:28
044 Celleneuve,3,5,8,2022,01-16,22:28
045 Jardin de la Lironde,4,4,8,2022,01-16,22:28
046 P�re Soulas,2,6,8,2022,01-16,22:28
047 Place Viala,1,7,8,2022,01-16,22:28
048 H�tel du D�partement,1,7,8,2022,01-16,22:28
049 Tonnelles,3,5,8,2022,01-16,22:28
050 Parvis Jules Ferry - Gare Saint-Roch,8,0,8,2022,01-16,22:28
051 Pont de Lattes - Gare Saint-Roch,0,12,12,2022,01-16,22:28
053 Deux Ponts - Gare Saint-Roch,2,6,8,2022,01-16,22:28
054 Providence - Ovalie,1,7,8,2022,01-16,22:28
055 P�rols Etang de l'Or,32,36,68,2022,01-16,22:28
056 Albert 1er - Cath�drale,7,5,12,2022,01-16,22:28
057 Saint-Guilhem - Courreau,3,5,8,2022,01-16,22:28
059 Sud De France,0,8,8,2022,01-16,22:28
001 Rue Jules Ferry - Gare Saint-Roch,7,5,12,2022,01-16,22:38
002 Com�die,9,15,24,2022,01-16,22:38
003 Esplanade,4,28,32,2022,01-16,22:38
004 H�tel de Ville,13,3,16,2022,01-16,22:38
005 Corum,6,6,12,2022,01-16,22:38
006 Place Albert 1er - St Charles,15,16,31,2022,01-16,22:38
007 Foch,3,5,8,2022,01-16,22:38
008 Halles Castellane,1,11,12,2022,01-16,22:38
009 Observatoire,4,4,8,2022,01-16,22:38
010 Rondelet,3,13,16,2022,01-16,22:38
011 Plan Cabanes,3,9,12,2022,01-16,22:38
012 Boutonnet,1,11,12,2022,01-16,22:38
013 Emile Combes,5,3,8,2022,01-16,22:38
014 Beaux-Arts,7,1,8,2022,01-16,22:38
015 Les Aubes,5,3,8,2022,01-16,22:38
016 Antigone centre,14,2,16,2022,01-16,22:38
017 M�diath�que Emile Zola,7,9,16,2022,01-16,22:38
018 Nombre d'Or,15,1,16,2022,01-16,22:38
019 Louis Blanc,10,6,16,2022,01-16,22:38
020 Gambetta,1,7,8,2022,01-16,22:38
021 Port Marianne,16,0,16,2022,01-16,22:38
022 Clemenceau,5,7,12,2022,01-16,22:38
023 Les Arceaux,2,14,16,2022,01-16,22:38
024 Cit� Mion,3,5,8,2022,01-16,22:38
025 Nouveau Saint-Roch,3,5,8,2022,01-16,22:38
026 Renouvier,1,7,8,2022,01-16,22:38
027 Odysseum,3,5,8,2022,01-16,22:38
028 Saint-Denis,8,0,8,2022,01-16,22:38
029 Richter,7,9,16,2022,01-16,22:38
030 Charles Flahault,6,2,8,2022,01-16,22:38
031 Voltaire,1,7,8,2022,01-16,22:38
032 Pr�s d'Ar�nes,7,1,8,2022,01-16,22:38
033 Garcia Lorca,8,0,8,2022,01-16,22:38
034 Vert Bois,0,16,16,2022,01-16,22:38
035 Malbosc,0,8,8,2022,01-16,22:38
036 Occitanie,3,29,32,2022,01-16,22:38
037 FacdesSciences,8,16,24,2022,01-16,22:38
038 Fac de Lettres,6,10,16,2022,01-16,22:38
039 Aiguelongue,6,2,8,2022,01-16,22:38
040 Jeu de Mail des Abb�s,5,3,8,2022,01-16,22:38
041 Eurom�decine,1,7,8,2022,01-16,22:38
042 Marie Caizergues,1,7,8,2022,01-16,22:38
043 Sabines,4,4,8,2022,01-16,22:38
044 Celleneuve,3,5,8,2022,01-16,22:38
045 Jardin de la Lironde,4,4,8,2022,01-16,22:38
046 P�re Soulas,2,6,8,2022,01-16,22:38
047 Place Viala,1,7,8,2022,01-16,22:38
048 H�tel du D�partement,1,7,8,2022,01-16,22:38
049 Tonnelles,3,5,8,2022,01-16,22:38
050 Parvis Jules Ferry - Gare Saint-Roch,8,0,8,2022,01-16,22:38
051 Pont de Lattes - Gare Saint-Roch,0,12,12,2022,01-16,22:38
053 Deux Ponts - Gare Saint-Roch,2,6,8,2022,01-16,22:38
054 Providence - Ovalie,1,7,8,2022,01-16,22:38
055 P�rols Etang de l'Or,32,36,68,2022,01-16,22:38
056 Albert 1er - Cath�drale,7,5,12,2022,01-16,22:38
057 Saint-Guilhem - Courreau,3,5,8,2022,01-16,22:38
059 Sud De France,0,8,8,2022,01-16,22:38
001 Rue Jules Ferry - Gare Saint-Roch,7,5,12,2022,01-16,22:49
002 Com�die,8,16,24,2022,01-16,22:49
003 Esplanade,2,30,32,2022,01-16,22:49
004 H�tel de Ville,13,3,16,2022,01-16,22:49
005 Corum,6,6,12,2022,01-16,22:49
006 Place Albert 1er - St Charles,15,16,31,2022,01-16,22:49
007 Foch,3,5,8,2022,01-16,22:49
008 Halles Castellane,1,11,12,2022,01-16,22:49
009 Observatoire,5,3,8,2022,01-16,22:49
010 Rondelet,3,13,16,2022,01-16,22:49
011 Plan Cabanes,3,9,12,2022,01-16,22:49
012 Boutonnet,1,11,12,2022,01-16,22:49
013 Emile Combes,5,3,8,2022,01-16,22:49
014 Beaux-Arts,7,1,8,2022,01-16,22:49
015 Les Aubes,5,3,8,2022,01-16,22:49
016 Antigone centre,14,2,16,2022,01-16,22:49
017 M�diath�que Emile Zola,7,9,16,2022,01-16,22:49
018 Nombre d'Or,15,1,16,2022,01-16,22:49
019 Louis Blanc,10,6,16,2022,01-16,22:49
020 Gambetta,1,7,8,2022,01-16,22:49
021 Port Marianne,16,0,16,2022,01-16,22:49
022 Clemenceau,5,7,12,2022,01-16,22:49
023 Les Arceaux,2,14,16,2022,01-16,22:49
024 Cit� Mion,3,5,8,2022,01-16,22:49
025 Nouveau Saint-Roch,3,5,8,2022,01-16,22:49
026 Renouvier,0,8,8,2022,01-16,22:49
027 Odysseum,3,5,8,2022,01-16,22:49
028 Saint-Denis,8,0,8,2022,01-16,22:49
029 Richter,7,9,16,2022,01-16,22:49
030 Charles Flahault,6,2,8,2022,01-16,22:49
031 Voltaire,0,8,8,2022,01-16,22:49
032 Pr�s d'Ar�nes,7,1,8,2022,01-16,22:49
033 Garcia Lorca,8,0,8,2022,01-16,22:49
034 Vert Bois,0,16,16,2022,01-16,22:49
035 Malbosc,0,8,8,2022,01-16,22:49
036 Occitanie,3,29,32,2022,01-16,22:49
037 FacdesSciences,8,16,24,2022,01-16,22:49
038 Fac de Lettres,6,10,16,2022,01-16,22:49
039 Aiguelongue,6,2,8,2022,01-16,22:49
040 Jeu de Mail des Abb�s,5,3,8,2022,01-16,22:49
041 Eurom�decine,1,7,8,2022,01-16,22:49
042 Marie Caizergues,1,7,8,2022,01-16,22:49
043 Sabines,4,4,8,2022,01-16,22:49
044 Celleneuve,3,5,8,2022,01-16,22:49
045 Jardin de la Lironde,4,4,8,2022,01-16,22:49
046 P�re Soulas,2,6,8,2022,01-16,22:49
047 Place Viala,1,7,8,2022,01-16,22:49
048 H�tel du D�partement,1,7,8,2022,01-16,22:49
049 Tonnelles,3,5,8,2022,01-16,22:49
050 Parvis Jules Ferry - Gare Saint-Roch,8,0,8,2022,01-16,22:49
051 Pont de Lattes - Gare Saint-Roch,0,12,12,2022,01-16,22:49
053 Deux Ponts - Gare Saint-Roch,2,6,8,2022,01-16,22:49
054 Providence - Ovalie,1,7,8,2022,01-16,22:49
055 P�rols Etang de l'Or,32,36,68,2022,01-16,22:49
056 Albert 1er - Cath�drale,7,5,12,2022,01-16,22:49
057 Saint-Guilhem - Courreau,3,5,8,2022,01-16,22:49
059 Sud De France,0,8,8,2022,01-16,22:49
001 Rue Jules Ferry - Gare Saint-Roch,7,5,12,2022,01-16,22:59
002 Com�die,8,16,24,2022,01-16,22:59
003 Esplanade,2,30,32,2022,01-16,22:59
004 H�tel de Ville,14,2,16,2022,01-16,22:59
005 Corum,5,7,12,2022,01-16,22:59
006 Place Albert 1er - St Charles,15,16,31,2022,01-16,22:59
007 Foch,3,5,8,2022,01-16,22:59
008 Halles Castellane,1,11,12,2022,01-16,22:59
009 Observatoire,5,3,8,2022,01-16,22:59
010 Rondelet,3,13,16,2022,01-16,22:59
011 Plan Cabanes,3,9,12,2022,01-16,22:59
012 Boutonnet,1,11,12,2022,01-16,22:59
013 Emile Combes,5,3,8,2022,01-16,22:59
014 Beaux-Arts,7,1,8,2022,01-16,22:59
015 Les Aubes,5,3,8,2022,01-16,22:59
016 Antigone centre,14,2,16,2022,01-16,22:59
017 M�diath�que Emile Zola,8,8,16,2022,01-16,22:59
018 Nombre d'Or,15,1,16,2022,01-16,22:59
019 Louis Blanc,9,7,16,2022,01-16,22:59
020 Gambetta,1,7,8,2022,01-16,22:59
021 Port Marianne,16,0,16,2022,01-16,22:59
022 Clemenceau,5,7,12,2022,01-16,22:59
023 Les Arceaux,2,14,16,2022,01-16,22:59
024 Cit� Mion,3,5,8,2022,01-16,22:59
025 Nouveau Saint-Roch,3,5,8,2022,01-16,22:59
026 Renouvier,0,8,8,2022,01-16,22:59
027 Odysseum,3,5,8,2022,01-16,22:59
028 Saint-Denis,8,0,8,2022,01-16,22:59
029 Richter,7,9,16,2022,01-16,22:59
030 Charles Flahault,6,2,8,2022,01-16,22:59
031 Voltaire,0,8,8,2022,01-16,22:59
032 Pr�s d'Ar�nes,7,1,8,2022,01-16,22:59
033 Garcia Lorca,8,0,8,2022,01-16,22:59
034 Vert Bois,0,16,16,2022,01-16,22:59
035 Malbosc,0,8,8,2022,01-16,22:59
036 Occitanie,3,29,32,2022,01-16,22:59
037 FacdesSciences,9,15,24,2022,01-16,22:59
038 Fac de Lettres,6,10,16,2022,01-16,22:59
039 Aiguelongue,6,2,8,2022,01-16,22:59
040 Jeu de Mail des Abb�s,5,3,8,2022,01-16,22:59
041 Eurom�decine,1,7,8,2022,01-16,22:59
042 Marie Caizergues,1,7,8,2022,01-16,22:59
043 Sabines,4,4,8,2022,01-16,22:59
044 Celleneuve,3,5,8,2022,01-16,22:59
045 Jardin de la Lironde,4,4,8,2022,01-16,22:59
046 P�re Soulas,2,6,8,2022,01-16,22:59
047 Place Viala,1,7,8,2022,01-16,22:59
048 H�tel du D�partement,1,7,8,2022,01-16,22:59
049 Tonnelles,2,6,8,2022,01-16,22:59
050 Parvis Jules Ferry - Gare Saint-Roch,8,0,8,2022,01-16,22:59
051 Pont de Lattes - Gare Saint-Roch,0,12,12,2022,01-16,22:59
053 Deux Ponts - Gare Saint-Roch,2,6,8,2022,01-16,22:59
054 Providence - Ovalie,1,7,8,2022,01-16,22:59
055 P�rols Etang de l'Or,32,36,68,2022,01-16,22:59
056 Albert 1er - Cath�drale,7,5,12,2022,01-16,22:59
057 Saint-Guilhem - Courreau,3,5,8,2022,01-16,22:59
059 Sud De France,0,8,8,2022,01-16,22:59
001 Rue Jules Ferry - Gare Saint-Roch,7,5,12,2022,01-16,23:09
002 Com�die,8,16,24,2022,01-16,23:09
003 Esplanade,2,30,32,2022,01-16,23:09
004 H�tel de Ville,14,2,16,2022,01-16,23:09
005 Corum,5,7,12,2022,01-16,23:09
006 Place Albert 1er - St Charles,16,15,31,2022,01-16,23:09
007 Foch,3,5,8,2022,01-16,23:09
008 Halles Castellane,1,11,12,2022,01-16,23:09
009 Observatoire,4,4,8,2022,01-16,23:09
010 Rondelet,3,13,16,2022,01-16,23:09
011 Plan Cabanes,4,8,12,2022,01-16,23:09
012 Boutonnet,1,11,12,2022,01-16,23:09
013 Emile Combes,5,3,8,2022,01-16,23:09
014 Beaux-Arts,7,1,8,2022,01-16,23:09
015 Les Aubes,5,3,8,2022,01-16,23:09
016 Antigone centre,14,2,16,2022,01-16,23:09
017 M�diath�que Emile Zola,8,8,16,2022,01-16,23:09
018 Nombre d'Or,15,1,16,2022,01-16,23:09
019 Louis Blanc,7,9,16,2022,01-16,23:09
020 Gambetta,1,7,8,2022,01-16,23:09
021 Port Marianne,16,0,16,2022,01-16,23:09
022 Clemenceau,5,7,12,2022,01-16,23:09
023 Les Arceaux,2,14,16,2022,01-16,23:09
024 Cit� Mion,3,5,8,2022,01-16,23:09
025 Nouveau Saint-Roch,3,5,8,2022,01-16,23:09
026 Renouvier,0,8,8,2022,01-16,23:09
027 Odysseum,3,5,8,2022,01-16,23:09
028 Saint-Denis,8,0,8,2022,01-16,23:09
029 Richter,7,9,16,2022,01-16,23:09
030 Charles Flahault,4,4,8,2022,01-16,23:09
031 Voltaire,0,8,8,2022,01-16,23:09
032 Pr�s d'Ar�nes,7,1,8,2022,01-16,23:09
033 Garcia Lorca,8,0,8,2022,01-16,23:09
034 Vert Bois,0,16,16,2022,01-16,23:09
035 Malbosc,0,8,8,2022,01-16,23:09
036 Occitanie,3,29,32,2022,01-16,23:09
037 FacdesSciences,9,15,24,2022,01-16,23:09
038 Fac de Lettres,6,10,16,2022,01-16,23:09
039 Aiguelongue,6,2,8,2022,01-16,23:09
040 Jeu de Mail des Abb�s,5,3,8,2022,01-16,23:09
041 Eurom�decine,1,7,8,2022,01-16,23:09
042 Marie Caizergues,1,7,8,2022,01-16,23:09
043 Sabines,4,4,8,2022,01-16,23:09
044 Celleneuve,3,5,8,2022,01-16,23:09
045 Jardin de la Lironde,4,4,8,2022,01-16,23:09
046 P�re Soulas,2,6,8,2022,01-16,23:09
047 Place Viala,1,7,8,2022,01-16,23:09
048 H�tel du D�partement,1,7,8,2022,01-16,23:09
049 Tonnelles,2,6,8,2022,01-16,23:09
050 Parvis Jules Ferry - Gare Saint-Roch,8,0,8,2022,01-16,23:09
051 Pont de Lattes - Gare Saint-Roch,0,12,12,2022,01-16,23:09
053 Deux Ponts - Gare Saint-Roch,2,6,8,2022,01-16,23:09
054 Providence - Ovalie,1,7,8,2022,01-16,23:09
055 P�rols Etang de l'Or,32,36,68,2022,01-16,23:09
056 Albert 1er - Cath�drale,7,5,12,2022,01-16,23:09
057 Saint-Guilhem - Courreau,2,6,8,2022,01-16,23:09
059 Sud De France,0,8,8,2022,01-16,23:09
001 Rue Jules Ferry - Gare Saint-Roch,7,5,12,2022,01-16,23:19
002 Com�die,8,16,24,2022,01-16,23:19
003 Esplanade,2,30,32,2022,01-16,23:19
004 H�tel de Ville,14,2,16,2022,01-16,23:19
005 Corum,5,7,12,2022,01-16,23:19
006 Place Albert 1er - St Charles,16,15,31,2022,01-16,23:19
007 Foch,3,5,8,2022,01-16,23:19
008 Halles Castellane,1,11,12,2022,01-16,23:19
009 Observatoire,4,4,8,2022,01-16,23:19
010 Rondelet,3,13,16,2022,01-16,23:19
011 Plan Cabanes,4,8,12,2022,01-16,23:19
012 Boutonnet,3,9,12,2022,01-16,23:19
013 Emile Combes,5,3,8,2022,01-16,23:19
014 Beaux-Arts,7,1,8,2022,01-16,23:19
015 Les Aubes,5,3,8,2022,01-16,23:19
016 Antigone centre,14,2,16,2022,01-16,23:19
017 M�diath�que Emile Zola,8,8,16,2022,01-16,23:19
018 Nombre d'Or,15,1,16,2022,01-16,23:19
019 Louis Blanc,7,9,16,2022,01-16,23:19
020 Gambetta,1,7,8,2022,01-16,23:19
021 Port Marianne,16,0,16,2022,01-16,23:19
022 Clemenceau,5,7,12,2022,01-16,23:19
023 Les Arceaux,2,14,16,2022,01-16,23:19
024 Cit� Mion,3,5,8,2022,01-16,23:19
025 Nouveau Saint-Roch,3,5,8,2022,01-16,23:19
026 Renouvier,0,8,8,2022,01-16,23:19
027 Odysseum,3,5,8,2022,01-16,23:19
028 Saint-Denis,8,0,8,2022,01-16,23:19
029 Richter,7,9,16,2022,01-16,23:19
030 Charles Flahault,4,4,8,2022,01-16,23:19
031 Voltaire,0,8,8,2022,01-16,23:19
032 Pr�s d'Ar�nes,7,1,8,2022,01-16,23:19
033 Garcia Lorca,8,0,8,2022,01-16,23:19
034 Vert Bois,0,16,16,2022,01-16,23:19
035 Malbosc,0,8,8,2022,01-16,23:19
036 Occitanie,3,29,32,2022,01-16,23:19
037 FacdesSciences,11,13,24,2022,01-16,23:19
038 Fac de Lettres,6,10,16,2022,01-16,23:19
039 Aiguelongue,6,2,8,2022,01-16,23:19
040 Jeu de Mail des Abb�s,7,1,8,2022,01-16,23:19
041 Eurom�decine,1,7,8,2022,01-16,23:19
042 Marie Caizergues,1,7,8,2022,01-16,23:19
043 Sabines,4,4,8,2022,01-16,23:19
044 Celleneuve,3,5,8,2022,01-16,23:19
045 Jardin de la Lironde,4,4,8,2022,01-16,23:19
046 P�re Soulas,2,6,8,2022,01-16,23:19
047 Place Viala,2,6,8,2022,01-16,23:19
048 H�tel du D�partement,1,7,8,2022,01-16,23:19
049 Tonnelles,2,6,8,2022,01-16,23:19
050 Parvis Jules Ferry - Gare Saint-Roch,8,0,8,2022,01-16,23:19
051 Pont de Lattes - Gare Saint-Roch,0,12,12,2022,01-16,23:19
053 Deux Ponts - Gare Saint-Roch,2,6,8,2022,01-16,23:19
054 Providence - Ovalie,1,7,8,2022,01-16,23:19
055 P�rols Etang de l'Or,32,36,68,2022,01-16,23:19
056 Albert 1er - Cath�drale,7,5,12,2022,01-16,23:19
057 Saint-Guilhem - Courreau,2,6,8,2022,01-16,23:19
059 Sud De France,0,8,8,2022,01-16,23:19
001 Rue Jules Ferry - Gare Saint-Roch,7,5,12,2022,01-16,23:29
002 Com�die,8,16,24,2022,01-16,23:29
003 Esplanade,2,30,32,2022,01-16,23:29
004 H�tel de Ville,14,2,16,2022,01-16,23:29
005 Corum,5,7,12,2022,01-16,23:29
006 Place Albert 1er - St Charles,16,15,31,2022,01-16,23:29
007 Foch,3,5,8,2022,01-16,23:29
008 Halles Castellane,1,11,12,2022,01-16,23:29
009 Observatoire,4,4,8,2022,01-16,23:29
010 Rondelet,3,13,16,2022,01-16,23:29
011 Plan Cabanes,4,8,12,2022,01-16,23:29
012 Boutonnet,3,9,12,2022,01-16,23:29
013 Emile Combes,5,3,8,2022,01-16,23:29
014 Beaux-Arts,7,1,8,2022,01-16,23:29
015 Les Aubes,5,3,8,2022,01-16,23:29
016 Antigone centre,14,2,16,2022,01-16,23:29
017 M�diath�que Emile Zola,8,8,16,2022,01-16,23:29
018 Nombre d'Or,15,1,16,2022,01-16,23:29
019 Louis Blanc,7,9,16,2022,01-16,23:29
020 Gambetta,1,7,8,2022,01-16,23:29
021 Port Marianne,16,0,16,2022,01-16,23:29
022 Clemenceau,5,7,12,2022,01-16,23:29
023 Les Arceaux,2,14,16,2022,01-16,23:29
024 Cit� Mion,3,5,8,2022,01-16,23:29
025 Nouveau Saint-Roch,3,5,8,2022,01-16,23:29
026 Renouvier,0,8,8,2022,01-16,23:29
027 Odysseum,3,5,8,2022,01-16,23:29
028 Saint-Denis,8,0,8,2022,01-16,23:29
029 Richter,7,9,16,2022,01-16,23:29
030 Charles Flahault,4,4,8,2022,01-16,23:29
031 Voltaire,0,8,8,2022,01-16,23:29
032 Pr�s d'Ar�nes,7,1,8,2022,01-16,23:29
033 Garcia Lorca,8,0,8,2022,01-16,23:29
034 Vert Bois,0,16,16,2022,01-16,23:29
035 Malbosc,0,8,8,2022,01-16,23:29
036 Occitanie,3,29,32,2022,01-16,23:29
037 FacdesSciences,11,13,24,2022,01-16,23:29
038 Fac de Lettres,6,10,16,2022,01-16,23:29
039 Aiguelongue,6,2,8,2022,01-16,23:29
040 Jeu de Mail des Abb�s,7,1,8,2022,01-16,23:29
041 Eurom�decine,1,7,8,2022,01-16,23:29
042 Marie Caizergues,1,7,8,2022,01-16,23:29
043 Sabines,4,4,8,2022,01-16,23:29
044 Celleneuve,4,4,8,2022,01-16,23:29
045 Jardin de la Lironde,4,4,8,2022,01-16,23:29
046 P�re Soulas,3,5,8,2022,01-16,23:29
047 Place Viala,2,6,8,2022,01-16,23:29
048 H�tel du D�partement,1,7,8,2022,01-16,23:29
049 Tonnelles,1,7,8,2022,01-16,23:29
050 Parvis Jules Ferry - Gare Saint-Roch,8,0,8,2022,01-16,23:29
051 Pont de Lattes - Gare Saint-Roch,0,12,12,2022,01-16,23:29
053 Deux Ponts - Gare Saint-Roch,2,6,8,2022,01-16,23:29
054 Providence - Ovalie,1,7,8,2022,01-16,23:29
055 P�rols Etang de l'Or,32,36,68,2022,01-16,23:29
056 Albert 1er - Cath�drale,7,5,12,2022,01-16,23:29
057 Saint-Guilhem - Courreau,2,6,8,2022,01-16,23:29
059 Sud De France,0,8,8,2022,01-16,23:29
001 Rue Jules Ferry - Gare Saint-Roch,7,5,12,2022,01-16,23:39
002 Com�die,8,16,24,2022,01-16,23:39
003 Esplanade,2,30,32,2022,01-16,23:39
004 H�tel de Ville,14,2,16,2022,01-16,23:39
005 Corum,5,7,12,2022,01-16,23:39
006 Place Albert 1er - St Charles,16,15,31,2022,01-16,23:39
007 Foch,3,5,8,2022,01-16,23:39
008 Halles Castellane,1,11,12,2022,01-16,23:39
009 Observatoire,4,4,8,2022,01-16,23:39
010 Rondelet,3,13,16,2022,01-16,23:39
011 Plan Cabanes,4,8,12,2022,01-16,23:39
012 Boutonnet,3,9,12,2022,01-16,23:39
013 Emile Combes,5,3,8,2022,01-16,23:39
014 Beaux-Arts,7,1,8,2022,01-16,23:39
015 Les Aubes,6,2,8,2022,01-16,23:39
016 Antigone centre,14,2,16,2022,01-16,23:39
017 M�diath�que Emile Zola,8,8,16,2022,01-16,23:39
018 Nombre d'Or,15,1,16,2022,01-16,23:39
019 Louis Blanc,7,9,16,2022,01-16,23:39
020 Gambetta,1,7,8,2022,01-16,23:39
021 Port Marianne,16,0,16,2022,01-16,23:39
022 Clemenceau,5,7,12,2022,01-16,23:39
023 Les Arceaux,2,14,16,2022,01-16,23:39
024 Cit� Mion,3,5,8,2022,01-16,23:39
025 Nouveau Saint-Roch,2,6,8,2022,01-16,23:39
026 Renouvier,0,8,8,2022,01-16,23:39
027 Odysseum,3,5,8,2022,01-16,23:39
028 Saint-Denis,8,0,8,2022,01-16,23:39
029 Richter,7,9,16,2022,01-16,23:39
030 Charles Flahault,4,4,8,2022,01-16,23:39
031 Voltaire,0,8,8,2022,01-16,23:39
032 Pr�s d'Ar�nes,7,1,8,2022,01-16,23:39
033 Garcia Lorca,7,1,8,2022,01-16,23:39
034 Vert Bois,0,16,16,2022,01-16,23:39
035 Malbosc,0,8,8,2022,01-16,23:39
036 Occitanie,3,29,32,2022,01-16,23:39
037 FacdesSciences,11,13,24,2022,01-16,23:39
038 Fac de Lettres,6,10,16,2022,01-16,23:39
039 Aiguelongue,6,2,8,2022,01-16,23:39
040 Jeu de Mail des Abb�s,7,1,8,2022,01-16,23:39
041 Eurom�decine,1,7,8,2022,01-16,23:39
042 Marie Caizergues,1,7,8,2022,01-16,23:39
043 Sabines,4,4,8,2022,01-16,23:39
044 Celleneuve,4,4,8,2022,01-16,23:39
045 Jardin de la Lironde,4,4,8,2022,01-16,23:39
046 P�re Soulas,4,4,8,2022,01-16,23:39
047 Place Viala,2,6,8,2022,01-16,23:39
048 H�tel du D�partement,1,7,8,2022,01-16,23:39
049 Tonnelles,1,7,8,2022,01-16,23:39
050 Parvis Jules Ferry - Gare Saint-Roch,8,0,8,2022,01-16,23:39
051 Pont de Lattes - Gare Saint-Roch,0,12,12,2022,01-16,23:39
053 Deux Ponts - Gare Saint-Roch,3,5,8,2022,01-16,23:39
054 Providence - Ovalie,1,7,8,2022,01-16,23:39
055 P�rols Etang de l'Or,32,36,68,2022,01-16,23:39
056 Albert 1er - Cath�drale,7,5,12,2022,01-16,23:39
057 Saint-Guilhem - Courreau,2,6,8,2022,01-16,23:39
059 Sud De France,0,8,8,2022,01-16,23:39
001 Rue Jules Ferry - Gare Saint-Roch,7,5,12,2022,01-16,23:50
002 Com�die,8,16,24,2022,01-16,23:50
003 Esplanade,2,30,32,2022,01-16,23:50
004 H�tel de Ville,14,2,16,2022,01-16,23:50
005 Corum,5,7,12,2022,01-16,23:50
006 Place Albert 1er - St Charles,16,15,31,2022,01-16,23:50
007 Foch,3,5,8,2022,01-16,23:50
008 Halles Castellane,1,11,12,2022,01-16,23:50
009 Observatoire,4,4,8,2022,01-16,23:50
010 Rondelet,3,13,16,2022,01-16,23:50
011 Plan Cabanes,4,8,12,2022,01-16,23:50
012 Boutonnet,2,10,12,2022,01-16,23:50
013 Emile Combes,6,2,8,2022,01-16,23:50
014 Beaux-Arts,7,1,8,2022,01-16,23:50
015 Les Aubes,6,2,8,2022,01-16,23:50
016 Antigone centre,14,2,16,2022,01-16,23:50
017 M�diath�que Emile Zola,8,8,16,2022,01-16,23:50
018 Nombre d'Or,15,1,16,2022,01-16,23:50
019 Louis Blanc,7,9,16,2022,01-16,23:50
020 Gambetta,1,7,8,2022,01-16,23:50
021 Port Marianne,16,0,16,2022,01-16,23:50
022 Clemenceau,5,7,12,2022,01-16,23:50
023 Les Arceaux,2,14,16,2022,01-16,23:50
024 Cit� Mion,3,5,8,2022,01-16,23:50
025 Nouveau Saint-Roch,2,6,8,2022,01-16,23:50
026 Renouvier,0,8,8,2022,01-16,23:50
027 Odysseum,3,5,8,2022,01-16,23:50
028 Saint-Denis,8,0,8,2022,01-16,23:50
029 Richter,7,9,16,2022,01-16,23:50
030 Charles Flahault,4,4,8,2022,01-16,23:50
031 Voltaire,0,8,8,2022,01-16,23:50
032 Pr�s d'Ar�nes,7,1,8,2022,01-16,23:50
033 Garcia Lorca,7,1,8,2022,01-16,23:50
034 Vert Bois,0,16,16,2022,01-16,23:50
035 Malbosc,0,8,8,2022,01-16,23:50
036 Occitanie,3,29,32,2022,01-16,23:50
037 FacdesSciences,11,13,24,2022,01-16,23:50
038 Fac de Lettres,6,10,16,2022,01-16,23:50
039 Aiguelongue,6,2,8,2022,01-16,23:50
040 Jeu de Mail des Abb�s,7,1,8,2022,01-16,23:50
041 Eurom�decine,1,7,8,2022,01-16,23:50
042 Marie Caizergues,1,7,8,2022,01-16,23:50
043 Sabines,2,6,8,2022,01-16,23:50
044 Celleneuve,4,4,8,2022,01-16,23:50
045 Jardin de la Lironde,4,4,8,2022,01-16,23:50
046 P�re Soulas,4,4,8,2022,01-16,23:50
047 Place Viala,2,6,8,2022,01-16,23:50
048 H�tel du D�partement,1,7,8,2022,01-16,23:50
049 Tonnelles,1,7,8,2022,01-16,23:50
050 Parvis Jules Ferry - Gare Saint-Roch,8,0,8,2022,01-16,23:50
051 Pont de Lattes - Gare Saint-Roch,0,12,12,2022,01-16,23:50
053 Deux Ponts - Gare Saint-Roch,3,5,8,2022,01-16,23:50
054 Providence - Ovalie,1,7,8,2022,01-16,23:50
055 P�rols Etang de l'Or,32,36,68,2022,01-16,23:50
056 Albert 1er - Cath�drale,7,5,12,2022,01-16,23:50
057 Saint-Guilhem - Courreau,2,6,8,2022,01-16,23:50
059 Sud De France,0,8,8,2022,01-16,23:50
001 Rue Jules Ferry - Gare Saint-Roch,7,5,12,2022,01-17,00:00
002 Com�die,8,16,24,2022,01-17,00:00
003 Esplanade,2,30,32,2022,01-17,00:00
008 Halles Castellane,1,11,12,2022,01-17,00:00
009 Observatoire,4,4,8,2022,01-17,00:00
010 Rondelet,3,13,16,2022,01-17,00:00
011 Plan Cabanes,4,8,12,2022,01-17,00:00
012 Boutonnet,2,10,12,2022,01-17,00:00
013 Emile Combes,6,2,8,2022,01-17,00:00
014 Beaux-Arts,7,1,8,2022,01-17,00:00
015 Les Aubes,6,2,8,2022,01-17,00:00
016 Antigone centre,14,2,16,2022,01-17,00:00
017 M�diath�que Emile Zola,8,8,16,2022,01-17,00:00
018 Nombre d'Or,15,1,16,2022,01-17,00:00
019 Louis Blanc,6,10,16,2022,01-17,00:00
020 Gambetta,1,7,8,2022,01-17,00:00
021 Port Marianne,16,0,16,2022,01-17,00:00
022 Clemenceau,5,7,12,2022,01-17,00:00
023 Les Arceaux,2,14,16,2022,01-17,00:00
024 Cit� Mion,3,5,8,2022,01-17,00:00
025 Nouveau Saint-Roch,2,6,8,2022,01-17,00:00
026 Renouvier,0,8,8,2022,01-17,00:00
027 Odysseum,3,5,8,2022,01-17,00:00
028 Saint-Denis,8,0,8,2022,01-17,00:00
029 Richter,7,9,16,2022,01-17,00:00
030 Charles Flahault,4,4,8,2022,01-17,00:00
031 Voltaire,0,8,8,2022,01-17,00:00
032 Pr�s d'Ar�nes,7,1,8,2022,01-17,00:00
033 Garcia Lorca,7,1,8,2022,01-17,00:00
034 Vert Bois,0,16,16,2022,01-17,00:00
035 Malbosc,0,8,8,2022,01-17,00:00
036 Occitanie,3,29,32,2022,01-17,00:00
037 FacdesSciences,11,13,24,2022,01-17,00:00
038 Fac de Lettres,6,10,16,2022,01-17,00:00
039 Aiguelongue,6,2,8,2022,01-17,00:00
040 Jeu de Mail des Abb�s,7,1,8,2022,01-17,00:00
041 Eurom�decine,1,7,8,2022,01-17,00:00
042 Marie Caizergues,2,6,8,2022,01-17,00:00
043 Sabines,2,6,8,2022,01-17,00:00
044 Celleneuve,4,4,8,2022,01-17,00:00
045 Jardin de la Lironde,4,4,8,2022,01-17,00:00
046 P�re Soulas,4,4,8,2022,01-17,00:00
047 Place Viala,2,6,8,2022,01-17,00:00
048 H�tel du D�partement,1,7,8,2022,01-17,00:00
049 Tonnelles,1,7,8,2022,01-17,00:00
050 Parvis Jules Ferry - Gare Saint-Roch,8,0,8,2022,01-17,00:00
051 Pont de Lattes - Gare Saint-Roch,0,12,12,2022,01-17,00:00
053 Deux Ponts - Gare Saint-Roch,3,5,8,2022,01-17,00:00
054 Providence - Ovalie,3,5,8,2022,01-17,00:00
055 P�rols Etang de l'Or,32,36,68,2022,01-17,00:00
056 Albert 1er - Cath�drale,7,5,12,2022,01-17,00:00
057 Saint-Guilhem - Courreau,2,6,8,2022,01-17,00:00
059 Sud De France,0,8,8,2022,01-17,00:00
001 Rue Jules Ferry - Gare Saint-Roch,7,5,12,2022,01-17,00:10
002 Com�die,8,16,24,2022,01-17,00:10
003 Esplanade,2,30,32,2022,01-17,00:10
004 H�tel de Ville,14,2,16,2022,01-17,00:10
005 Corum,5,7,12,2022,01-17,00:10
006 Place Albert 1er - St Charles,16,15,31,2022,01-17,00:10
007 Foch,3,5,8,2022,01-17,00:10
008 Halles Castellane,1,11,12,2022,01-17,00:10
009 Observatoire,4,4,8,2022,01-17,00:10
010 Rondelet,4,12,16,2022,01-17,00:10
011 Plan Cabanes,4,8,12,2022,01-17,00:10
012 Boutonnet,2,10,12,2022,01-17,00:10
013 Emile Combes,6,2,8,2022,01-17,00:10
014 Beaux-Arts,7,1,8,2022,01-17,00:10
015 Les Aubes,6,2,8,2022,01-17,00:10
016 Antigone centre,14,2,16,2022,01-17,00:10
017 M�diath�que Emile Zola,8,8,16,2022,01-17,00:10
018 Nombre d'Or,15,1,16,2022,01-17,00:10
019 Louis Blanc,6,10,16,2022,01-17,00:10
020 Gambetta,1,7,8,2022,01-17,00:10
021 Port Marianne,16,0,16,2022,01-17,00:10
022 Clemenceau,5,7,12,2022,01-17,00:10
023 Les Arceaux,2,14,16,2022,01-17,00:10
024 Cit� Mion,3,5,8,2022,01-17,00:10
025 Nouveau Saint-Roch,2,6,8,2022,01-17,00:10
026 Renouvier,0,8,8,2022,01-17,00:10
027 Odysseum,3,5,8,2022,01-17,00:10
028 Saint-Denis,8,0,8,2022,01-17,00:10
029 Richter,7,9,16,2022,01-17,00:10
030 Charles Flahault,4,4,8,2022,01-17,00:10
031 Voltaire,0,8,8,2022,01-17,00:10
032 Pr�s d'Ar�nes,7,1,8,2022,01-17,00:10
033 Garcia Lorca,7,1,8,2022,01-17,00:10
034 Vert Bois,0,16,16,2022,01-17,00:10
035 Malbosc,0,8,8,2022,01-17,00:10
036 Occitanie,3,29,32,2022,01-17,00:10
037 FacdesSciences,11,13,24,2022,01-17,00:10
038 Fac de Lettres,6,10,16,2022,01-17,00:10
039 Aiguelongue,6,2,8,2022,01-17,00:10
040 Jeu de Mail des Abb�s,7,1,8,2022,01-17,00:10
041 Eurom�decine,1,7,8,2022,01-17,00:10
042 Marie Caizergues,2,6,8,2022,01-17,00:10
043 Sabines,2,6,8,2022,01-17,00:10
044 Celleneuve,4,4,8,2022,01-17,00:10
045 Jardin de la Lironde,4,4,8,2022,01-17,00:10
046 P�re Soulas,4,4,8,2022,01-17,00:10
047 Place Viala,2,6,8,2022,01-17,00:10
048 H�tel du D�partement,1,7,8,2022,01-17,00:10
049 Tonnelles,1,7,8,2022,01-17,00:10
050 Parvis Jules Ferry - Gare Saint-Roch,8,0,8,2022,01-17,00:10
051 Pont de Lattes - Gare Saint-Roch,0,12,12,2022,01-17,00:10
053 Deux Ponts - Gare Saint-Roch,3,5,8,2022,01-17,00:10
054 Providence - Ovalie,3,5,8,2022,01-17,00:10
055 P�rols Etang de l'Or,32,36,68,2022,01-17,00:10
056 Albert 1er - Cath�drale,7,5,12,2022,01-17,00:10
057 Saint-Guilhem - Courreau,2,6,8,2022,01-17,00:10
059 Sud De France,0,8,8,2022,01-17,00:10
001 Rue Jules Ferry - Gare Saint-Roch,7,5,12,2022,01-17,00:20
002 Com�die,8,16,24,2022,01-17,00:20
003 Esplanade,2,30,32,2022,01-17,00:20
004 H�tel de Ville,14,2,16,2022,01-17,00:20
005 Corum,5,7,12,2022,01-17,00:20
006 Place Albert 1er - St Charles,16,15,31,2022,01-17,00:20
007 Foch,3,5,8,2022,01-17,00:20
008 Halles Castellane,0,12,12,2022,01-17,00:20
009 Observatoire,4,4,8,2022,01-17,00:20
010 Rondelet,4,12,16,2022,01-17,00:20
011 Plan Cabanes,4,8,12,2022,01-17,00:20
012 Boutonnet,2,10,12,2022,01-17,00:20
013 Emile Combes,6,2,8,2022,01-17,00:20
014 Beaux-Arts,7,1,8,2022,01-17,00:20
015 Les Aubes,6,2,8,2022,01-17,00:20
016 Antigone centre,14,2,16,2022,01-17,00:20
017 M�diath�que Emile Zola,8,8,16,2022,01-17,00:20
018 Nombre d'Or,15,1,16,2022,01-17,00:20
019 Louis Blanc,6,10,16,2022,01-17,00:20
020 Gambetta,1,7,8,2022,01-17,00:20
021 Port Marianne,16,0,16,2022,01-17,00:20
022 Clemenceau,5,7,12,2022,01-17,00:20
023 Les Arceaux,2,14,16,2022,01-17,00:20
024 Cit� Mion,3,5,8,2022,01-17,00:20
025 Nouveau Saint-Roch,2,6,8,2022,01-17,00:20
026 Renouvier,0,8,8,2022,01-17,00:20
027 Odysseum,3,5,8,2022,01-17,00:20
028 Saint-Denis,8,0,8,2022,01-17,00:20
029 Richter,7,9,16,2022,01-17,00:20
030 Charles Flahault,4,4,8,2022,01-17,00:20
031 Voltaire,0,8,8,2022,01-17,00:20
032 Pr�s d'Ar�nes,7,1,8,2022,01-17,00:20
033 Garcia Lorca,7,1,8,2022,01-17,00:20
034 Vert Bois,0,16,16,2022,01-17,00:20
035 Malbosc,0,8,8,2022,01-17,00:20
036 Occitanie,3,29,32,2022,01-17,00:20
037 FacdesSciences,11,13,24,2022,01-17,00:20
038 Fac de Lettres,6,10,16,2022,01-17,00:20
039 Aiguelongue,6,2,8,2022,01-17,00:20
040 Jeu de Mail des Abb�s,7,1,8,2022,01-17,00:20
041 Eurom�decine,1,7,8,2022,01-17,00:20
042 Marie Caizergues,2,6,8,2022,01-17,00:20
043 Sabines,2,6,8,2022,01-17,00:20
044 Celleneuve,4,4,8,2022,01-17,00:20
045 Jardin de la Lironde,4,4,8,2022,01-17,00:20
046 P�re Soulas,4,4,8,2022,01-17,00:20
047 Place Viala,2,6,8,2022,01-17,00:20
048 H�tel du D�partement,1,7,8,2022,01-17,00:20
049 Tonnelles,1,7,8,2022,01-17,00:20
050 Parvis Jules Ferry - Gare Saint-Roch,8,0,8,2022,01-17,00:20
051 Pont de Lattes - Gare Saint-Roch,0,12,12,2022,01-17,00:20
053 Deux Ponts - Gare Saint-Roch,3,5,8,2022,01-17,00:20
054 Providence - Ovalie,3,5,8,2022,01-17,00:20
055 P�rols Etang de l'Or,32,36,68,2022,01-17,00:20
056 Albert 1er - Cath�drale,7,5,12,2022,01-17,00:20
057 Saint-Guilhem - Courreau,2,6,8,2022,01-17,00:20
059 Sud De France,0,8,8,2022,01-17,00:20
001 Rue Jules Ferry - Gare Saint-Roch,7,5,12,2022,01-17,00:30
002 Com�die,8,16,24,2022,01-17,00:30
003 Esplanade,2,30,32,2022,01-17,00:30
004 H�tel de Ville,14,2,16,2022,01-17,00:30
005 Corum,4,8,12,2022,01-17,00:30
006 Place Albert 1er - St Charles,16,15,31,2022,01-17,00:30
007 Foch,3,5,8,2022,01-17,00:30
008 Halles Castellane,0,12,12,2022,01-17,00:30
009 Observatoire,4,4,8,2022,01-17,00:30
010 Rondelet,4,12,16,2022,01-17,00:30
011 Plan Cabanes,5,7,12,2022,01-17,00:30
012 Boutonnet,2,10,12,2022,01-17,00:30
013 Emile Combes,6,2,8,2022,01-17,00:30
014 Beaux-Arts,7,1,8,2022,01-17,00:30
015 Les Aubes,6,2,8,2022,01-17,00:30
016 Antigone centre,14,2,16,2022,01-17,00:30
017 M�diath�que Emile Zola,8,8,16,2022,01-17,00:30
018 Nombre d'Or,15,1,16,2022,01-17,00:30
019 Louis Blanc,6,10,16,2022,01-17,00:30
020 Gambetta,1,7,8,2022,01-17,00:30
021 Port Marianne,16,0,16,2022,01-17,00:30
022 Clemenceau,5,7,12,2022,01-17,00:30
023 Les Arceaux,2,14,16,2022,01-17,00:30
024 Cit� Mion,3,5,8,2022,01-17,00:30
025 Nouveau Saint-Roch,2,6,8,2022,01-17,00:30
026 Renouvier,0,8,8,2022,01-17,00:30
027 Odysseum,3,5,8,2022,01-17,00:30
028 Saint-Denis,8,0,8,2022,01-17,00:30
029 Richter,7,9,16,2022,01-17,00:30
030 Charles Flahault,4,4,8,2022,01-17,00:30
031 Voltaire,0,8,8,2022,01-17,00:30
032 Pr�s d'Ar�nes,7,1,8,2022,01-17,00:30
033 Garcia Lorca,7,1,8,2022,01-17,00:30
034 Vert Bois,0,16,16,2022,01-17,00:30
035 Malbosc,0,8,8,2022,01-17,00:30
036 Occitanie,3,29,32,2022,01-17,00:30
037 FacdesSciences,10,14,24,2022,01-17,00:30
038 Fac de Lettres,6,10,16,2022,01-17,00:30
039 Aiguelongue,6,2,8,2022,01-17,00:30
040 Jeu de Mail des Abb�s,7,1,8,2022,01-17,00:30
041 Eurom�decine,1,7,8,2022,01-17,00:30
042 Marie Caizergues,2,6,8,2022,01-17,00:30
043 Sabines,2,6,8,2022,01-17,00:30
044 Celleneuve,4,4,8,2022,01-17,00:30
045 Jardin de la Lironde,4,4,8,2022,01-17,00:30
046 P�re Soulas,4,4,8,2022,01-17,00:30
047 Place Viala,2,6,8,2022,01-17,00:30
048 H�tel du D�partement,1,7,8,2022,01-17,00:30
049 Tonnelles,1,7,8,2022,01-17,00:30
050 Parvis Jules Ferry - Gare Saint-Roch,8,0,8,2022,01-17,00:30
051 Pont de Lattes - Gare Saint-Roch,0,12,12,2022,01-17,00:30
053 Deux Ponts - Gare Saint-Roch,3,5,8,2022,01-17,00:30
054 Providence - Ovalie,3,5,8,2022,01-17,00:30
055 P�rols Etang de l'Or,32,36,68,2022,01-17,00:30
056 Albert 1er - Cath�drale,7,5,12,2022,01-17,00:30
057 Saint-Guilhem - Courreau,2,6,8,2022,01-17,00:30
059 Sud De France,0,8,8,2022,01-17,00:30
001 Rue Jules Ferry - Gare Saint-Roch,7,5,12,2022,01-17,00:40
002 Com�die,8,16,24,2022,01-17,00:40
003 Esplanade,2,30,32,2022,01-17,00:40
004 H�tel de Ville,14,2,16,2022,01-17,00:40
005 Corum,4,8,12,2022,01-17,00:40
006 Place Albert 1er - St Charles,17,14,31,2022,01-17,00:40
007 Foch,3,5,8,2022,01-17,00:40
008 Halles Castellane,0,12,12,2022,01-17,00:40
009 Observatoire,4,4,8,2022,01-17,00:40
010 Rondelet,4,12,16,2022,01-17,00:40
011 Plan Cabanes,5,7,12,2022,01-17,00:40
012 Boutonnet,2,10,12,2022,01-17,00:40
013 Emile Combes,6,2,8,2022,01-17,00:40
014 Beaux-Arts,7,1,8,2022,01-17,00:40
015 Les Aubes,6,2,8,2022,01-17,00:40
016 Antigone centre,14,2,16,2022,01-17,00:40
017 M�diath�que Emile Zola,8,8,16,2022,01-17,00:40
018 Nombre d'Or,15,1,16,2022,01-17,00:40
019 Louis Blanc,6,10,16,2022,01-17,00:40
020 Gambetta,1,7,8,2022,01-17,00:40
021 Port Marianne,16,0,16,2022,01-17,00:40
022 Clemenceau,5,7,12,2022,01-17,00:40
023 Les Arceaux,3,13,16,2022,01-17,00:40
024 Cit� Mion,3,5,8,2022,01-17,00:40
025 Nouveau Saint-Roch,2,6,8,2022,01-17,00:40
026 Renouvier,0,8,8,2022,01-17,00:40
027 Odysseum,3,5,8,2022,01-17,00:40
028 Saint-Denis,8,0,8,2022,01-17,00:40
029 Richter,7,9,16,2022,01-17,00:40
030 Charles Flahault,4,4,8,2022,01-17,00:40
031 Voltaire,0,8,8,2022,01-17,00:40
032 Pr�s d'Ar�nes,7,1,8,2022,01-17,00:40
033 Garcia Lorca,7,1,8,2022,01-17,00:40
034 Vert Bois,0,16,16,2022,01-17,00:40
035 Malbosc,0,8,8,2022,01-17,00:40
036 Occitanie,3,29,32,2022,01-17,00:40
037 FacdesSciences,10,14,24,2022,01-17,00:40
038 Fac de Lettres,6,10,16,2022,01-17,00:40
039 Aiguelongue,6,2,8,2022,01-17,00:40
040 Jeu de Mail des Abb�s,7,1,8,2022,01-17,00:40
041 Eurom�decine,1,7,8,2022,01-17,00:40
042 Marie Caizergues,2,6,8,2022,01-17,00:40
043 Sabines,2,6,8,2022,01-17,00:40
044 Celleneuve,4,4,8,2022,01-17,00:40
045 Jardin de la Lironde,4,4,8,2022,01-17,00:40
046 P�re Soulas,4,4,8,2022,01-17,00:40
047 Place Viala,2,6,8,2022,01-17,00:40
048 H�tel du D�partement,1,7,8,2022,01-17,00:40
049 Tonnelles,1,7,8,2022,01-17,00:40
050 Parvis Jules Ferry - Gare Saint-Roch,8,0,8,2022,01-17,00:40
051 Pont de Lattes - Gare Saint-Roch,0,12,12,2022,01-17,00:40
053 Deux Ponts - Gare Saint-Roch,3,5,8,2022,01-17,00:40
054 Providence - Ovalie,3,5,8,2022,01-17,00:40
055 P�rols Etang de l'Or,32,36,68,2022,01-17,00:40
056 Albert 1er - Cath�drale,7,5,12,2022,01-17,00:40
057 Saint-Guilhem - Courreau,2,6,8,2022,01-17,00:40
059 Sud De France,0,8,8,2022,01-17,00:40
001 Rue Jules Ferry - Gare Saint-Roch,7,5,12,2022,01-17,00:51
002 Com�die,8,16,24,2022,01-17,00:51
003 Esplanade,2,30,32,2022,01-17,00:51
004 H�tel de Ville,14,2,16,2022,01-17,00:51
005 Corum,4,8,12,2022,01-17,00:51
006 Place Albert 1er - St Charles,17,14,31,2022,01-17,00:51
007 Foch,3,5,8,2022,01-17,00:51
008 Halles Castellane,0,12,12,2022,01-17,00:51
009 Observatoire,4,4,8,2022,01-17,00:51
010 Rondelet,4,12,16,2022,01-17,00:51
011 Plan Cabanes,5,7,12,2022,01-17,00:51
012 Boutonnet,1,11,12,2022,01-17,00:51
013 Emile Combes,6,2,8,2022,01-17,00:51
014 Beaux-Arts,7,1,8,2022,01-17,00:51
015 Les Aubes,6,2,8,2022,01-17,00:51
016 Antigone centre,14,2,16,2022,01-17,00:51
017 M�diath�que Emile Zola,8,8,16,2022,01-17,00:51
018 Nombre d'Or,15,1,16,2022,01-17,00:51
019 Louis Blanc,6,10,16,2022,01-17,00:51
020 Gambetta,1,7,8,2022,01-17,00:51
021 Port Marianne,16,0,16,2022,01-17,00:51
022 Clemenceau,5,7,12,2022,01-17,00:51
023 Les Arceaux,3,13,16,2022,01-17,00:51
024 Cit� Mion,3,5,8,2022,01-17,00:51
025 Nouveau Saint-Roch,2,6,8,2022,01-17,00:51
026 Renouvier,0,8,8,2022,01-17,00:51
027 Odysseum,3,5,8,2022,01-17,00:51
028 Saint-Denis,8,0,8,2022,01-17,00:51
029 Richter,7,9,16,2022,01-17,00:51
030 Charles Flahault,4,4,8,2022,01-17,00:51
031 Voltaire,0,8,8,2022,01-17,00:51
032 Pr�s d'Ar�nes,7,1,8,2022,01-17,00:51
033 Garcia Lorca,7,1,8,2022,01-17,00:51
034 Vert Bois,0,16,16,2022,01-17,00:51
035 Malbosc,0,8,8,2022,01-17,00:51
036 Occitanie,3,29,32,2022,01-17,00:51
037 FacdesSciences,10,14,24,2022,01-17,00:51
038 Fac de Lettres,6,10,16,2022,01-17,00:51
039 Aiguelongue,6,2,8,2022,01-17,00:51
040 Jeu de Mail des Abb�s,7,1,8,2022,01-17,00:51
041 Eurom�decine,1,7,8,2022,01-17,00:51
042 Marie Caizergues,2,6,8,2022,01-17,00:51
043 Sabines,2,6,8,2022,01-17,00:51
044 Celleneuve,4,4,8,2022,01-17,00:51
045 Jardin de la Lironde,4,4,8,2022,01-17,00:51
046 P�re Soulas,4,4,8,2022,01-17,00:51
047 Place Viala,2,6,8,2022,01-17,00:51
048 H�tel du D�partement,1,7,8,2022,01-17,00:51
049 Tonnelles,1,7,8,2022,01-17,00:51
050 Parvis Jules Ferry - Gare Saint-Roch,8,0,8,2022,01-17,00:51
051 Pont de Lattes - Gare Saint-Roch,0,12,12,2022,01-17,00:51
053 Deux Ponts - Gare Saint-Roch,3,5,8,2022,01-17,00:51
054 Providence - Ovalie,3,5,8,2022,01-17,00:51
055 P�rols Etang de l'Or,32,36,68,2022,01-17,00:51
056 Albert 1er - Cath�drale,7,5,12,2022,01-17,00:51
057 Saint-Guilhem - Courreau,2,6,8,2022,01-17,00:51
059 Sud De France,0,8,8,2022,01-17,00:51
001 Rue Jules Ferry - Gare Saint-Roch,5,7,12,2022,01-17,01:01
002 Com�die,8,16,24,2022,01-17,01:01
003 Esplanade,1,31,32,2022,01-17,01:01
004 H�tel de Ville,14,2,16,2022,01-17,01:01
005 Corum,4,8,12,2022,01-17,01:01
006 Place Albert 1er - St Charles,17,14,31,2022,01-17,01:01
007 Foch,3,5,8,2022,01-17,01:01
008 Halles Castellane,0,12,12,2022,01-17,01:01
009 Observatoire,4,4,8,2022,01-17,01:01
010 Rondelet,4,12,16,2022,01-17,01:01
011 Plan Cabanes,5,7,12,2022,01-17,01:01
012 Boutonnet,1,11,12,2022,01-17,01:01
013 Emile Combes,6,2,8,2022,01-17,01:01
014 Beaux-Arts,7,1,8,2022,01-17,01:01
015 Les Aubes,6,2,8,2022,01-17,01:01
016 Antigone centre,14,2,16,2022,01-17,01:01
017 M�diath�que Emile Zola,8,8,16,2022,01-17,01:01
018 Nombre d'Or,15,1,16,2022,01-17,01:01
019 Louis Blanc,6,10,16,2022,01-17,01:01
020 Gambetta,1,7,8,2022,01-17,01:01
021 Port Marianne,16,0,16,2022,01-17,01:01
022 Clemenceau,5,7,12,2022,01-17,01:01
023 Les Arceaux,3,13,16,2022,01-17,01:01
024 Cit� Mion,3,5,8,2022,01-17,01:01
025 Nouveau Saint-Roch,2,6,8,2022,01-17,01:01
026 Renouvier,0,8,8,2022,01-17,01:01
027 Odysseum,3,5,8,2022,01-17,01:01
028 Saint-Denis,8,0,8,2022,01-17,01:01
029 Richter,7,9,16,2022,01-17,01:01
030 Charles Flahault,4,4,8,2022,01-17,01:01
031 Voltaire,0,8,8,2022,01-17,01:01
032 Pr�s d'Ar�nes,7,1,8,2022,01-17,01:01
033 Garcia Lorca,7,1,8,2022,01-17,01:01
034 Vert Bois,0,16,16,2022,01-17,01:01
035 Malbosc,0,8,8,2022,01-17,01:01
036 Occitanie,3,29,32,2022,01-17,01:01
037 FacdesSciences,10,14,24,2022,01-17,01:01
038 Fac de Lettres,6,10,16,2022,01-17,01:01
039 Aiguelongue,6,2,8,2022,01-17,01:01
040 Jeu de Mail des Abb�s,7,1,8,2022,01-17,01:01
041 Eurom�decine,1,7,8,2022,01-17,01:01
042 Marie Caizergues,2,6,8,2022,01-17,01:01
043 Sabines,2,6,8,2022,01-17,01:01
044 Celleneuve,4,4,8,2022,01-17,01:01
045 Jardin de la Lironde,4,4,8,2022,01-17,01:01
046 P�re Soulas,5,3,8,2022,01-17,01:01
047 Place Viala,2,6,8,2022,01-17,01:01
048 H�tel du D�partement,1,7,8,2022,01-17,01:01
049 Tonnelles,1,7,8,2022,01-17,01:01
050 Parvis Jules Ferry - Gare Saint-Roch,8,0,8,2022,01-17,01:01
051 Pont de Lattes - Gare Saint-Roch,0,12,12,2022,01-17,01:01
053 Deux Ponts - Gare Saint-Roch,3,5,8,2022,01-17,01:01
054 Providence - Ovalie,3,5,8,2022,01-17,01:01
055 P�rols Etang de l'Or,32,36,68,2022,01-17,01:01
056 Albert 1er - Cath�drale,7,5,12,2022,01-17,01:01
057 Saint-Guilhem - Courreau,2,6,8,2022,01-17,01:01
059 Sud De France,0,8,8,2022,01-17,01:01
001 Rue Jules Ferry - Gare Saint-Roch,5,7,12,2022,01-17,01:11
002 Com�die,8,16,24,2022,01-17,01:11
003 Esplanade,0,32,32,2022,01-17,01:11
004 H�tel de Ville,14,2,16,2022,01-17,01:11
005 Corum,4,8,12,2022,01-17,01:11
006 Place Albert 1er - St Charles,17,14,31,2022,01-17,01:11
007 Foch,3,5,8,2022,01-17,01:11
008 Halles Castellane,0,12,12,2022,01-17,01:11
009 Observatoire,4,4,8,2022,01-17,01:11
010 Rondelet,4,12,16,2022,01-17,01:11
011 Plan Cabanes,5,7,12,2022,01-17,01:11
012 Boutonnet,1,11,12,2022,01-17,01:11
013 Emile Combes,6,2,8,2022,01-17,01:11
014 Beaux-Arts,7,1,8,2022,01-17,01:11
015 Les Aubes,6,2,8,2022,01-17,01:11
016 Antigone centre,14,2,16,2022,01-17,01:11
017 M�diath�que Emile Zola,8,8,16,2022,01-17,01:11
018 Nombre d'Or,15,1,16,2022,01-17,01:11
019 Louis Blanc,6,10,16,2022,01-17,01:11
020 Gambetta,1,7,8,2022,01-17,01:11
021 Port Marianne,13,3,16,2022,01-17,01:11
022 Clemenceau,5,7,12,2022,01-17,01:11
023 Les Arceaux,3,13,16,2022,01-17,01:11
024 Cit� Mion,3,5,8,2022,01-17,01:11
025 Nouveau Saint-Roch,2,6,8,2022,01-17,01:11
026 Renouvier,0,8,8,2022,01-17,01:11
027 Odysseum,3,5,8,2022,01-17,01:11
028 Saint-Denis,8,0,8,2022,01-17,01:11
029 Richter,7,9,16,2022,01-17,01:11
030 Charles Flahault,4,4,8,2022,01-17,01:11
031 Voltaire,2,6,8,2022,01-17,01:11
032 Pr�s d'Ar�nes,7,1,8,2022,01-17,01:11
033 Garcia Lorca,7,1,8,2022,01-17,01:11
034 Vert Bois,0,16,16,2022,01-17,01:11
035 Malbosc,0,8,8,2022,01-17,01:11
036 Occitanie,3,29,32,2022,01-17,01:11
037 FacdesSciences,10,14,24,2022,01-17,01:11
038 Fac de Lettres,6,10,16,2022,01-17,01:11
039 Aiguelongue,6,2,8,2022,01-17,01:11
040 Jeu de Mail des Abb�s,7,1,8,2022,01-17,01:11
041 Eurom�decine,1,7,8,2022,01-17,01:11
042 Marie Caizergues,2,6,8,2022,01-17,01:11
043 Sabines,2,6,8,2022,01-17,01:11
044 Celleneuve,4,4,8,2022,01-17,01:11
045 Jardin de la Lironde,4,4,8,2022,01-17,01:11
046 P�re Soulas,5,3,8,2022,01-17,01:11
047 Place Viala,2,6,8,2022,01-17,01:11
048 H�tel du D�partement,1,7,8,2022,01-17,01:11
049 Tonnelles,1,7,8,2022,01-17,01:11
050 Parvis Jules Ferry - Gare Saint-Roch,8,0,8,2022,01-17,01:11
051 Pont de Lattes - Gare Saint-Roch,0,12,12,2022,01-17,01:11
053 Deux Ponts - Gare Saint-Roch,3,5,8,2022,01-17,01:11
054 Providence - Ovalie,3,5,8,2022,01-17,01:11
055 P�rols Etang de l'Or,32,36,68,2022,01-17,01:11
056 Albert 1er - Cath�drale,7,5,12,2022,01-17,01:11
057 Saint-Guilhem - Courreau,2,6,8,2022,01-17,01:11
059 Sud De France,0,8,8,2022,01-17,01:11
001 Rue Jules Ferry - Gare Saint-Roch,4,8,12,2022,01-17,01:21
002 Com�die,8,16,24,2022,01-17,01:21
003 Esplanade,0,32,32,2022,01-17,01:21
004 H�tel de Ville,14,2,16,2022,01-17,01:21
005 Corum,4,8,12,2022,01-17,01:21
006 Place Albert 1er - St Charles,17,14,31,2022,01-17,01:21
007 Foch,3,5,8,2022,01-17,01:21
008 Halles Castellane,0,12,12,2022,01-17,01:21
009 Observatoire,4,4,8,2022,01-17,01:21
010 Rondelet,4,12,16,2022,01-17,01:21
011 Plan Cabanes,5,7,12,2022,01-17,01:21
012 Boutonnet,1,11,12,2022,01-17,01:21
013 Emile Combes,6,2,8,2022,01-17,01:21
014 Beaux-Arts,7,1,8,2022,01-17,01:21
015 Les Aubes,6,2,8,2022,01-17,01:21
016 Antigone centre,14,2,16,2022,01-17,01:21
017 M�diath�que Emile Zola,8,8,16,2022,01-17,01:21
018 Nombre d'Or,15,1,16,2022,01-17,01:21
019 Louis Blanc,6,10,16,2022,01-17,01:21
020 Gambetta,1,7,8,2022,01-17,01:21
021 Port Marianne,16,0,16,2022,01-17,01:21
022 Clemenceau,5,7,12,2022,01-17,01:21
023 Les Arceaux,3,13,16,2022,01-17,01:21
024 Cit� Mion,3,5,8,2022,01-17,01:21
025 Nouveau Saint-Roch,3,5,8,2022,01-17,01:21
026 Renouvier,0,8,8,2022,01-17,01:21
027 Odysseum,3,5,8,2022,01-17,01:21
028 Saint-Denis,8,0,8,2022,01-17,01:21
029 Richter,7,9,16,2022,01-17,01:21
030 Charles Flahault,4,4,8,2022,01-17,01:21
031 Voltaire,2,6,8,2022,01-17,01:21
032 Pr�s d'Ar�nes,7,1,8,2022,01-17,01:21
033 Garcia Lorca,7,1,8,2022,01-17,01:21
034 Vert Bois,0,16,16,2022,01-17,01:21
035 Malbosc,0,8,8,2022,01-17,01:21
036 Occitanie,3,29,32,2022,01-17,01:21
037 FacdesSciences,10,14,24,2022,01-17,01:21
038 Fac de Lettres,6,10,16,2022,01-17,01:21
039 Aiguelongue,6,2,8,2022,01-17,01:21
040 Jeu de Mail des Abb�s,7,1,8,2022,01-17,01:21
041 Eurom�decine,1,7,8,2022,01-17,01:21
042 Marie Caizergues,2,6,8,2022,01-17,01:21
043 Sabines,2,6,8,2022,01-17,01:21
044 Celleneuve,4,4,8,2022,01-17,01:21
045 Jardin de la Lironde,4,4,8,2022,01-17,01:21
046 P�re Soulas,5,3,8,2022,01-17,01:21
047 Place Viala,2,6,8,2022,01-17,01:21
048 H�tel du D�partement,1,7,8,2022,01-17,01:21
049 Tonnelles,1,7,8,2022,01-17,01:21
050 Parvis Jules Ferry - Gare Saint-Roch,8,0,8,2022,01-17,01:21
051 Pont de Lattes - Gare Saint-Roch,0,12,12,2022,01-17,01:21
053 Deux Ponts - Gare Saint-Roch,3,5,8,2022,01-17,01:21
054 Providence - Ovalie,3,5,8,2022,01-17,01:21
055 P�rols Etang de l'Or,32,36,68,2022,01-17,01:21
056 Albert 1er - Cath�drale,7,5,12,2022,01-17,01:21
057 Saint-Guilhem - Courreau,2,6,8,2022,01-17,01:21
059 Sud De France,0,8,8,2022,01-17,01:21
001 Rue Jules Ferry - Gare Saint-Roch,4,8,12,2022,01-17,01:31
002 Com�die,8,16,24,2022,01-17,01:31
003 Esplanade,0,32,32,2022,01-17,01:31
004 H�tel de Ville,14,2,16,2022,01-17,01:31
005 Corum,3,9,12,2022,01-17,01:31
006 Place Albert 1er - St Charles,17,14,31,2022,01-17,01:31
007 Foch,3,5,8,2022,01-17,01:31
008 Halles Castellane,0,12,12,2022,01-17,01:31
009 Observatoire,4,4,8,2022,01-17,01:31
010 Rondelet,4,12,16,2022,01-17,01:31
011 Plan Cabanes,5,7,12,2022,01-17,01:31
012 Boutonnet,1,11,12,2022,01-17,01:31
013 Emile Combes,6,2,8,2022,01-17,01:31
014 Beaux-Arts,7,1,8,2022,01-17,01:31
015 Les Aubes,6,2,8,2022,01-17,01:31
016 Antigone centre,14,2,16,2022,01-17,01:31
017 M�diath�que Emile Zola,8,8,16,2022,01-17,01:31
018 Nombre d'Or,15,1,16,2022,01-17,01:31
019 Louis Blanc,6,10,16,2022,01-17,01:31
020 Gambetta,1,7,8,2022,01-17,01:31
021 Port Marianne,16,0,16,2022,01-17,01:31
022 Clemenceau,5,7,12,2022,01-17,01:31
023 Les Arceaux,3,13,16,2022,01-17,01:31
024 Cit� Mion,3,5,8,2022,01-17,01:31
025 Nouveau Saint-Roch,3,5,8,2022,01-17,01:31
026 Renouvier,0,8,8,2022,01-17,01:31
027 Odysseum,3,5,8,2022,01-17,01:31
028 Saint-Denis,8,0,8,2022,01-17,01:31
029 Richter,7,9,16,2022,01-17,01:31
030 Charles Flahault,4,4,8,2022,01-17,01:31
031 Voltaire,2,6,8,2022,01-17,01:31
032 Pr�s d'Ar�nes,7,1,8,2022,01-17,01:31
033 Garcia Lorca,7,1,8,2022,01-17,01:31
034 Vert Bois,0,16,16,2022,01-17,01:31
035 Malbosc,0,8,8,2022,01-17,01:31
036 Occitanie,3,29,32,2022,01-17,01:31
037 FacdesSciences,10,14,24,2022,01-17,01:31
038 Fac de Lettres,6,10,16,2022,01-17,01:31
039 Aiguelongue,6,2,8,2022,01-17,01:31
040 Jeu de Mail des Abb�s,7,1,8,2022,01-17,01:31
041 Eurom�decine,1,7,8,2022,01-17,01:31
042 Marie Caizergues,2,6,8,2022,01-17,01:31
043 Sabines,2,6,8,2022,01-17,01:31
044 Celleneuve,4,4,8,2022,01-17,01:31
045 Jardin de la Lironde,4,4,8,2022,01-17,01:31
046 P�re Soulas,5,3,8,2022,01-17,01:31
047 Place Viala,2,6,8,2022,01-17,01:31
048 H�tel du D�partement,1,7,8,2022,01-17,01:31
049 Tonnelles,1,7,8,2022,01-17,01:31
050 Parvis Jules Ferry - Gare Saint-Roch,8,0,8,2022,01-17,01:31
051 Pont de Lattes - Gare Saint-Roch,0,12,12,2022,01-17,01:31
053 Deux Ponts - Gare Saint-Roch,3,5,8,2022,01-17,01:31
054 Providence - Ovalie,3,5,8,2022,01-17,01:31
055 P�rols Etang de l'Or,32,36,68,2022,01-17,01:31
056 Albert 1er - Cath�drale,7,5,12,2022,01-17,01:31
057 Saint-Guilhem - Courreau,3,5,8,2022,01-17,01:31
059 Sud De France,0,8,8,2022,01-17,01:31
001 Rue Jules Ferry - Gare Saint-Roch,4,8,12,2022,01-17,01:41
002 Com�die,8,16,24,2022,01-17,01:41
003 Esplanade,0,32,32,2022,01-17,01:41
004 H�tel de Ville,14,2,16,2022,01-17,01:41
005 Corum,3,9,12,2022,01-17,01:41
006 Place Albert 1er - St Charles,17,14,31,2022,01-17,01:41
007 Foch,3,5,8,2022,01-17,01:41
008 Halles Castellane,0,12,12,2022,01-17,01:41
009 Observatoire,4,4,8,2022,01-17,01:41
010 Rondelet,4,12,16,2022,01-17,01:41
011 Plan Cabanes,5,7,12,2022,01-17,01:41
012 Boutonnet,1,11,12,2022,01-17,01:41
013 Emile Combes,6,2,8,2022,01-17,01:41
014 Beaux-Arts,7,1,8,2022,01-17,01:41
015 Les Aubes,6,2,8,2022,01-17,01:41
016 Antigone centre,14,2,16,2022,01-17,01:41
017 M�diath�que Emile Zola,8,8,16,2022,01-17,01:41
018 Nombre d'Or,15,1,16,2022,01-17,01:41
019 Louis Blanc,6,10,16,2022,01-17,01:41
020 Gambetta,1,7,8,2022,01-17,01:41
021 Port Marianne,16,0,16,2022,01-17,01:41
022 Clemenceau,5,7,12,2022,01-17,01:41
023 Les Arceaux,3,13,16,2022,01-17,01:41
024 Cit� Mion,3,5,8,2022,01-17,01:41
025 Nouveau Saint-Roch,3,5,8,2022,01-17,01:41
026 Renouvier,0,8,8,2022,01-17,01:41
027 Odysseum,3,5,8,2022,01-17,01:41
028 Saint-Denis,8,0,8,2022,01-17,01:41
029 Richter,7,9,16,2022,01-17,01:41
030 Charles Flahault,4,4,8,2022,01-17,01:41
031 Voltaire,2,6,8,2022,01-17,01:41
032 Pr�s d'Ar�nes,7,1,8,2022,01-17,01:41
033 Garcia Lorca,7,1,8,2022,01-17,01:41
034 Vert Bois,0,16,16,2022,01-17,01:41
035 Malbosc,0,8,8,2022,01-17,01:41
036 Occitanie,3,29,32,2022,01-17,01:41
037 FacdesSciences,10,14,24,2022,01-17,01:41
038 Fac de Lettres,6,10,16,2022,01-17,01:41
039 Aiguelongue,6,2,8,2022,01-17,01:41
040 Jeu de Mail des Abb�s,7,1,8,2022,01-17,01:41
041 Eurom�decine,1,7,8,2022,01-17,01:41
042 Marie Caizergues,2,6,8,2022,01-17,01:41
043 Sabines,2,6,8,2022,01-17,01:41
044 Celleneuve,4,4,8,2022,01-17,01:41
045 Jardin de la Lironde,4,4,8,2022,01-17,01:41
046 P�re Soulas,5,3,8,2022,01-17,01:41
047 Place Viala,2,6,8,2022,01-17,01:41
048 H�tel du D�partement,1,7,8,2022,01-17,01:41
049 Tonnelles,1,7,8,2022,01-17,01:41
050 Parvis Jules Ferry - Gare Saint-Roch,8,0,8,2022,01-17,01:41
051 Pont de Lattes - Gare Saint-Roch,0,12,12,2022,01-17,01:41
053 Deux Ponts - Gare Saint-Roch,3,5,8,2022,01-17,01:41
054 Providence - Ovalie,3,5,8,2022,01-17,01:41
055 P�rols Etang de l'Or,32,36,68,2022,01-17,01:41
056 Albert 1er - Cath�drale,7,5,12,2022,01-17,01:41
057 Saint-Guilhem - Courreau,3,5,8,2022,01-17,01:41
059 Sud De France,0,8,8,2022,01-17,01:41
001 Rue Jules Ferry - Gare Saint-Roch,4,8,12,2022,01-17,01:52
002 Com�die,5,19,24,2022,01-17,01:52
003 Esplanade,0,32,32,2022,01-17,01:52
004 H�tel de Ville,14,2,16,2022,01-17,01:52
005 Corum,3,9,12,2022,01-17,01:52
006 Place Albert 1er - St Charles,17,14,31,2022,01-17,01:52
007 Foch,3,5,8,2022,01-17,01:52
008 Halles Castellane,0,12,12,2022,01-17,01:52
009 Observatoire,4,4,8,2022,01-17,01:52
010 Rondelet,4,12,16,2022,01-17,01:52
011 Plan Cabanes,5,7,12,2022,01-17,01:52
012 Boutonnet,1,11,12,2022,01-17,01:52
013 Emile Combes,6,2,8,2022,01-17,01:52
014 Beaux-Arts,7,1,8,2022,01-17,01:52
015 Les Aubes,6,2,8,2022,01-17,01:52
016 Antigone centre,14,2,16,2022,01-17,01:52
017 M�diath�que Emile Zola,8,8,16,2022,01-17,01:52
018 Nombre d'Or,15,1,16,2022,01-17,01:52
019 Louis Blanc,6,10,16,2022,01-17,01:52
020 Gambetta,1,7,8,2022,01-17,01:52
021 Port Marianne,16,0,16,2022,01-17,01:52
022 Clemenceau,5,7,12,2022,01-17,01:52
023 Les Arceaux,3,13,16,2022,01-17,01:52
024 Cit� Mion,3,5,8,2022,01-17,01:52
025 Nouveau Saint-Roch,3,5,8,2022,01-17,01:52
026 Renouvier,0,8,8,2022,01-17,01:52
027 Odysseum,3,5,8,2022,01-17,01:52
028 Saint-Denis,8,0,8,2022,01-17,01:52
029 Richter,7,9,16,2022,01-17,01:52
030 Charles Flahault,4,4,8,2022,01-17,01:52
031 Voltaire,2,6,8,2022,01-17,01:52
032 Pr�s d'Ar�nes,7,1,8,2022,01-17,01:52
033 Garcia Lorca,7,1,8,2022,01-17,01:52
034 Vert Bois,0,16,16,2022,01-17,01:52
035 Malbosc,0,8,8,2022,01-17,01:52
036 Occitanie,3,29,32,2022,01-17,01:52
037 FacdesSciences,11,13,24,2022,01-17,01:52
038 Fac de Lettres,6,10,16,2022,01-17,01:52
039 Aiguelongue,6,2,8,2022,01-17,01:52
040 Jeu de Mail des Abb�s,7,1,8,2022,01-17,01:52
041 Eurom�decine,1,7,8,2022,01-17,01:52
042 Marie Caizergues,2,6,8,2022,01-17,01:52
043 Sabines,2,6,8,2022,01-17,01:52
044 Celleneuve,4,4,8,2022,01-17,01:52
045 Jardin de la Lironde,4,4,8,2022,01-17,01:52
046 P�re Soulas,5,3,8,2022,01-17,01:52
047 Place Viala,3,5,8,2022,01-17,01:52
048 H�tel du D�partement,1,7,8,2022,01-17,01:52
049 Tonnelles,1,7,8,2022,01-17,01:52
050 Parvis Jules Ferry - Gare Saint-Roch,8,0,8,2022,01-17,01:52
051 Pont de Lattes - Gare Saint-Roch,0,12,12,2022,01-17,01:52
053 Deux Ponts - Gare Saint-Roch,3,5,8,2022,01-17,01:52
054 Providence - Ovalie,3,5,8,2022,01-17,01:52
055 P�rols Etang de l'Or,32,36,68,2022,01-17,01:52
056 Albert 1er - Cath�drale,7,5,12,2022,01-17,01:52
057 Saint-Guilhem - Courreau,3,5,8,2022,01-17,01:52
059 Sud De France,0,8,8,2022,01-17,01:52
001 Rue Jules Ferry - Gare Saint-Roch,4,8,12,2022,01-17,02:02
002 Com�die,5,19,24,2022,01-17,02:02
003 Esplanade,0,32,32,2022,01-17,02:02
004 H�tel de Ville,14,2,16,2022,01-17,02:02
005 Corum,2,10,12,2022,01-17,02:02
006 Place Albert 1er - St Charles,17,14,31,2022,01-17,02:02
007 Foch,3,5,8,2022,01-17,02:02
008 Halles Castellane,0,12,12,2022,01-17,02:02
009 Observatoire,4,4,8,2022,01-17,02:02
010 Rondelet,4,12,16,2022,01-17,02:02
011 Plan Cabanes,5,7,12,2022,01-17,02:02
012 Boutonnet,1,11,12,2022,01-17,02:02
013 Emile Combes,6,2,8,2022,01-17,02:02
014 Beaux-Arts,7,1,8,2022,01-17,02:02
015 Les Aubes,6,2,8,2022,01-17,02:02
016 Antigone centre,15,1,16,2022,01-17,02:02
017 M�diath�que Emile Zola,8,8,16,2022,01-17,02:02
018 Nombre d'Or,15,1,16,2022,01-17,02:02
019 Louis Blanc,6,10,16,2022,01-17,02:02
020 Gambetta,1,7,8,2022,01-17,02:02
021 Port Marianne,16,0,16,2022,01-17,02:02
022 Clemenceau,5,7,12,2022,01-17,02:02
023 Les Arceaux,3,13,16,2022,01-17,02:02
024 Cit� Mion,3,5,8,2022,01-17,02:02
025 Nouveau Saint-Roch,3,5,8,2022,01-17,02:02
026 Renouvier,0,8,8,2022,01-17,02:02
027 Odysseum,3,5,8,2022,01-17,02:02
028 Saint-Denis,8,0,8,2022,01-17,02:02
029 Richter,7,9,16,2022,01-17,02:02
030 Charles Flahault,4,4,8,2022,01-17,02:02
031 Voltaire,2,6,8,2022,01-17,02:02
032 Pr�s d'Ar�nes,7,1,8,2022,01-17,02:02
033 Garcia Lorca,7,1,8,2022,01-17,02:02
034 Vert Bois,0,16,16,2022,01-17,02:02
035 Malbosc,0,8,8,2022,01-17,02:02
036 Occitanie,3,29,32,2022,01-17,02:02
037 FacdesSciences,11,13,24,2022,01-17,02:02
038 Fac de Lettres,6,10,16,2022,01-17,02:02
039 Aiguelongue,6,2,8,2022,01-17,02:02
040 Jeu de Mail des Abb�s,7,1,8,2022,01-17,02:02
041 Eurom�decine,1,7,8,2022,01-17,02:02
042 Marie Caizergues,2,6,8,2022,01-17,02:02
043 Sabines,2,6,8,2022,01-17,02:02
044 Celleneuve,4,4,8,2022,01-17,02:02
045 Jardin de la Lironde,4,4,8,2022,01-17,02:02
046 P�re Soulas,6,2,8,2022,01-17,02:02
047 Place Viala,3,5,8,2022,01-17,02:02
048 H�tel du D�partement,1,7,8,2022,01-17,02:02
049 Tonnelles,1,7,8,2022,01-17,02:02
050 Parvis Jules Ferry - Gare Saint-Roch,8,0,8,2022,01-17,02:02
051 Pont de Lattes - Gare Saint-Roch,0,12,12,2022,01-17,02:02
053 Deux Ponts - Gare Saint-Roch,3,5,8,2022,01-17,02:02
054 Providence - Ovalie,3,5,8,2022,01-17,02:02
055 P�rols Etang de l'Or,32,36,68,2022,01-17,02:02
056 Albert 1er - Cath�drale,7,5,12,2022,01-17,02:02
057 Saint-Guilhem - Courreau,3,5,8,2022,01-17,02:02
059 Sud De France,0,8,8,2022,01-17,02:02
001 Rue Jules Ferry - Gare Saint-Roch,4,8,12,2022,01-17,02:12
002 Com�die,5,19,24,2022,01-17,02:12
003 Esplanade,0,32,32,2022,01-17,02:12
004 H�tel de Ville,13,3,16,2022,01-17,02:12
005 Corum,2,10,12,2022,01-17,02:12
006 Place Albert 1er - St Charles,15,16,31,2022,01-17,02:12
007 Foch,3,5,8,2022,01-17,02:12
008 Halles Castellane,0,12,12,2022,01-17,02:12
009 Observatoire,4,4,8,2022,01-17,02:12
010 Rondelet,4,12,16,2022,01-17,02:12
011 Plan Cabanes,5,7,12,2022,01-17,02:12
012 Boutonnet,2,10,12,2022,01-17,02:12
013 Emile Combes,6,2,8,2022,01-17,02:12
014 Beaux-Arts,7,1,8,2022,01-17,02:12
015 Les Aubes,6,2,8,2022,01-17,02:12
016 Antigone centre,15,1,16,2022,01-17,02:12
017 M�diath�que Emile Zola,8,8,16,2022,01-17,02:12
018 Nombre d'Or,15,1,16,2022,01-17,02:12
019 Louis Blanc,6,10,16,2022,01-17,02:12
020 Gambetta,1,7,8,2022,01-17,02:12
021 Port Marianne,16,0,16,2022,01-17,02:12
022 Clemenceau,5,7,12,2022,01-17,02:12
023 Les Arceaux,3,13,16,2022,01-17,02:12
024 Cit� Mion,3,5,8,2022,01-17,02:12
025 Nouveau Saint-Roch,3,5,8,2022,01-17,02:12
026 Renouvier,0,8,8,2022,01-17,02:12
027 Odysseum,3,5,8,2022,01-17,02:12
028 Saint-Denis,8,0,8,2022,01-17,02:12
029 Richter,8,8,16,2022,01-17,02:12
030 Charles Flahault,4,4,8,2022,01-17,02:12
031 Voltaire,2,6,8,2022,01-17,02:12
032 Pr�s d'Ar�nes,7,1,8,2022,01-17,02:12
033 Garcia Lorca,7,1,8,2022,01-17,02:12
034 Vert Bois,0,16,16,2022,01-17,02:12
035 Malbosc,0,8,8,2022,01-17,02:12
036 Occitanie,3,29,32,2022,01-17,02:12
037 FacdesSciences,12,12,24,2022,01-17,02:12
038 Fac de Lettres,6,10,16,2022,01-17,02:12
039 Aiguelongue,6,2,8,2022,01-17,02:12
040 Jeu de Mail des Abb�s,7,1,8,2022,01-17,02:12
041 Eurom�decine,1,7,8,2022,01-17,02:12
042 Marie Caizergues,2,6,8,2022,01-17,02:12
043 Sabines,2,6,8,2022,01-17,02:12
044 Celleneuve,4,4,8,2022,01-17,02:12
045 Jardin de la Lironde,4,4,8,2022,01-17,02:12
046 P�re Soulas,6,2,8,2022,01-17,02:12
047 Place Viala,3,5,8,2022,01-17,02:12
048 H�tel du D�partement,1,7,8,2022,01-17,02:12
049 Tonnelles,1,7,8,2022,01-17,02:12
050 Parvis Jules Ferry - Gare Saint-Roch,8,0,8,2022,01-17,02:12
051 Pont de Lattes - Gare Saint-Roch,0,12,12,2022,01-17,02:12
053 Deux Ponts - Gare Saint-Roch,3,5,8,2022,01-17,02:12
054 Providence - Ovalie,3,5,8,2022,01-17,02:12
055 P�rols Etang de l'Or,32,36,68,2022,01-17,02:12
056 Albert 1er - Cath�drale,7,5,12,2022,01-17,02:12
057 Saint-Guilhem - Courreau,3,5,8,2022,01-17,02:12
059 Sud De France,0,8,8,2022,01-17,02:12
001 Rue Jules Ferry - Gare Saint-Roch,4,8,12,2022,01-17,02:22
002 Com�die,5,19,24,2022,01-17,02:22
003 Esplanade,0,32,32,2022,01-17,02:22
004 H�tel de Ville,13,3,16,2022,01-17,02:22
005 Corum,2,10,12,2022,01-17,02:22
006 Place Albert 1er - St Charles,15,16,31,2022,01-17,02:22
007 Foch,3,5,8,2022,01-17,02:22
008 Halles Castellane,0,12,12,2022,01-17,02:22
009 Observatoire,4,4,8,2022,01-17,02:22
010 Rondelet,4,12,16,2022,01-17,02:22
011 Plan Cabanes,5,7,12,2022,01-17,02:22
012 Boutonnet,2,10,12,2022,01-17,02:22
013 Emile Combes,6,2,8,2022,01-17,02:22
014 Beaux-Arts,7,1,8,2022,01-17,02:22
015 Les Aubes,6,2,8,2022,01-17,02:22
016 Antigone centre,15,1,16,2022,01-17,02:22
017 M�diath�que Emile Zola,8,8,16,2022,01-17,02:22
018 Nombre d'Or,15,1,16,2022,01-17,02:22
019 Louis Blanc,6,10,16,2022,01-17,02:22
020 Gambetta,1,7,8,2022,01-17,02:22
021 Port Marianne,16,0,16,2022,01-17,02:22
022 Clemenceau,5,7,12,2022,01-17,02:22
023 Les Arceaux,3,13,16,2022,01-17,02:22
024 Cit� Mion,3,5,8,2022,01-17,02:22
025 Nouveau Saint-Roch,4,4,8,2022,01-17,02:22
026 Renouvier,0,8,8,2022,01-17,02:22
027 Odysseum,3,5,8,2022,01-17,02:22
028 Saint-Denis,8,0,8,2022,01-17,02:22
029 Richter,8,8,16,2022,01-17,02:22
030 Charles Flahault,4,4,8,2022,01-17,02:22
031 Voltaire,2,6,8,2022,01-17,02:22
032 Pr�s d'Ar�nes,7,1,8,2022,01-17,02:22
033 Garcia Lorca,7,1,8,2022,01-17,02:22
034 Vert Bois,0,16,16,2022,01-17,02:22
035 Malbosc,0,8,8,2022,01-17,02:22
036 Occitanie,3,29,32,2022,01-17,02:22
037 FacdesSciences,12,12,24,2022,01-17,02:22
038 Fac de Lettres,6,10,16,2022,01-17,02:22
039 Aiguelongue,6,2,8,2022,01-17,02:22
040 Jeu de Mail des Abb�s,7,1,8,2022,01-17,02:22
041 Eurom�decine,1,7,8,2022,01-17,02:22
042 Marie Caizergues,2,6,8,2022,01-17,02:22
043 Sabines,2,6,8,2022,01-17,02:22
044 Celleneuve,4,4,8,2022,01-17,02:22
045 Jardin de la Lironde,4,4,8,2022,01-17,02:22
046 P�re Soulas,6,2,8,2022,01-17,02:22
047 Place Viala,3,5,8,2022,01-17,02:22
048 H�tel du D�partement,1,7,8,2022,01-17,02:22
049 Tonnelles,1,7,8,2022,01-17,02:22
050 Parvis Jules Ferry - Gare Saint-Roch,8,0,8,2022,01-17,02:22
051 Pont de Lattes - Gare Saint-Roch,0,12,12,2022,01-17,02:22
053 Deux Ponts - Gare Saint-Roch,3,5,8,2022,01-17,02:22
054 Providence - Ovalie,3,5,8,2022,01-17,02:22
055 P�rols Etang de l'Or,32,36,68,2022,01-17,02:22
056 Albert 1er - Cath�drale,7,5,12,2022,01-17,02:22
057 Saint-Guilhem - Courreau,3,5,8,2022,01-17,02:22
059 Sud De France,0,8,8,2022,01-17,02:22
001 Rue Jules Ferry - Gare Saint-Roch,4,8,12,2022,01-17,02:32
002 Com�die,5,19,24,2022,01-17,02:32
003 Esplanade,0,32,32,2022,01-17,02:32
004 H�tel de Ville,13,3,16,2022,01-17,02:32
005 Corum,2,10,12,2022,01-17,02:32
006 Place Albert 1er - St Charles,15,16,31,2022,01-17,02:32
007 Foch,3,5,8,2022,01-17,02:32
008 Halles Castellane,0,12,12,2022,01-17,02:32
009 Observatoire,4,4,8,2022,01-17,02:32
010 Rondelet,4,12,16,2022,01-17,02:32
011 Plan Cabanes,5,7,12,2022,01-17,02:32
012 Boutonnet,2,10,12,2022,01-17,02:32
013 Emile Combes,6,2,8,2022,01-17,02:32
014 Beaux-Arts,7,1,8,2022,01-17,02:32
015 Les Aubes,6,2,8,2022,01-17,02:32
016 Antigone centre,15,1,16,2022,01-17,02:32
017 M�diath�que Emile Zola,8,8,16,2022,01-17,02:32
018 Nombre d'Or,15,1,16,2022,01-17,02:32
019 Louis Blanc,6,10,16,2022,01-17,02:32
020 Gambetta,1,7,8,2022,01-17,02:32
021 Port Marianne,16,0,16,2022,01-17,02:32
022 Clemenceau,5,7,12,2022,01-17,02:32
023 Les Arceaux,3,13,16,2022,01-17,02:32
024 Cit� Mion,3,5,8,2022,01-17,02:32
025 Nouveau Saint-Roch,4,4,8,2022,01-17,02:32
026 Renouvier,0,8,8,2022,01-17,02:32
027 Odysseum,3,5,8,2022,01-17,02:32
028 Saint-Denis,8,0,8,2022,01-17,02:32
029 Richter,8,8,16,2022,01-17,02:32
030 Charles Flahault,4,4,8,2022,01-17,02:32
031 Voltaire,2,6,8,2022,01-17,02:32
032 Pr�s d'Ar�nes,7,1,8,2022,01-17,02:32
033 Garcia Lorca,7,1,8,2022,01-17,02:32
034 Vert Bois,0,16,16,2022,01-17,02:32
035 Malbosc,0,8,8,2022,01-17,02:32
036 Occitanie,3,29,32,2022,01-17,02:32
037 FacdesSciences,12,12,24,2022,01-17,02:32
038 Fac de Lettres,6,10,16,2022,01-17,02:32
039 Aiguelongue,6,2,8,2022,01-17,02:32
040 Jeu de Mail des Abb�s,7,1,8,2022,01-17,02:32
041 Eurom�decine,1,7,8,2022,01-17,02:32
042 Marie Caizergues,2,6,8,2022,01-17,02:32
043 Sabines,2,6,8,2022,01-17,02:32
044 Celleneuve,4,4,8,2022,01-17,02:32
045 Jardin de la Lironde,4,4,8,2022,01-17,02:32
046 P�re Soulas,6,2,8,2022,01-17,02:32
047 Place Viala,3,5,8,2022,01-17,02:32
048 H�tel du D�partement,1,7,8,2022,01-17,02:32
049 Tonnelles,1,7,8,2022,01-17,02:32
050 Parvis Jules Ferry - Gare Saint-Roch,8,0,8,2022,01-17,02:32
051 Pont de Lattes - Gare Saint-Roch,0,12,12,2022,01-17,02:32
053 Deux Ponts - Gare Saint-Roch,3,5,8,2022,01-17,02:32
054 Providence - Ovalie,3,5,8,2022,01-17,02:32
055 P�rols Etang de l'Or,32,36,68,2022,01-17,02:32
056 Albert 1er - Cath�drale,7,5,12,2022,01-17,02:32
057 Saint-Guilhem - Courreau,3,5,8,2022,01-17,02:32
059 Sud De France,0,8,8,2022,01-17,02:32
001 Rue Jules Ferry - Gare Saint-Roch,4,8,12,2022,01-17,02:42
002 Com�die,5,19,24,2022,01-17,02:42
003 Esplanade,0,32,32,2022,01-17,02:42
004 H�tel de Ville,13,3,16,2022,01-17,02:42
005 Corum,2,10,12,2022,01-17,02:42
006 Place Albert 1er - St Charles,15,16,31,2022,01-17,02:42
007 Foch,3,5,8,2022,01-17,02:42
008 Halles Castellane,0,12,12,2022,01-17,02:42
009 Observatoire,4,4,8,2022,01-17,02:42
010 Rondelet,4,12,16,2022,01-17,02:42
011 Plan Cabanes,5,7,12,2022,01-17,02:42
012 Boutonnet,1,11,12,2022,01-17,02:42
013 Emile Combes,6,2,8,2022,01-17,02:42
014 Beaux-Arts,7,1,8,2022,01-17,02:42
015 Les Aubes,6,2,8,2022,01-17,02:42
016 Antigone centre,15,1,16,2022,01-17,02:42
017 M�diath�que Emile Zola,8,8,16,2022,01-17,02:42
018 Nombre d'Or,15,1,16,2022,01-17,02:42
019 Louis Blanc,6,10,16,2022,01-17,02:42
020 Gambetta,1,7,8,2022,01-17,02:42
021 Port Marianne,16,0,16,2022,01-17,02:42
022 Clemenceau,5,7,12,2022,01-17,02:42
023 Les Arceaux,3,13,16,2022,01-17,02:42
024 Cit� Mion,3,5,8,2022,01-17,02:42
025 Nouveau Saint-Roch,4,4,8,2022,01-17,02:42
026 Renouvier,0,8,8,2022,01-17,02:42
027 Odysseum,3,5,8,2022,01-17,02:42
028 Saint-Denis,8,0,8,2022,01-17,02:42
029 Richter,8,8,16,2022,01-17,02:42
030 Charles Flahault,4,4,8,2022,01-17,02:42
031 Voltaire,2,6,8,2022,01-17,02:42
032 Pr�s d'Ar�nes,7,1,8,2022,01-17,02:42
033 Garcia Lorca,7,1,8,2022,01-17,02:42
034 Vert Bois,0,16,16,2022,01-17,02:42
035 Malbosc,0,8,8,2022,01-17,02:42
036 Occitanie,3,29,32,2022,01-17,02:42
037 FacdesSciences,12,12,24,2022,01-17,02:42
038 Fac de Lettres,6,10,16,2022,01-17,02:42
039 Aiguelongue,6,2,8,2022,01-17,02:42
040 Jeu de Mail des Abb�s,7,1,8,2022,01-17,02:42
041 Eurom�decine,1,7,8,2022,01-17,02:42
042 Marie Caizergues,2,6,8,2022,01-17,02:42
043 Sabines,2,6,8,2022,01-17,02:42
044 Celleneuve,4,4,8,2022,01-17,02:42
045 Jardin de la Lironde,4,4,8,2022,01-17,02:42
046 P�re Soulas,6,2,8,2022,01-17,02:42
047 Place Viala,3,5,8,2022,01-17,02:42
048 H�tel du D�partement,1,7,8,2022,01-17,02:42
049 Tonnelles,1,7,8,2022,01-17,02:42
050 Parvis Jules Ferry - Gare Saint-Roch,8,0,8,2022,01-17,02:42
051 Pont de Lattes - Gare Saint-Roch,0,12,12,2022,01-17,02:42
053 Deux Ponts - Gare Saint-Roch,3,5,8,2022,01-17,02:42
054 Providence - Ovalie,3,5,8,2022,01-17,02:42
055 P�rols Etang de l'Or,32,36,68,2022,01-17,02:42
056 Albert 1er - Cath�drale,7,5,12,2022,01-17,02:42
057 Saint-Guilhem - Courreau,3,5,8,2022,01-17,02:42
059 Sud De France,0,8,8,2022,01-17,02:42
001 Rue Jules Ferry - Gare Saint-Roch,4,8,12,2022,01-17,02:53
002 Com�die,5,19,24,2022,01-17,02:53
003 Esplanade,0,32,32,2022,01-17,02:53
004 H�tel de Ville,13,3,16,2022,01-17,02:53
005 Corum,2,10,12,2022,01-17,02:53
006 Place Albert 1er - St Charles,16,15,31,2022,01-17,02:53
007 Foch,3,5,8,2022,01-17,02:53
008 Halles Castellane,0,12,12,2022,01-17,02:53
009 Observatoire,4,4,8,2022,01-17,02:53
010 Rondelet,4,12,16,2022,01-17,02:53
011 Plan Cabanes,5,7,12,2022,01-17,02:53
012 Boutonnet,1,11,12,2022,01-17,02:53
013 Emile Combes,6,2,8,2022,01-17,02:53
014 Beaux-Arts,7,1,8,2022,01-17,02:53
015 Les Aubes,6,2,8,2022,01-17,02:53
016 Antigone centre,15,1,16,2022,01-17,02:53
017 M�diath�que Emile Zola,8,8,16,2022,01-17,02:53
018 Nombre d'Or,15,1,16,2022,01-17,02:53
019 Louis Blanc,6,10,16,2022,01-17,02:53
020 Gambetta,1,7,8,2022,01-17,02:53
021 Port Marianne,16,0,16,2022,01-17,02:53
022 Clemenceau,5,7,12,2022,01-17,02:53
023 Les Arceaux,3,13,16,2022,01-17,02:53
024 Cit� Mion,3,5,8,2022,01-17,02:53
025 Nouveau Saint-Roch,4,4,8,2022,01-17,02:53
026 Renouvier,0,8,8,2022,01-17,02:53
027 Odysseum,3,5,8,2022,01-17,02:53
028 Saint-Denis,8,0,8,2022,01-17,02:53
029 Richter,8,8,16,2022,01-17,02:53
030 Charles Flahault,4,4,8,2022,01-17,02:53
031 Voltaire,2,6,8,2022,01-17,02:53
032 Pr�s d'Ar�nes,7,1,8,2022,01-17,02:53
033 Garcia Lorca,7,1,8,2022,01-17,02:53
034 Vert Bois,0,16,16,2022,01-17,02:53
035 Malbosc,0,8,8,2022,01-17,02:53
036 Occitanie,3,29,32,2022,01-17,02:53
037 FacdesSciences,12,12,24,2022,01-17,02:53
038 Fac de Lettres,6,10,16,2022,01-17,02:53
039 Aiguelongue,6,2,8,2022,01-17,02:53
040 Jeu de Mail des Abb�s,7,1,8,2022,01-17,02:53
041 Eurom�decine,1,7,8,2022,01-17,02:53
042 Marie Caizergues,2,6,8,2022,01-17,02:53
043 Sabines,2,6,8,2022,01-17,02:53
044 Celleneuve,4,4,8,2022,01-17,02:53
045 Jardin de la Lironde,4,4,8,2022,01-17,02:53
046 P�re Soulas,6,2,8,2022,01-17,02:53
047 Place Viala,3,5,8,2022,01-17,02:53
048 H�tel du D�partement,1,7,8,2022,01-17,02:53
049 Tonnelles,1,7,8,2022,01-17,02:53
050 Parvis Jules Ferry - Gare Saint-Roch,8,0,8,2022,01-17,02:53
051 Pont de Lattes - Gare Saint-Roch,0,12,12,2022,01-17,02:53
053 Deux Ponts - Gare Saint-Roch,3,5,8,2022,01-17,02:53
054 Providence - Ovalie,3,5,8,2022,01-17,02:53
055 P�rols Etang de l'Or,32,36,68,2022,01-17,02:53
056 Albert 1er - Cath�drale,7,5,12,2022,01-17,02:53
057 Saint-Guilhem - Courreau,3,5,8,2022,01-17,02:53
059 Sud De France,0,8,8,2022,01-17,02:53
001 Rue Jules Ferry - Gare Saint-Roch,4,8,12,2022,01-17,03:03
002 Com�die,5,19,24,2022,01-17,03:03
003 Esplanade,0,32,32,2022,01-17,03:03
004 H�tel de Ville,13,3,16,2022,01-17,03:03
005 Corum,2,10,12,2022,01-17,03:03
006 Place Albert 1er - St Charles,16,15,31,2022,01-17,03:03
007 Foch,3,5,8,2022,01-17,03:03
008 Halles Castellane,0,12,12,2022,01-17,03:03
009 Observatoire,4,4,8,2022,01-17,03:03
010 Rondelet,4,12,16,2022,01-17,03:03
011 Plan Cabanes,5,7,12,2022,01-17,03:03
012 Boutonnet,1,11,12,2022,01-17,03:03
013 Emile Combes,6,2,8,2022,01-17,03:03
014 Beaux-Arts,7,1,8,2022,01-17,03:03
015 Les Aubes,6,2,8,2022,01-17,03:03
016 Antigone centre,15,1,16,2022,01-17,03:03
017 M�diath�que Emile Zola,8,8,16,2022,01-17,03:03
018 Nombre d'Or,15,1,16,2022,01-17,03:03
019 Louis Blanc,6,10,16,2022,01-17,03:03
020 Gambetta,1,7,8,2022,01-17,03:03
021 Port Marianne,16,0,16,2022,01-17,03:03
022 Clemenceau,5,7,12,2022,01-17,03:03
023 Les Arceaux,4,12,16,2022,01-17,03:03
024 Cit� Mion,3,5,8,2022,01-17,03:03
025 Nouveau Saint-Roch,4,4,8,2022,01-17,03:03
026 Renouvier,0,8,8,2022,01-17,03:03
027 Odysseum,3,5,8,2022,01-17,03:03
028 Saint-Denis,8,0,8,2022,01-17,03:03
029 Richter,8,8,16,2022,01-17,03:03
030 Charles Flahault,4,4,8,2022,01-17,03:03
031 Voltaire,2,6,8,2022,01-17,03:03
032 Pr�s d'Ar�nes,7,1,8,2022,01-17,03:03
033 Garcia Lorca,7,1,8,2022,01-17,03:03
034 Vert Bois,0,16,16,2022,01-17,03:03
035 Malbosc,0,8,8,2022,01-17,03:03
036 Occitanie,3,29,32,2022,01-17,03:03
037 FacdesSciences,11,13,24,2022,01-17,03:03
038 Fac de Lettres,6,10,16,2022,01-17,03:03
039 Aiguelongue,6,2,8,2022,01-17,03:03
040 Jeu de Mail des Abb�s,7,1,8,2022,01-17,03:03
041 Eurom�decine,1,7,8,2022,01-17,03:03
042 Marie Caizergues,2,6,8,2022,01-17,03:03
043 Sabines,2,6,8,2022,01-17,03:03
044 Celleneuve,4,4,8,2022,01-17,03:03
045 Jardin de la Lironde,4,4,8,2022,01-17,03:03
046 P�re Soulas,6,2,8,2022,01-17,03:03
047 Place Viala,3,5,8,2022,01-17,03:03
048 H�tel du D�partement,1,7,8,2022,01-17,03:03
049 Tonnelles,1,7,8,2022,01-17,03:03
050 Parvis Jules Ferry - Gare Saint-Roch,8,0,8,2022,01-17,03:03
051 Pont de Lattes - Gare Saint-Roch,0,12,12,2022,01-17,03:03
053 Deux Ponts - Gare Saint-Roch,3,5,8,2022,01-17,03:03
054 Providence - Ovalie,3,5,8,2022,01-17,03:03
055 P�rols Etang de l'Or,32,36,68,2022,01-17,03:03
056 Albert 1er - Cath�drale,7,5,12,2022,01-17,03:03
057 Saint-Guilhem - Courreau,3,5,8,2022,01-17,03:03
059 Sud De France,0,8,8,2022,01-17,03:03
001 Rue Jules Ferry - Gare Saint-Roch,4,8,12,2022,01-17,03:13
002 Com�die,5,19,24,2022,01-17,03:13
003 Esplanade,0,32,32,2022,01-17,03:13
004 H�tel de Ville,13,3,16,2022,01-17,03:13
005 Corum,2,10,12,2022,01-17,03:13
006 Place Albert 1er - St Charles,16,15,31,2022,01-17,03:13
007 Foch,3,5,8,2022,01-17,03:13
008 Halles Castellane,0,12,12,2022,01-17,03:13
009 Observatoire,4,4,8,2022,01-17,03:13
010 Rondelet,4,12,16,2022,01-17,03:13
011 Plan Cabanes,5,7,12,2022,01-17,03:13
012 Boutonnet,1,11,12,2022,01-17,03:13
013 Emile Combes,6,2,8,2022,01-17,03:13
014 Beaux-Arts,7,1,8,2022,01-17,03:13
015 Les Aubes,6,2,8,2022,01-17,03:13
016 Antigone centre,15,1,16,2022,01-17,03:13
017 M�diath�que Emile Zola,8,8,16,2022,01-17,03:13
018 Nombre d'Or,15,1,16,2022,01-17,03:13
019 Louis Blanc,8,8,16,2022,01-17,03:13
020 Gambetta,1,7,8,2022,01-17,03:13
021 Port Marianne,16,0,16,2022,01-17,03:13
022 Clemenceau,5,7,12,2022,01-17,03:13
023 Les Arceaux,4,12,16,2022,01-17,03:13
024 Cit� Mion,3,5,8,2022,01-17,03:13
025 Nouveau Saint-Roch,4,4,8,2022,01-17,03:13
026 Renouvier,0,8,8,2022,01-17,03:13
027 Odysseum,3,5,8,2022,01-17,03:13
028 Saint-Denis,8,0,8,2022,01-17,03:13
029 Richter,8,8,16,2022,01-17,03:13
030 Charles Flahault,4,4,8,2022,01-17,03:13
031 Voltaire,2,6,8,2022,01-17,03:13
032 Pr�s d'Ar�nes,7,1,8,2022,01-17,03:13
033 Garcia Lorca,7,1,8,2022,01-17,03:13
034 Vert Bois,0,16,16,2022,01-17,03:13
035 Malbosc,0,8,8,2022,01-17,03:13
036 Occitanie,3,29,32,2022,01-17,03:13
037 FacdesSciences,11,13,24,2022,01-17,03:13
038 Fac de Lettres,6,10,16,2022,01-17,03:13
039 Aiguelongue,6,2,8,2022,01-17,03:13
040 Jeu de Mail des Abb�s,7,1,8,2022,01-17,03:13
041 Eurom�decine,1,7,8,2022,01-17,03:13
042 Marie Caizergues,2,6,8,2022,01-17,03:13
043 Sabines,2,6,8,2022,01-17,03:13
044 Celleneuve,4,4,8,2022,01-17,03:13
045 Jardin de la Lironde,4,4,8,2022,01-17,03:13
046 P�re Soulas,6,2,8,2022,01-17,03:13
047 Place Viala,3,5,8,2022,01-17,03:13
048 H�tel du D�partement,1,7,8,2022,01-17,03:13
049 Tonnelles,1,7,8,2022,01-17,03:13
050 Parvis Jules Ferry - Gare Saint-Roch,8,0,8,2022,01-17,03:13
051 Pont de Lattes - Gare Saint-Roch,0,12,12,2022,01-17,03:13
053 Deux Ponts - Gare Saint-Roch,3,5,8,2022,01-17,03:13
054 Providence - Ovalie,3,5,8,2022,01-17,03:13
055 P�rols Etang de l'Or,32,36,68,2022,01-17,03:13
056 Albert 1er - Cath�drale,7,5,12,2022,01-17,03:13
057 Saint-Guilhem - Courreau,3,5,8,2022,01-17,03:13
059 Sud De France,0,8,8,2022,01-17,03:13
001 Rue Jules Ferry - Gare Saint-Roch,4,8,12,2022,01-17,03:23
002 Com�die,5,19,24,2022,01-17,03:23
003 Esplanade,0,32,32,2022,01-17,03:23
004 H�tel de Ville,14,2,16,2022,01-17,03:23
005 Corum,2,10,12,2022,01-17,03:23
006 Place Albert 1er - St Charles,16,15,31,2022,01-17,03:23
007 Foch,3,5,8,2022,01-17,03:23
008 Halles Castellane,0,12,12,2022,01-17,03:23
009 Observatoire,4,4,8,2022,01-17,03:23
010 Rondelet,4,12,16,2022,01-17,03:23
011 Plan Cabanes,5,7,12,2022,01-17,03:23
012 Boutonnet,1,11,12,2022,01-17,03:23
013 Emile Combes,6,2,8,2022,01-17,03:23
014 Beaux-Arts,7,1,8,2022,01-17,03:23
015 Les Aubes,6,2,8,2022,01-17,03:23
016 Antigone centre,15,1,16,2022,01-17,03:23
017 M�diath�que Emile Zola,8,8,16,2022,01-17,03:23
018 Nombre d'Or,15,1,16,2022,01-17,03:23
019 Louis Blanc,8,8,16,2022,01-17,03:23
020 Gambetta,1,7,8,2022,01-17,03:23
021 Port Marianne,16,0,16,2022,01-17,03:23
022 Clemenceau,5,7,12,2022,01-17,03:23
023 Les Arceaux,4,12,16,2022,01-17,03:23
024 Cit� Mion,3,5,8,2022,01-17,03:23
025 Nouveau Saint-Roch,4,4,8,2022,01-17,03:23
026 Renouvier,0,8,8,2022,01-17,03:23
027 Odysseum,3,5,8,2022,01-17,03:23
028 Saint-Denis,8,0,8,2022,01-17,03:23
029 Richter,8,8,16,2022,01-17,03:23
030 Charles Flahault,4,4,8,2022,01-17,03:23
031 Voltaire,2,6,8,2022,01-17,03:23
032 Pr�s d'Ar�nes,7,1,8,2022,01-17,03:23
033 Garcia Lorca,7,1,8,2022,01-17,03:23
034 Vert Bois,0,16,16,2022,01-17,03:23
035 Malbosc,0,8,8,2022,01-17,03:23
036 Occitanie,3,29,32,2022,01-17,03:23
037 FacdesSciences,11,13,24,2022,01-17,03:23
038 Fac de Lettres,6,10,16,2022,01-17,03:23
039 Aiguelongue,6,2,8,2022,01-17,03:23
040 Jeu de Mail des Abb�s,7,1,8,2022,01-17,03:23
041 Eurom�decine,1,7,8,2022,01-17,03:23
042 Marie Caizergues,2,6,8,2022,01-17,03:23
043 Sabines,2,6,8,2022,01-17,03:23
044 Celleneuve,4,4,8,2022,01-17,03:23
045 Jardin de la Lironde,4,4,8,2022,01-17,03:23
046 P�re Soulas,6,2,8,2022,01-17,03:23
047 Place Viala,3,5,8,2022,01-17,03:23
048 H�tel du D�partement,1,7,8,2022,01-17,03:23
049 Tonnelles,1,7,8,2022,01-17,03:23
050 Parvis Jules Ferry - Gare Saint-Roch,8,0,8,2022,01-17,03:23
051 Pont de Lattes - Gare Saint-Roch,0,12,12,2022,01-17,03:23
053 Deux Ponts - Gare Saint-Roch,3,5,8,2022,01-17,03:23
054 Providence - Ovalie,3,5,8,2022,01-17,03:23
055 P�rols Etang de l'Or,32,36,68,2022,01-17,03:23
056 Albert 1er - Cath�drale,7,5,12,2022,01-17,03:23
057 Saint-Guilhem - Courreau,3,5,8,2022,01-17,03:23
059 Sud De France,0,8,8,2022,01-17,03:23
001 Rue Jules Ferry - Gare Saint-Roch,4,8,12,2022,01-17,03:33
002 Com�die,5,19,24,2022,01-17,03:33
003 Esplanade,0,32,32,2022,01-17,03:33
004 H�tel de Ville,14,2,16,2022,01-17,03:33
005 Corum,2,10,12,2022,01-17,03:33
006 Place Albert 1er - St Charles,16,15,31,2022,01-17,03:33
007 Foch,3,5,8,2022,01-17,03:33
008 Halles Castellane,0,12,12,2022,01-17,03:33
009 Observatoire,4,4,8,2022,01-17,03:33
010 Rondelet,4,12,16,2022,01-17,03:33
011 Plan Cabanes,5,7,12,2022,01-17,03:33
012 Boutonnet,1,11,12,2022,01-17,03:33
013 Emile Combes,6,2,8,2022,01-17,03:33
014 Beaux-Arts,7,1,8,2022,01-17,03:33
015 Les Aubes,6,2,8,2022,01-17,03:33
016 Antigone centre,15,1,16,2022,01-17,03:33
017 M�diath�que Emile Zola,8,8,16,2022,01-17,03:33
018 Nombre d'Or,15,1,16,2022,01-17,03:33
019 Louis Blanc,8,8,16,2022,01-17,03:33
020 Gambetta,1,7,8,2022,01-17,03:33
021 Port Marianne,16,0,16,2022,01-17,03:33
022 Clemenceau,5,7,12,2022,01-17,03:33
023 Les Arceaux,4,12,16,2022,01-17,03:33
024 Cit� Mion,3,5,8,2022,01-17,03:33
025 Nouveau Saint-Roch,4,4,8,2022,01-17,03:33
026 Renouvier,0,8,8,2022,01-17,03:33
027 Odysseum,3,5,8,2022,01-17,03:33
028 Saint-Denis,8,0,8,2022,01-17,03:33
029 Richter,8,8,16,2022,01-17,03:33
030 Charles Flahault,4,4,8,2022,01-17,03:33
031 Voltaire,2,6,8,2022,01-17,03:33
032 Pr�s d'Ar�nes,7,1,8,2022,01-17,03:33
033 Garcia Lorca,7,1,8,2022,01-17,03:33
034 Vert Bois,0,16,16,2022,01-17,03:33
035 Malbosc,0,8,8,2022,01-17,03:33
036 Occitanie,3,29,32,2022,01-17,03:33
037 FacdesSciences,11,13,24,2022,01-17,03:33
038 Fac de Lettres,5,11,16,2022,01-17,03:33
039 Aiguelongue,6,2,8,2022,01-17,03:33
040 Jeu de Mail des Abb�s,7,1,8,2022,01-17,03:33
041 Eurom�decine,1,7,8,2022,01-17,03:33
042 Marie Caizergues,2,6,8,2022,01-17,03:33
043 Sabines,1,7,8,2022,01-17,03:33
044 Celleneuve,4,4,8,2022,01-17,03:33
045 Jardin de la Lironde,4,4,8,2022,01-17,03:33
046 P�re Soulas,6,2,8,2022,01-17,03:33
047 Place Viala,3,5,8,2022,01-17,03:33
048 H�tel du D�partement,1,7,8,2022,01-17,03:33
049 Tonnelles,1,7,8,2022,01-17,03:33
050 Parvis Jules Ferry - Gare Saint-Roch,8,0,8,2022,01-17,03:33
051 Pont de Lattes - Gare Saint-Roch,0,12,12,2022,01-17,03:33
053 Deux Ponts - Gare Saint-Roch,3,5,8,2022,01-17,03:33
054 Providence - Ovalie,3,5,8,2022,01-17,03:33
055 P�rols Etang de l'Or,32,36,68,2022,01-17,03:33
056 Albert 1er - Cath�drale,7,5,12,2022,01-17,03:33
057 Saint-Guilhem - Courreau,3,5,8,2022,01-17,03:33
059 Sud De France,0,8,8,2022,01-17,03:33
001 Rue Jules Ferry - Gare Saint-Roch,4,8,12,2022,01-17,03:43
002 Com�die,5,19,24,2022,01-17,03:43
003 Esplanade,0,32,32,2022,01-17,03:43
004 H�tel de Ville,13,3,16,2022,01-17,03:43
005 Corum,2,10,12,2022,01-17,03:43
006 Place Albert 1er - St Charles,16,15,31,2022,01-17,03:43
007 Foch,3,5,8,2022,01-17,03:43
008 Halles Castellane,0,12,12,2022,01-17,03:43
009 Observatoire,4,4,8,2022,01-17,03:43
010 Rondelet,4,12,16,2022,01-17,03:43
011 Plan Cabanes,5,7,12,2022,01-17,03:43
012 Boutonnet,1,11,12,2022,01-17,03:43
013 Emile Combes,6,2,8,2022,01-17,03:43
014 Beaux-Arts,7,1,8,2022,01-17,03:43
015 Les Aubes,6,2,8,2022,01-17,03:43
016 Antigone centre,15,1,16,2022,01-17,03:43
017 M�diath�que Emile Zola,8,8,16,2022,01-17,03:43
018 Nombre d'Or,15,1,16,2022,01-17,03:43
019 Louis Blanc,8,8,16,2022,01-17,03:43
020 Gambetta,1,7,8,2022,01-17,03:43
021 Port Marianne,16,0,16,2022,01-17,03:43
022 Clemenceau,5,7,12,2022,01-17,03:43
023 Les Arceaux,4,12,16,2022,01-17,03:43
024 Cit� Mion,3,5,8,2022,01-17,03:43
025 Nouveau Saint-Roch,4,4,8,2022,01-17,03:43
026 Renouvier,0,8,8,2022,01-17,03:43
027 Odysseum,3,5,8,2022,01-17,03:43
028 Saint-Denis,8,0,8,2022,01-17,03:43
029 Richter,8,8,16,2022,01-17,03:43
030 Charles Flahault,4,4,8,2022,01-17,03:43
031 Voltaire,2,6,8,2022,01-17,03:43
032 Pr�s d'Ar�nes,7,1,8,2022,01-17,03:43
033 Garcia Lorca,7,1,8,2022,01-17,03:43
034 Vert Bois,0,16,16,2022,01-17,03:43
035 Malbosc,0,8,8,2022,01-17,03:43
036 Occitanie,3,29,32,2022,01-17,03:43
037 FacdesSciences,11,13,24,2022,01-17,03:43
038 Fac de Lettres,5,11,16,2022,01-17,03:43
039 Aiguelongue,6,2,8,2022,01-17,03:43
040 Jeu de Mail des Abb�s,7,1,8,2022,01-17,03:43
041 Eurom�decine,1,7,8,2022,01-17,03:43
042 Marie Caizergues,2,6,8,2022,01-17,03:43
043 Sabines,1,7,8,2022,01-17,03:43
044 Celleneuve,4,4,8,2022,01-17,03:43
045 Jardin de la Lironde,4,4,8,2022,01-17,03:43
046 P�re Soulas,6,2,8,2022,01-17,03:43
047 Place Viala,3,5,8,2022,01-17,03:43
048 H�tel du D�partement,1,7,8,2022,01-17,03:43
049 Tonnelles,1,7,8,2022,01-17,03:43
050 Parvis Jules Ferry - Gare Saint-Roch,8,0,8,2022,01-17,03:43
051 Pont de Lattes - Gare Saint-Roch,0,12,12,2022,01-17,03:43
053 Deux Ponts - Gare Saint-Roch,3,5,8,2022,01-17,03:43
054 Providence - Ovalie,3,5,8,2022,01-17,03:43
055 P�rols Etang de l'Or,32,36,68,2022,01-17,03:43
056 Albert 1er - Cath�drale,7,5,12,2022,01-17,03:43
057 Saint-Guilhem - Courreau,3,5,8,2022,01-17,03:43
059 Sud De France,0,8,8,2022,01-17,03:43
001 Rue Jules Ferry - Gare Saint-Roch,4,8,12,2022,01-17,03:54
002 Com�die,5,19,24,2022,01-17,03:54
003 Esplanade,0,32,32,2022,01-17,03:54
004 H�tel de Ville,13,3,16,2022,01-17,03:54
005 Corum,2,10,12,2022,01-17,03:54
006 Place Albert 1er - St Charles,16,15,31,2022,01-17,03:54
007 Foch,3,5,8,2022,01-17,03:54
008 Halles Castellane,0,12,12,2022,01-17,03:54
009 Observatoire,4,4,8,2022,01-17,03:54
010 Rondelet,4,12,16,2022,01-17,03:54
011 Plan Cabanes,5,7,12,2022,01-17,03:54
012 Boutonnet,1,11,12,2022,01-17,03:54
013 Emile Combes,6,2,8,2022,01-17,03:54
014 Beaux-Arts,7,1,8,2022,01-17,03:54
015 Les Aubes,6,2,8,2022,01-17,03:54
016 Antigone centre,15,1,16,2022,01-17,03:54
017 M�diath�que Emile Zola,8,8,16,2022,01-17,03:54
018 Nombre d'Or,15,1,16,2022,01-17,03:54
019 Louis Blanc,8,8,16,2022,01-17,03:54
020 Gambetta,1,7,8,2022,01-17,03:54
021 Port Marianne,16,0,16,2022,01-17,03:54
022 Clemenceau,5,7,12,2022,01-17,03:54
023 Les Arceaux,4,12,16,2022,01-17,03:54
024 Cit� Mion,3,5,8,2022,01-17,03:54
025 Nouveau Saint-Roch,4,4,8,2022,01-17,03:54
026 Renouvier,0,8,8,2022,01-17,03:54
027 Odysseum,3,5,8,2022,01-17,03:54
028 Saint-Denis,8,0,8,2022,01-17,03:54
029 Richter,8,8,16,2022,01-17,03:54
030 Charles Flahault,4,4,8,2022,01-17,03:54
031 Voltaire,2,6,8,2022,01-17,03:54
032 Pr�s d'Ar�nes,7,1,8,2022,01-17,03:54
033 Garcia Lorca,7,1,8,2022,01-17,03:54
034 Vert Bois,0,16,16,2022,01-17,03:54
035 Malbosc,0,8,8,2022,01-17,03:54
036 Occitanie,3,29,32,2022,01-17,03:54
037 FacdesSciences,11,13,24,2022,01-17,03:54
038 Fac de Lettres,5,11,16,2022,01-17,03:54
039 Aiguelongue,6,2,8,2022,01-17,03:54
040 Jeu de Mail des Abb�s,7,1,8,2022,01-17,03:54
041 Eurom�decine,1,7,8,2022,01-17,03:54
042 Marie Caizergues,2,6,8,2022,01-17,03:54
043 Sabines,1,7,8,2022,01-17,03:54
044 Celleneuve,4,4,8,2022,01-17,03:54
045 Jardin de la Lironde,4,4,8,2022,01-17,03:54
046 P�re Soulas,6,2,8,2022,01-17,03:54
047 Place Viala,3,5,8,2022,01-17,03:54
048 H�tel du D�partement,1,7,8,2022,01-17,03:54
049 Tonnelles,1,7,8,2022,01-17,03:54
050 Parvis Jules Ferry - Gare Saint-Roch,8,0,8,2022,01-17,03:54
051 Pont de Lattes - Gare Saint-Roch,0,12,12,2022,01-17,03:54
053 Deux Ponts - Gare Saint-Roch,3,5,8,2022,01-17,03:54
054 Providence - Ovalie,3,5,8,2022,01-17,03:54
055 P�rols Etang de l'Or,32,36,68,2022,01-17,03:54
056 Albert 1er - Cath�drale,7,5,12,2022,01-17,03:54
057 Saint-Guilhem - Courreau,3,5,8,2022,01-17,03:54
059 Sud De France,0,8,8,2022,01-17,03:54
001 Rue Jules Ferry - Gare Saint-Roch,4,8,12,2022,01-17,04:04
002 Com�die,5,19,24,2022,01-17,04:04
003 Esplanade,0,32,32,2022,01-17,04:04
004 H�tel de Ville,13,3,16,2022,01-17,04:04
005 Corum,2,10,12,2022,01-17,04:04
006 Place Albert 1er - St Charles,16,15,31,2022,01-17,04:04
007 Foch,3,5,8,2022,01-17,04:04
008 Halles Castellane,0,12,12,2022,01-17,04:04
009 Observatoire,4,4,8,2022,01-17,04:04
010 Rondelet,4,12,16,2022,01-17,04:04
011 Plan Cabanes,5,7,12,2022,01-17,04:04
012 Boutonnet,1,11,12,2022,01-17,04:04
013 Emile Combes,6,2,8,2022,01-17,04:04
014 Beaux-Arts,7,1,8,2022,01-17,04:04
015 Les Aubes,6,2,8,2022,01-17,04:04
016 Antigone centre,15,1,16,2022,01-17,04:04
017 M�diath�que Emile Zola,8,8,16,2022,01-17,04:04
018 Nombre d'Or,15,1,16,2022,01-17,04:04
019 Louis Blanc,8,8,16,2022,01-17,04:04
020 Gambetta,1,7,8,2022,01-17,04:04
021 Port Marianne,16,0,16,2022,01-17,04:04
022 Clemenceau,5,7,12,2022,01-17,04:04
023 Les Arceaux,4,12,16,2022,01-17,04:04
024 Cit� Mion,3,5,8,2022,01-17,04:04
025 Nouveau Saint-Roch,4,4,8,2022,01-17,04:04
026 Renouvier,0,8,8,2022,01-17,04:04
027 Odysseum,3,5,8,2022,01-17,04:04
028 Saint-Denis,8,0,8,2022,01-17,04:04
029 Richter,8,8,16,2022,01-17,04:04
030 Charles Flahault,4,4,8,2022,01-17,04:04
031 Voltaire,2,6,8,2022,01-17,04:04
032 Pr�s d'Ar�nes,7,1,8,2022,01-17,04:04
033 Garcia Lorca,7,1,8,2022,01-17,04:04
034 Vert Bois,0,16,16,2022,01-17,04:04
035 Malbosc,0,8,8,2022,01-17,04:04
036 Occitanie,3,29,32,2022,01-17,04:04
037 FacdesSciences,11,13,24,2022,01-17,04:04
038 Fac de Lettres,5,11,16,2022,01-17,04:04
039 Aiguelongue,6,2,8,2022,01-17,04:04
040 Jeu de Mail des Abb�s,7,1,8,2022,01-17,04:04
041 Eurom�decine,1,7,8,2022,01-17,04:04
042 Marie Caizergues,2,6,8,2022,01-17,04:04
043 Sabines,1,7,8,2022,01-17,04:04
044 Celleneuve,4,4,8,2022,01-17,04:04
045 Jardin de la Lironde,4,4,8,2022,01-17,04:04
046 P�re Soulas,6,2,8,2022,01-17,04:04
047 Place Viala,3,5,8,2022,01-17,04:04
048 H�tel du D�partement,1,7,8,2022,01-17,04:04
049 Tonnelles,1,7,8,2022,01-17,04:04
050 Parvis Jules Ferry - Gare Saint-Roch,8,0,8,2022,01-17,04:04
051 Pont de Lattes - Gare Saint-Roch,0,12,12,2022,01-17,04:04
053 Deux Ponts - Gare Saint-Roch,3,5,8,2022,01-17,04:04
054 Providence - Ovalie,3,5,8,2022,01-17,04:04
055 P�rols Etang de l'Or,32,36,68,2022,01-17,04:04
056 Albert 1er - Cath�drale,7,5,12,2022,01-17,04:04
057 Saint-Guilhem - Courreau,3,5,8,2022,01-17,04:04
059 Sud De France,0,8,8,2022,01-17,04:04
001 Rue Jules Ferry - Gare Saint-Roch,4,8,12,2022,01-17,04:14
002 Com�die,5,19,24,2022,01-17,04:14
003 Esplanade,0,32,32,2022,01-17,04:14
004 H�tel de Ville,13,3,16,2022,01-17,04:14
005 Corum,2,10,12,2022,01-17,04:14
006 Place Albert 1er - St Charles,16,15,31,2022,01-17,04:14
007 Foch,3,5,8,2022,01-17,04:14
008 Halles Castellane,0,12,12,2022,01-17,04:14
009 Observatoire,4,4,8,2022,01-17,04:14
010 Rondelet,4,12,16,2022,01-17,04:14
011 Plan Cabanes,5,7,12,2022,01-17,04:14
012 Boutonnet,1,11,12,2022,01-17,04:14
013 Emile Combes,6,2,8,2022,01-17,04:14
014 Beaux-Arts,7,1,8,2022,01-17,04:14
015 Les Aubes,6,2,8,2022,01-17,04:14
016 Antigone centre,15,1,16,2022,01-17,04:14
017 M�diath�que Emile Zola,8,8,16,2022,01-17,04:14
018 Nombre d'Or,15,1,16,2022,01-17,04:14
019 Louis Blanc,8,8,16,2022,01-17,04:14
020 Gambetta,1,7,8,2022,01-17,04:14
021 Port Marianne,16,0,16,2022,01-17,04:14
022 Clemenceau,5,7,12,2022,01-17,04:14
023 Les Arceaux,4,12,16,2022,01-17,04:14
024 Cit� Mion,3,5,8,2022,01-17,04:14
025 Nouveau Saint-Roch,4,4,8,2022,01-17,04:14
026 Renouvier,0,8,8,2022,01-17,04:14
027 Odysseum,3,5,8,2022,01-17,04:14
028 Saint-Denis,8,0,8,2022,01-17,04:14
029 Richter,8,8,16,2022,01-17,04:14
030 Charles Flahault,4,4,8,2022,01-17,04:14
031 Voltaire,2,6,8,2022,01-17,04:14
032 Pr�s d'Ar�nes,7,1,8,2022,01-17,04:14
033 Garcia Lorca,7,1,8,2022,01-17,04:14
034 Vert Bois,0,16,16,2022,01-17,04:14
035 Malbosc,0,8,8,2022,01-17,04:14
036 Occitanie,3,29,32,2022,01-17,04:14
037 FacdesSciences,11,13,24,2022,01-17,04:14
038 Fac de Lettres,5,11,16,2022,01-17,04:14
039 Aiguelongue,6,2,8,2022,01-17,04:14
040 Jeu de Mail des Abb�s,7,1,8,2022,01-17,04:14
041 Eurom�decine,1,7,8,2022,01-17,04:14
042 Marie Caizergues,2,6,8,2022,01-17,04:14
043 Sabines,1,7,8,2022,01-17,04:14
044 Celleneuve,4,4,8,2022,01-17,04:14
045 Jardin de la Lironde,4,4,8,2022,01-17,04:14
046 P�re Soulas,6,2,8,2022,01-17,04:14
047 Place Viala,3,5,8,2022,01-17,04:14
048 H�tel du D�partement,1,7,8,2022,01-17,04:14
049 Tonnelles,1,7,8,2022,01-17,04:14
050 Parvis Jules Ferry - Gare Saint-Roch,8,0,8,2022,01-17,04:14
051 Pont de Lattes - Gare Saint-Roch,0,12,12,2022,01-17,04:14
053 Deux Ponts - Gare Saint-Roch,3,5,8,2022,01-17,04:14
054 Providence - Ovalie,3,5,8,2022,01-17,04:14
055 P�rols Etang de l'Or,32,36,68,2022,01-17,04:14
056 Albert 1er - Cath�drale,7,5,12,2022,01-17,04:14
057 Saint-Guilhem - Courreau,3,5,8,2022,01-17,04:14
059 Sud De France,0,8,8,2022,01-17,04:14
001 Rue Jules Ferry - Gare Saint-Roch,4,8,12,2022,01-17,04:24
002 Com�die,5,19,24,2022,01-17,04:24
003 Esplanade,0,32,32,2022,01-17,04:24
004 H�tel de Ville,13,3,16,2022,01-17,04:24
005 Corum,2,10,12,2022,01-17,04:24
006 Place Albert 1er - St Charles,16,15,31,2022,01-17,04:24
007 Foch,3,5,8,2022,01-17,04:24
008 Halles Castellane,0,12,12,2022,01-17,04:24
009 Observatoire,4,4,8,2022,01-17,04:24
010 Rondelet,4,12,16,2022,01-17,04:24
011 Plan Cabanes,5,7,12,2022,01-17,04:24
012 Boutonnet,1,11,12,2022,01-17,04:24
013 Emile Combes,6,2,8,2022,01-17,04:24
014 Beaux-Arts,7,1,8,2022,01-17,04:24
015 Les Aubes,6,2,8,2022,01-17,04:24
016 Antigone centre,15,1,16,2022,01-17,04:24
017 M�diath�que Emile Zola,8,8,16,2022,01-17,04:24
018 Nombre d'Or,15,1,16,2022,01-17,04:24
019 Louis Blanc,8,8,16,2022,01-17,04:24
020 Gambetta,1,7,8,2022,01-17,04:24
021 Port Marianne,16,0,16,2022,01-17,04:24
022 Clemenceau,5,7,12,2022,01-17,04:24
023 Les Arceaux,4,12,16,2022,01-17,04:24
024 Cit� Mion,3,5,8,2022,01-17,04:24
025 Nouveau Saint-Roch,4,4,8,2022,01-17,04:24
026 Renouvier,0,8,8,2022,01-17,04:24
027 Odysseum,3,5,8,2022,01-17,04:24
028 Saint-Denis,8,0,8,2022,01-17,04:24
029 Richter,8,8,16,2022,01-17,04:24
030 Charles Flahault,4,4,8,2022,01-17,04:24
031 Voltaire,2,6,8,2022,01-17,04:24
032 Pr�s d'Ar�nes,7,1,8,2022,01-17,04:24
033 Garcia Lorca,7,1,8,2022,01-17,04:24
034 Vert Bois,0,16,16,2022,01-17,04:24
035 Malbosc,0,8,8,2022,01-17,04:24
036 Occitanie,3,29,32,2022,01-17,04:24
037 FacdesSciences,11,13,24,2022,01-17,04:24
038 Fac de Lettres,7,9,16,2022,01-17,04:24
039 Aiguelongue,6,2,8,2022,01-17,04:24
040 Jeu de Mail des Abb�s,7,1,8,2022,01-17,04:24
041 Eurom�decine,1,7,8,2022,01-17,04:24
042 Marie Caizergues,2,6,8,2022,01-17,04:24
043 Sabines,1,7,8,2022,01-17,04:24
044 Celleneuve,4,4,8,2022,01-17,04:24
045 Jardin de la Lironde,4,4,8,2022,01-17,04:24
046 P�re Soulas,6,2,8,2022,01-17,04:24
047 Place Viala,3,5,8,2022,01-17,04:24
048 H�tel du D�partement,1,7,8,2022,01-17,04:24
049 Tonnelles,1,7,8,2022,01-17,04:24
050 Parvis Jules Ferry - Gare Saint-Roch,8,0,8,2022,01-17,04:24
051 Pont de Lattes - Gare Saint-Roch,0,12,12,2022,01-17,04:24
053 Deux Ponts - Gare Saint-Roch,3,5,8,2022,01-17,04:24
054 Providence - Ovalie,3,5,8,2022,01-17,04:24
055 P�rols Etang de l'Or,32,36,68,2022,01-17,04:24
056 Albert 1er - Cath�drale,7,5,12,2022,01-17,04:24
057 Saint-Guilhem - Courreau,3,5,8,2022,01-17,04:24
059 Sud De France,0,8,8,2022,01-17,04:24
001 Rue Jules Ferry - Gare Saint-Roch,4,8,12,2022,01-17,04:34
002 Com�die,5,19,24,2022,01-17,04:34
003 Esplanade,0,32,32,2022,01-17,04:34
004 H�tel de Ville,13,3,16,2022,01-17,04:34
005 Corum,2,10,12,2022,01-17,04:34
006 Place Albert 1er - St Charles,16,15,31,2022,01-17,04:34
007 Foch,3,5,8,2022,01-17,04:34
008 Halles Castellane,0,12,12,2022,01-17,04:34
009 Observatoire,4,4,8,2022,01-17,04:34
010 Rondelet,4,12,16,2022,01-17,04:34
011 Plan Cabanes,5,7,12,2022,01-17,04:34
012 Boutonnet,1,11,12,2022,01-17,04:34
013 Emile Combes,6,2,8,2022,01-17,04:34
014 Beaux-Arts,7,1,8,2022,01-17,04:34
015 Les Aubes,6,2,8,2022,01-17,04:34
016 Antigone centre,15,1,16,2022,01-17,04:34
017 M�diath�que Emile Zola,8,8,16,2022,01-17,04:34
018 Nombre d'Or,15,1,16,2022,01-17,04:34
019 Louis Blanc,8,8,16,2022,01-17,04:34
020 Gambetta,1,7,8,2022,01-17,04:34
021 Port Marianne,16,0,16,2022,01-17,04:34
022 Clemenceau,5,7,12,2022,01-17,04:34
023 Les Arceaux,4,12,16,2022,01-17,04:34
024 Cit� Mion,3,5,8,2022,01-17,04:34
025 Nouveau Saint-Roch,4,4,8,2022,01-17,04:34
026 Renouvier,0,8,8,2022,01-17,04:34
027 Odysseum,3,5,8,2022,01-17,04:34
028 Saint-Denis,8,0,8,2022,01-17,04:34
029 Richter,8,8,16,2022,01-17,04:34
030 Charles Flahault,5,3,8,2022,01-17,04:34
031 Voltaire,2,6,8,2022,01-17,04:34
032 Pr�s d'Ar�nes,7,1,8,2022,01-17,04:34
033 Garcia Lorca,7,1,8,2022,01-17,04:34
034 Vert Bois,0,16,16,2022,01-17,04:34
035 Malbosc,0,8,8,2022,01-17,04:34
036 Occitanie,3,29,32,2022,01-17,04:34
037 FacdesSciences,11,13,24,2022,01-17,04:34
038 Fac de Lettres,7,9,16,2022,01-17,04:34
039 Aiguelongue,6,2,8,2022,01-17,04:34
040 Jeu de Mail des Abb�s,7,1,8,2022,01-17,04:34
041 Eurom�decine,1,7,8,2022,01-17,04:34
042 Marie Caizergues,2,6,8,2022,01-17,04:34
043 Sabines,1,7,8,2022,01-17,04:34
044 Celleneuve,4,4,8,2022,01-17,04:34
045 Jardin de la Lironde,4,4,8,2022,01-17,04:34
046 P�re Soulas,6,2,8,2022,01-17,04:34
047 Place Viala,3,5,8,2022,01-17,04:34
048 H�tel du D�partement,1,7,8,2022,01-17,04:34
049 Tonnelles,1,7,8,2022,01-17,04:34
050 Parvis Jules Ferry - Gare Saint-Roch,8,0,8,2022,01-17,04:34
051 Pont de Lattes - Gare Saint-Roch,0,12,12,2022,01-17,04:34
053 Deux Ponts - Gare Saint-Roch,3,5,8,2022,01-17,04:34
054 Providence - Ovalie,3,5,8,2022,01-17,04:34
055 P�rols Etang de l'Or,32,36,68,2022,01-17,04:34
056 Albert 1er - Cath�drale,7,5,12,2022,01-17,04:34
057 Saint-Guilhem - Courreau,3,5,8,2022,01-17,04:34
059 Sud De France,0,8,8,2022,01-17,04:34
001 Rue Jules Ferry - Gare Saint-Roch,4,8,12,2022,01-17,04:44
002 Com�die,5,19,24,2022,01-17,04:44
003 Esplanade,0,32,32,2022,01-17,04:44
004 H�tel de Ville,13,3,16,2022,01-17,04:44
005 Corum,2,10,12,2022,01-17,04:44
006 Place Albert 1er - St Charles,16,15,31,2022,01-17,04:44
007 Foch,3,5,8,2022,01-17,04:44
008 Halles Castellane,0,12,12,2022,01-17,04:44
009 Observatoire,4,4,8,2022,01-17,04:44
010 Rondelet,4,12,16,2022,01-17,04:44
011 Plan Cabanes,5,7,12,2022,01-17,04:44
012 Boutonnet,1,11,12,2022,01-17,04:44
013 Emile Combes,6,2,8,2022,01-17,04:44
014 Beaux-Arts,7,1,8,2022,01-17,04:44
015 Les Aubes,6,2,8,2022,01-17,04:44
016 Antigone centre,15,1,16,2022,01-17,04:44
017 M�diath�que Emile Zola,8,8,16,2022,01-17,04:44
018 Nombre d'Or,15,1,16,2022,01-17,04:44
019 Louis Blanc,8,8,16,2022,01-17,04:44
020 Gambetta,1,7,8,2022,01-17,04:44
021 Port Marianne,16,0,16,2022,01-17,04:44
022 Clemenceau,5,7,12,2022,01-17,04:44
023 Les Arceaux,4,12,16,2022,01-17,04:44
024 Cit� Mion,3,5,8,2022,01-17,04:44
025 Nouveau Saint-Roch,4,4,8,2022,01-17,04:44
026 Renouvier,0,8,8,2022,01-17,04:44
027 Odysseum,3,5,8,2022,01-17,04:44
028 Saint-Denis,8,0,8,2022,01-17,04:44
029 Richter,8,8,16,2022,01-17,04:44
030 Charles Flahault,5,3,8,2022,01-17,04:44
031 Voltaire,2,6,8,2022,01-17,04:44
032 Pr�s d'Ar�nes,7,1,8,2022,01-17,04:44
033 Garcia Lorca,7,1,8,2022,01-17,04:44
034 Vert Bois,0,16,16,2022,01-17,04:44
035 Malbosc,0,8,8,2022,01-17,04:44
036 Occitanie,3,29,32,2022,01-17,04:44
037 FacdesSciences,10,14,24,2022,01-17,04:44
038 Fac de Lettres,7,9,16,2022,01-17,04:44
039 Aiguelongue,6,2,8,2022,01-17,04:44
040 Jeu de Mail des Abb�s,7,1,8,2022,01-17,04:44
041 Eurom�decine,1,7,8,2022,01-17,04:44
042 Marie Caizergues,2,6,8,2022,01-17,04:44
043 Sabines,1,7,8,2022,01-17,04:44
044 Celleneuve,4,4,8,2022,01-17,04:44
045 Jardin de la Lironde,4,4,8,2022,01-17,04:44
046 P�re Soulas,6,2,8,2022,01-17,04:44
047 Place Viala,3,5,8,2022,01-17,04:44
048 H�tel du D�partement,1,7,8,2022,01-17,04:44
049 Tonnelles,1,7,8,2022,01-17,04:44
050 Parvis Jules Ferry - Gare Saint-Roch,8,0,8,2022,01-17,04:44
051 Pont de Lattes - Gare Saint-Roch,0,12,12,2022,01-17,04:44
053 Deux Ponts - Gare Saint-Roch,3,5,8,2022,01-17,04:44
054 Providence - Ovalie,3,5,8,2022,01-17,04:44
055 P�rols Etang de l'Or,32,36,68,2022,01-17,04:44
056 Albert 1er - Cath�drale,7,5,12,2022,01-17,04:44
057 Saint-Guilhem - Courreau,3,5,8,2022,01-17,04:44
059 Sud De France,0,8,8,2022,01-17,04:44
001 Rue Jules Ferry - Gare Saint-Roch,4,8,12,2022,01-17,04:54
002 Com�die,5,19,24,2022,01-17,04:54
003 Esplanade,0,32,32,2022,01-17,04:54
004 H�tel de Ville,13,3,16,2022,01-17,04:54
005 Corum,2,10,12,2022,01-17,04:54
006 Place Albert 1er - St Charles,16,15,31,2022,01-17,04:54
007 Foch,3,5,8,2022,01-17,04:54
008 Halles Castellane,0,12,12,2022,01-17,04:54
009 Observatoire,4,4,8,2022,01-17,04:54
010 Rondelet,4,12,16,2022,01-17,04:54
011 Plan Cabanes,5,7,12,2022,01-17,04:54
012 Boutonnet,1,11,12,2022,01-17,04:54
013 Emile Combes,6,2,8,2022,01-17,04:54
014 Beaux-Arts,7,1,8,2022,01-17,04:54
015 Les Aubes,6,2,8,2022,01-17,04:54
016 Antigone centre,15,1,16,2022,01-17,04:54
017 M�diath�que Emile Zola,8,8,16,2022,01-17,04:54
018 Nombre d'Or,15,1,16,2022,01-17,04:54
019 Louis Blanc,8,8,16,2022,01-17,04:54
020 Gambetta,1,7,8,2022,01-17,04:54
021 Port Marianne,16,0,16,2022,01-17,04:54
022 Clemenceau,5,7,12,2022,01-17,04:54
023 Les Arceaux,4,12,16,2022,01-17,04:54
024 Cit� Mion,3,5,8,2022,01-17,04:54
025 Nouveau Saint-Roch,4,4,8,2022,01-17,04:54
026 Renouvier,0,8,8,2022,01-17,04:54
027 Odysseum,3,5,8,2022,01-17,04:54
028 Saint-Denis,8,0,8,2022,01-17,04:54
029 Richter,8,8,16,2022,01-17,04:54
030 Charles Flahault,5,3,8,2022,01-17,04:54
031 Voltaire,2,6,8,2022,01-17,04:54
032 Pr�s d'Ar�nes,7,1,8,2022,01-17,04:54
033 Garcia Lorca,7,1,8,2022,01-17,04:54
034 Vert Bois,0,16,16,2022,01-17,04:54
035 Malbosc,0,8,8,2022,01-17,04:54
036 Occitanie,3,29,32,2022,01-17,04:54
037 FacdesSciences,10,14,24,2022,01-17,04:54
038 Fac de Lettres,7,9,16,2022,01-17,04:54
039 Aiguelongue,6,2,8,2022,01-17,04:54
040 Jeu de Mail des Abb�s,7,1,8,2022,01-17,04:54
041 Eurom�decine,1,7,8,2022,01-17,04:54
042 Marie Caizergues,2,6,8,2022,01-17,04:54
043 Sabines,1,7,8,2022,01-17,04:54
044 Celleneuve,4,4,8,2022,01-17,04:54
045 Jardin de la Lironde,4,4,8,2022,01-17,04:54
046 P�re Soulas,6,2,8,2022,01-17,04:54
047 Place Viala,3,5,8,2022,01-17,04:54
048 H�tel du D�partement,1,7,8,2022,01-17,04:54
049 Tonnelles,1,7,8,2022,01-17,04:54
050 Parvis Jules Ferry - Gare Saint-Roch,8,0,8,2022,01-17,04:54
051 Pont de Lattes - Gare Saint-Roch,0,12,12,2022,01-17,04:54
053 Deux Ponts - Gare Saint-Roch,3,5,8,2022,01-17,04:54
054 Providence - Ovalie,3,5,8,2022,01-17,04:54
055 P�rols Etang de l'Or,32,36,68,2022,01-17,04:54
056 Albert 1er - Cath�drale,7,5,12,2022,01-17,04:54
057 Saint-Guilhem - Courreau,3,5,8,2022,01-17,04:54
059 Sud De France,0,8,8,2022,01-17,04:54
001 Rue Jules Ferry - Gare Saint-Roch,4,8,12,2022,01-17,05:05
002 Com�die,5,19,24,2022,01-17,05:05
003 Esplanade,0,32,32,2022,01-17,05:05
004 H�tel de Ville,13,3,16,2022,01-17,05:05
005 Corum,3,9,12,2022,01-17,05:05
006 Place Albert 1er - St Charles,16,15,31,2022,01-17,05:05
007 Foch,3,5,8,2022,01-17,05:05
008 Halles Castellane,0,12,12,2022,01-17,05:05
009 Observatoire,4,4,8,2022,01-17,05:05
010 Rondelet,4,12,16,2022,01-17,05:05
011 Plan Cabanes,5,7,12,2022,01-17,05:05
012 Boutonnet,1,11,12,2022,01-17,05:05
013 Emile Combes,6,2,8,2022,01-17,05:05
014 Beaux-Arts,7,1,8,2022,01-17,05:05
015 Les Aubes,6,2,8,2022,01-17,05:05
016 Antigone centre,15,1,16,2022,01-17,05:05
017 M�diath�que Emile Zola,8,8,16,2022,01-17,05:05
018 Nombre d'Or,15,1,16,2022,01-17,05:05
019 Louis Blanc,8,8,16,2022,01-17,05:05
020 Gambetta,1,7,8,2022,01-17,05:05
021 Port Marianne,16,0,16,2022,01-17,05:05
022 Clemenceau,5,7,12,2022,01-17,05:05
023 Les Arceaux,4,12,16,2022,01-17,05:05
024 Cit� Mion,3,5,8,2022,01-17,05:05
025 Nouveau Saint-Roch,4,4,8,2022,01-17,05:05
026 Renouvier,0,8,8,2022,01-17,05:05
027 Odysseum,3,5,8,2022,01-17,05:05
028 Saint-Denis,8,0,8,2022,01-17,05:05
029 Richter,8,8,16,2022,01-17,05:05
030 Charles Flahault,5,3,8,2022,01-17,05:05
031 Voltaire,2,6,8,2022,01-17,05:05
032 Pr�s d'Ar�nes,7,1,8,2022,01-17,05:05
033 Garcia Lorca,7,1,8,2022,01-17,05:05
034 Vert Bois,0,16,16,2022,01-17,05:05
035 Malbosc,0,8,8,2022,01-17,05:05
036 Occitanie,3,29,32,2022,01-17,05:05
037 FacdesSciences,10,14,24,2022,01-17,05:05
038 Fac de Lettres,7,9,16,2022,01-17,05:05
039 Aiguelongue,6,2,8,2022,01-17,05:05
040 Jeu de Mail des Abb�s,7,1,8,2022,01-17,05:05
041 Eurom�decine,1,7,8,2022,01-17,05:05
042 Marie Caizergues,2,6,8,2022,01-17,05:05
043 Sabines,1,7,8,2022,01-17,05:05
044 Celleneuve,4,4,8,2022,01-17,05:05
045 Jardin de la Lironde,4,4,8,2022,01-17,05:05
046 P�re Soulas,6,2,8,2022,01-17,05:05
047 Place Viala,3,5,8,2022,01-17,05:05
048 H�tel du D�partement,1,7,8,2022,01-17,05:05
049 Tonnelles,1,7,8,2022,01-17,05:05
050 Parvis Jules Ferry - Gare Saint-Roch,8,0,8,2022,01-17,05:05
051 Pont de Lattes - Gare Saint-Roch,0,12,12,2022,01-17,05:05
053 Deux Ponts - Gare Saint-Roch,3,5,8,2022,01-17,05:05
054 Providence - Ovalie,3,5,8,2022,01-17,05:05
055 P�rols Etang de l'Or,32,36,68,2022,01-17,05:05
056 Albert 1er - Cath�drale,7,5,12,2022,01-17,05:05
057 Saint-Guilhem - Courreau,3,5,8,2022,01-17,05:05
059 Sud De France,0,8,8,2022,01-17,05:05
001 Rue Jules Ferry - Gare Saint-Roch,4,8,12,2022,01-17,05:15
002 Com�die,5,19,24,2022,01-17,05:15
003 Esplanade,0,32,32,2022,01-17,05:15
004 H�tel de Ville,13,3,16,2022,01-17,05:15
005 Corum,3,9,12,2022,01-17,05:15
006 Place Albert 1er - St Charles,16,15,31,2022,01-17,05:15
007 Foch,3,5,8,2022,01-17,05:15
008 Halles Castellane,0,12,12,2022,01-17,05:15
009 Observatoire,4,4,8,2022,01-17,05:15
010 Rondelet,4,12,16,2022,01-17,05:15
011 Plan Cabanes,5,7,12,2022,01-17,05:15
012 Boutonnet,1,11,12,2022,01-17,05:15
013 Emile Combes,6,2,8,2022,01-17,05:15
014 Beaux-Arts,7,1,8,2022,01-17,05:15
015 Les Aubes,6,2,8,2022,01-17,05:15
016 Antigone centre,15,1,16,2022,01-17,05:15
017 M�diath�que Emile Zola,8,8,16,2022,01-17,05:15
018 Nombre d'Or,15,1,16,2022,01-17,05:15
019 Louis Blanc,8,8,16,2022,01-17,05:15
020 Gambetta,1,7,8,2022,01-17,05:15
021 Port Marianne,16,0,16,2022,01-17,05:15
022 Clemenceau,5,7,12,2022,01-17,05:15
023 Les Arceaux,4,12,16,2022,01-17,05:15
024 Cit� Mion,3,5,8,2022,01-17,05:15
025 Nouveau Saint-Roch,4,4,8,2022,01-17,05:15
026 Renouvier,0,8,8,2022,01-17,05:15
027 Odysseum,3,5,8,2022,01-17,05:15
028 Saint-Denis,8,0,8,2022,01-17,05:15
029 Richter,8,8,16,2022,01-17,05:15
030 Charles Flahault,5,3,8,2022,01-17,05:15
031 Voltaire,2,6,8,2022,01-17,05:15
032 Pr�s d'Ar�nes,7,1,8,2022,01-17,05:15
033 Garcia Lorca,7,1,8,2022,01-17,05:15
034 Vert Bois,0,16,16,2022,01-17,05:15
035 Malbosc,0,8,8,2022,01-17,05:15
036 Occitanie,3,29,32,2022,01-17,05:15
037 FacdesSciences,10,14,24,2022,01-17,05:15
038 Fac de Lettres,7,9,16,2022,01-17,05:15
039 Aiguelongue,6,2,8,2022,01-17,05:15
040 Jeu de Mail des Abb�s,7,1,8,2022,01-17,05:15
041 Eurom�decine,1,7,8,2022,01-17,05:15
042 Marie Caizergues,2,6,8,2022,01-17,05:15
043 Sabines,1,7,8,2022,01-17,05:15
044 Celleneuve,4,4,8,2022,01-17,05:15
045 Jardin de la Lironde,4,4,8,2022,01-17,05:15
046 P�re Soulas,6,2,8,2022,01-17,05:15
047 Place Viala,3,5,8,2022,01-17,05:15
048 H�tel du D�partement,1,7,8,2022,01-17,05:15
049 Tonnelles,1,7,8,2022,01-17,05:15
050 Parvis Jules Ferry - Gare Saint-Roch,8,0,8,2022,01-17,05:15
051 Pont de Lattes - Gare Saint-Roch,0,12,12,2022,01-17,05:15
053 Deux Ponts - Gare Saint-Roch,3,5,8,2022,01-17,05:15
054 Providence - Ovalie,3,5,8,2022,01-17,05:15
055 P�rols Etang de l'Or,32,36,68,2022,01-17,05:15
056 Albert 1er - Cath�drale,7,5,12,2022,01-17,05:15
057 Saint-Guilhem - Courreau,3,5,8,2022,01-17,05:15
059 Sud De France,0,8,8,2022,01-17,05:15
001 Rue Jules Ferry - Gare Saint-Roch,4,8,12,2022,01-17,05:25
002 Com�die,5,19,24,2022,01-17,05:25
003 Esplanade,0,32,32,2022,01-17,05:25
004 H�tel de Ville,13,3,16,2022,01-17,05:25
005 Corum,3,9,12,2022,01-17,05:25
006 Place Albert 1er - St Charles,16,15,31,2022,01-17,05:25
007 Foch,3,5,8,2022,01-17,05:25
008 Halles Castellane,0,12,12,2022,01-17,05:25
009 Observatoire,4,4,8,2022,01-17,05:25
010 Rondelet,4,12,16,2022,01-17,05:25
011 Plan Cabanes,5,7,12,2022,01-17,05:25
012 Boutonnet,1,11,12,2022,01-17,05:25
013 Emile Combes,6,2,8,2022,01-17,05:25
014 Beaux-Arts,7,1,8,2022,01-17,05:25
015 Les Aubes,6,2,8,2022,01-17,05:25
016 Antigone centre,15,1,16,2022,01-17,05:25
017 M�diath�que Emile Zola,8,8,16,2022,01-17,05:25
018 Nombre d'Or,15,1,16,2022,01-17,05:25
019 Louis Blanc,8,8,16,2022,01-17,05:25
020 Gambetta,1,7,8,2022,01-17,05:25
021 Port Marianne,16,0,16,2022,01-17,05:25
022 Clemenceau,5,7,12,2022,01-17,05:25
023 Les Arceaux,4,12,16,2022,01-17,05:25
024 Cit� Mion,3,5,8,2022,01-17,05:25
025 Nouveau Saint-Roch,4,4,8,2022,01-17,05:25
026 Renouvier,0,8,8,2022,01-17,05:25
027 Odysseum,3,5,8,2022,01-17,05:25
028 Saint-Denis,8,0,8,2022,01-17,05:25
029 Richter,8,8,16,2022,01-17,05:25
030 Charles Flahault,5,3,8,2022,01-17,05:25
031 Voltaire,2,6,8,2022,01-17,05:25
032 Pr�s d'Ar�nes,7,1,8,2022,01-17,05:25
033 Garcia Lorca,7,1,8,2022,01-17,05:25
034 Vert Bois,0,16,16,2022,01-17,05:25
035 Malbosc,0,8,8,2022,01-17,05:25
036 Occitanie,3,29,32,2022,01-17,05:25
037 FacdesSciences,10,14,24,2022,01-17,05:25
038 Fac de Lettres,7,9,16,2022,01-17,05:25
039 Aiguelongue,6,2,8,2022,01-17,05:25
040 Jeu de Mail des Abb�s,7,1,8,2022,01-17,05:25
041 Eurom�decine,1,7,8,2022,01-17,05:25
042 Marie Caizergues,2,6,8,2022,01-17,05:25
043 Sabines,1,7,8,2022,01-17,05:25
044 Celleneuve,4,4,8,2022,01-17,05:25
045 Jardin de la Lironde,4,4,8,2022,01-17,05:25
046 P�re Soulas,6,2,8,2022,01-17,05:25
047 Place Viala,3,5,8,2022,01-17,05:25
048 H�tel du D�partement,1,7,8,2022,01-17,05:25
049 Tonnelles,1,7,8,2022,01-17,05:25
050 Parvis Jules Ferry - Gare Saint-Roch,8,0,8,2022,01-17,05:25
051 Pont de Lattes - Gare Saint-Roch,0,12,12,2022,01-17,05:25
053 Deux Ponts - Gare Saint-Roch,3,5,8,2022,01-17,05:25
054 Providence - Ovalie,3,5,8,2022,01-17,05:25
055 P�rols Etang de l'Or,32,36,68,2022,01-17,05:25
056 Albert 1er - Cath�drale,7,5,12,2022,01-17,05:25
057 Saint-Guilhem - Courreau,3,5,8,2022,01-17,05:25
059 Sud De France,0,8,8,2022,01-17,05:25
001 Rue Jules Ferry - Gare Saint-Roch,4,8,12,2022,01-17,05:35
002 Com�die,5,19,24,2022,01-17,05:35
003 Esplanade,0,32,32,2022,01-17,05:35
004 H�tel de Ville,13,3,16,2022,01-17,05:35
005 Corum,3,9,12,2022,01-17,05:35
006 Place Albert 1er - St Charles,16,15,31,2022,01-17,05:35
007 Foch,3,5,8,2022,01-17,05:35
008 Halles Castellane,0,12,12,2022,01-17,05:35
009 Observatoire,4,4,8,2022,01-17,05:35
010 Rondelet,4,12,16,2022,01-17,05:35
011 Plan Cabanes,5,7,12,2022,01-17,05:35
012 Boutonnet,1,11,12,2022,01-17,05:35
013 Emile Combes,6,2,8,2022,01-17,05:35
014 Beaux-Arts,7,1,8,2022,01-17,05:35
015 Les Aubes,6,2,8,2022,01-17,05:35
016 Antigone centre,15,1,16,2022,01-17,05:35
017 M�diath�que Emile Zola,8,8,16,2022,01-17,05:35
018 Nombre d'Or,15,1,16,2022,01-17,05:35
019 Louis Blanc,8,8,16,2022,01-17,05:35
020 Gambetta,1,7,8,2022,01-17,05:35
021 Port Marianne,16,0,16,2022,01-17,05:35
022 Clemenceau,5,7,12,2022,01-17,05:35
023 Les Arceaux,4,12,16,2022,01-17,05:35
024 Cit� Mion,3,5,8,2022,01-17,05:35
025 Nouveau Saint-Roch,4,4,8,2022,01-17,05:35
026 Renouvier,0,8,8,2022,01-17,05:35
027 Odysseum,3,5,8,2022,01-17,05:35
028 Saint-Denis,8,0,8,2022,01-17,05:35
029 Richter,8,8,16,2022,01-17,05:35
030 Charles Flahault,5,3,8,2022,01-17,05:35
031 Voltaire,2,6,8,2022,01-17,05:35
032 Pr�s d'Ar�nes,7,1,8,2022,01-17,05:35
033 Garcia Lorca,7,1,8,2022,01-17,05:35
034 Vert Bois,0,16,16,2022,01-17,05:35
035 Malbosc,0,8,8,2022,01-17,05:35
036 Occitanie,3,29,32,2022,01-17,05:35
037 FacdesSciences,10,14,24,2022,01-17,05:35
038 Fac de Lettres,7,9,16,2022,01-17,05:35
039 Aiguelongue,6,2,8,2022,01-17,05:35
040 Jeu de Mail des Abb�s,7,1,8,2022,01-17,05:35
041 Eurom�decine,1,7,8,2022,01-17,05:35
042 Marie Caizergues,2,6,8,2022,01-17,05:35
043 Sabines,1,7,8,2022,01-17,05:35
044 Celleneuve,4,4,8,2022,01-17,05:35
045 Jardin de la Lironde,4,4,8,2022,01-17,05:35
046 P�re Soulas,6,2,8,2022,01-17,05:35
047 Place Viala,3,5,8,2022,01-17,05:35
048 H�tel du D�partement,1,7,8,2022,01-17,05:35
049 Tonnelles,1,7,8,2022,01-17,05:35
050 Parvis Jules Ferry - Gare Saint-Roch,8,0,8,2022,01-17,05:35
051 Pont de Lattes - Gare Saint-Roch,0,12,12,2022,01-17,05:35
053 Deux Ponts - Gare Saint-Roch,3,5,8,2022,01-17,05:35
054 Providence - Ovalie,3,5,8,2022,01-17,05:35
055 P�rols Etang de l'Or,32,36,68,2022,01-17,05:35
056 Albert 1er - Cath�drale,7,5,12,2022,01-17,05:35
057 Saint-Guilhem - Courreau,3,5,8,2022,01-17,05:35
059 Sud De France,0,8,8,2022,01-17,05:35
001 Rue Jules Ferry - Gare Saint-Roch,4,8,12,2022,01-17,05:45
002 Com�die,5,19,24,2022,01-17,05:45
003 Esplanade,0,32,32,2022,01-17,05:45
004 H�tel de Ville,13,3,16,2022,01-17,05:45
005 Corum,3,9,12,2022,01-17,05:45
006 Place Albert 1er - St Charles,16,15,31,2022,01-17,05:45
007 Foch,3,5,8,2022,01-17,05:45
008 Halles Castellane,0,12,12,2022,01-17,05:45
009 Observatoire,4,4,8,2022,01-17,05:45
010 Rondelet,4,12,16,2022,01-17,05:45
011 Plan Cabanes,5,7,12,2022,01-17,05:45
012 Boutonnet,1,11,12,2022,01-17,05:45
013 Emile Combes,6,2,8,2022,01-17,05:45
014 Beaux-Arts,7,1,8,2022,01-17,05:45
015 Les Aubes,6,2,8,2022,01-17,05:45
016 Antigone centre,15,1,16,2022,01-17,05:45
017 M�diath�que Emile Zola,8,8,16,2022,01-17,05:45
018 Nombre d'Or,15,1,16,2022,01-17,05:45
019 Louis Blanc,8,8,16,2022,01-17,05:45
020 Gambetta,1,7,8,2022,01-17,05:45
021 Port Marianne,16,0,16,2022,01-17,05:45
022 Clemenceau,5,7,12,2022,01-17,05:45
023 Les Arceaux,4,12,16,2022,01-17,05:45
024 Cit� Mion,3,5,8,2022,01-17,05:45
025 Nouveau Saint-Roch,4,4,8,2022,01-17,05:45
026 Renouvier,0,8,8,2022,01-17,05:45
027 Odysseum,3,5,8,2022,01-17,05:45
028 Saint-Denis,8,0,8,2022,01-17,05:45
029 Richter,8,8,16,2022,01-17,05:45
030 Charles Flahault,5,3,8,2022,01-17,05:45
031 Voltaire,2,6,8,2022,01-17,05:45
032 Pr�s d'Ar�nes,7,1,8,2022,01-17,05:45
033 Garcia Lorca,7,1,8,2022,01-17,05:45
034 Vert Bois,0,16,16,2022,01-17,05:45
035 Malbosc,0,8,8,2022,01-17,05:45
036 Occitanie,3,29,32,2022,01-17,05:45
037 FacdesSciences,9,15,24,2022,01-17,05:45
038 Fac de Lettres,7,9,16,2022,01-17,05:45
039 Aiguelongue,6,2,8,2022,01-17,05:45
040 Jeu de Mail des Abb�s,7,1,8,2022,01-17,05:45
041 Eurom�decine,1,7,8,2022,01-17,05:45
042 Marie Caizergues,2,6,8,2022,01-17,05:45
043 Sabines,1,7,8,2022,01-17,05:45
044 Celleneuve,4,4,8,2022,01-17,05:45
045 Jardin de la Lironde,4,4,8,2022,01-17,05:45
046 P�re Soulas,6,2,8,2022,01-17,05:45
047 Place Viala,3,5,8,2022,01-17,05:45
048 H�tel du D�partement,1,7,8,2022,01-17,05:45
049 Tonnelles,1,7,8,2022,01-17,05:45
050 Parvis Jules Ferry - Gare Saint-Roch,8,0,8,2022,01-17,05:45
051 Pont de Lattes - Gare Saint-Roch,0,12,12,2022,01-17,05:45
053 Deux Ponts - Gare Saint-Roch,3,5,8,2022,01-17,05:45
054 Providence - Ovalie,3,5,8,2022,01-17,05:45
055 P�rols Etang de l'Or,32,36,68,2022,01-17,05:45
056 Albert 1er - Cath�drale,7,5,12,2022,01-17,05:45
057 Saint-Guilhem - Courreau,3,5,8,2022,01-17,05:45
059 Sud De France,0,8,8,2022,01-17,05:45
001 Rue Jules Ferry - Gare Saint-Roch,4,8,12,2022,01-17,05:55
002 Com�die,5,19,24,2022,01-17,05:55
003 Esplanade,0,32,32,2022,01-17,05:55
004 H�tel de Ville,13,3,16,2022,01-17,05:55
005 Corum,3,9,12,2022,01-17,05:55
006 Place Albert 1er - St Charles,16,15,31,2022,01-17,05:55
007 Foch,3,5,8,2022,01-17,05:55
008 Halles Castellane,0,12,12,2022,01-17,05:55
009 Observatoire,4,4,8,2022,01-17,05:55
010 Rondelet,4,12,16,2022,01-17,05:55
011 Plan Cabanes,5,7,12,2022,01-17,05:55
012 Boutonnet,1,11,12,2022,01-17,05:55
013 Emile Combes,6,2,8,2022,01-17,05:55
014 Beaux-Arts,7,1,8,2022,01-17,05:55
015 Les Aubes,6,2,8,2022,01-17,05:55
016 Antigone centre,15,1,16,2022,01-17,05:55
017 M�diath�que Emile Zola,8,8,16,2022,01-17,05:55
018 Nombre d'Or,15,1,16,2022,01-17,05:55
019 Louis Blanc,8,8,16,2022,01-17,05:55
020 Gambetta,1,7,8,2022,01-17,05:55
021 Port Marianne,16,0,16,2022,01-17,05:55
022 Clemenceau,5,7,12,2022,01-17,05:55
023 Les Arceaux,4,12,16,2022,01-17,05:55
024 Cit� Mion,3,5,8,2022,01-17,05:55
025 Nouveau Saint-Roch,4,4,8,2022,01-17,05:55
026 Renouvier,0,8,8,2022,01-17,05:55
027 Odysseum,3,5,8,2022,01-17,05:55
028 Saint-Denis,8,0,8,2022,01-17,05:55
029 Richter,8,8,16,2022,01-17,05:55
030 Charles Flahault,5,3,8,2022,01-17,05:55
031 Voltaire,2,6,8,2022,01-17,05:55
032 Pr�s d'Ar�nes,7,1,8,2022,01-17,05:55
033 Garcia Lorca,7,1,8,2022,01-17,05:55
034 Vert Bois,0,16,16,2022,01-17,05:55
035 Malbosc,0,8,8,2022,01-17,05:55
036 Occitanie,3,29,32,2022,01-17,05:55
037 FacdesSciences,9,15,24,2022,01-17,05:55
038 Fac de Lettres,7,9,16,2022,01-17,05:55
039 Aiguelongue,5,3,8,2022,01-17,05:55
040 Jeu de Mail des Abb�s,7,1,8,2022,01-17,05:55
041 Eurom�decine,1,7,8,2022,01-17,05:55
042 Marie Caizergues,2,6,8,2022,01-17,05:55
043 Sabines,1,7,8,2022,01-17,05:55
044 Celleneuve,4,4,8,2022,01-17,05:55
045 Jardin de la Lironde,4,4,8,2022,01-17,05:55
046 P�re Soulas,6,2,8,2022,01-17,05:55
047 Place Viala,3,5,8,2022,01-17,05:55
048 H�tel du D�partement,1,7,8,2022,01-17,05:55
049 Tonnelles,1,7,8,2022,01-17,05:55
050 Parvis Jules Ferry - Gare Saint-Roch,8,0,8,2022,01-17,05:55
051 Pont de Lattes - Gare Saint-Roch,0,12,12,2022,01-17,05:55
053 Deux Ponts - Gare Saint-Roch,3,5,8,2022,01-17,05:55
054 Providence - Ovalie,3,5,8,2022,01-17,05:55
055 P�rols Etang de l'Or,32,36,68,2022,01-17,05:55
056 Albert 1er - Cath�drale,7,5,12,2022,01-17,05:55
057 Saint-Guilhem - Courreau,3,5,8,2022,01-17,05:55
059 Sud De France,0,8,8,2022,01-17,05:55
001 Rue Jules Ferry - Gare Saint-Roch,4,8,12,2022,01-17,06:06
002 Com�die,5,19,24,2022,01-17,06:06
003 Esplanade,0,32,32,2022,01-17,06:06
004 H�tel de Ville,13,3,16,2022,01-17,06:06
005 Corum,4,8,12,2022,01-17,06:06
006 Place Albert 1er - St Charles,16,15,31,2022,01-17,06:06
007 Foch,3,5,8,2022,01-17,06:06
008 Halles Castellane,0,12,12,2022,01-17,06:06
009 Observatoire,4,4,8,2022,01-17,06:06
010 Rondelet,4,12,16,2022,01-17,06:06
011 Plan Cabanes,5,7,12,2022,01-17,06:06
012 Boutonnet,1,11,12,2022,01-17,06:06
013 Emile Combes,6,2,8,2022,01-17,06:06
014 Beaux-Arts,7,1,8,2022,01-17,06:06
015 Les Aubes,6,2,8,2022,01-17,06:06
016 Antigone centre,15,1,16,2022,01-17,06:06
017 M�diath�que Emile Zola,8,8,16,2022,01-17,06:06
018 Nombre d'Or,15,1,16,2022,01-17,06:06
019 Louis Blanc,8,8,16,2022,01-17,06:06
020 Gambetta,1,7,8,2022,01-17,06:06
021 Port Marianne,16,0,16,2022,01-17,06:06
022 Clemenceau,5,7,12,2022,01-17,06:06
023 Les Arceaux,4,12,16,2022,01-17,06:06
024 Cit� Mion,3,5,8,2022,01-17,06:06
025 Nouveau Saint-Roch,4,4,8,2022,01-17,06:06
026 Renouvier,0,8,8,2022,01-17,06:06
027 Odysseum,3,5,8,2022,01-17,06:06
028 Saint-Denis,8,0,8,2022,01-17,06:06
029 Richter,8,8,16,2022,01-17,06:06
030 Charles Flahault,5,3,8,2022,01-17,06:06
031 Voltaire,2,6,8,2022,01-17,06:06
032 Pr�s d'Ar�nes,7,1,8,2022,01-17,06:06
033 Garcia Lorca,7,1,8,2022,01-17,06:06
034 Vert Bois,0,16,16,2022,01-17,06:06
035 Malbosc,0,8,8,2022,01-17,06:06
036 Occitanie,3,29,32,2022,01-17,06:06
037 FacdesSciences,10,14,24,2022,01-17,06:06
038 Fac de Lettres,7,9,16,2022,01-17,06:06
039 Aiguelongue,5,3,8,2022,01-17,06:06
040 Jeu de Mail des Abb�s,7,1,8,2022,01-17,06:06
041 Eurom�decine,1,7,8,2022,01-17,06:06
042 Marie Caizergues,2,6,8,2022,01-17,06:06
043 Sabines,1,7,8,2022,01-17,06:06
044 Celleneuve,4,4,8,2022,01-17,06:06
045 Jardin de la Lironde,4,4,8,2022,01-17,06:06
046 P�re Soulas,6,2,8,2022,01-17,06:06
047 Place Viala,3,5,8,2022,01-17,06:06
048 H�tel du D�partement,1,7,8,2022,01-17,06:06
049 Tonnelles,1,7,8,2022,01-17,06:06
050 Parvis Jules Ferry - Gare Saint-Roch,8,0,8,2022,01-17,06:06
051 Pont de Lattes - Gare Saint-Roch,0,12,12,2022,01-17,06:06
053 Deux Ponts - Gare Saint-Roch,3,5,8,2022,01-17,06:06
054 Providence - Ovalie,3,5,8,2022,01-17,06:06
055 P�rols Etang de l'Or,32,36,68,2022,01-17,06:06
056 Albert 1er - Cath�drale,7,5,12,2022,01-17,06:06
057 Saint-Guilhem - Courreau,3,5,8,2022,01-17,06:06
059 Sud De France,0,8,8,2022,01-17,06:06
001 Rue Jules Ferry - Gare Saint-Roch,4,8,12,2022,01-17,06:16
002 Com�die,5,19,24,2022,01-17,06:16
003 Esplanade,0,32,32,2022,01-17,06:16
004 H�tel de Ville,13,3,16,2022,01-17,06:16
005 Corum,3,9,12,2022,01-17,06:16
006 Place Albert 1er - St Charles,16,15,31,2022,01-17,06:16
007 Foch,3,5,8,2022,01-17,06:16
008 Halles Castellane,0,12,12,2022,01-17,06:16
009 Observatoire,4,4,8,2022,01-17,06:16
010 Rondelet,4,12,16,2022,01-17,06:16
011 Plan Cabanes,5,7,12,2022,01-17,06:16
012 Boutonnet,1,11,12,2022,01-17,06:16
013 Emile Combes,6,2,8,2022,01-17,06:16
014 Beaux-Arts,7,1,8,2022,01-17,06:16
015 Les Aubes,6,2,8,2022,01-17,06:16
016 Antigone centre,15,1,16,2022,01-17,06:16
017 M�diath�que Emile Zola,8,8,16,2022,01-17,06:16
018 Nombre d'Or,15,1,16,2022,01-17,06:16
019 Louis Blanc,8,8,16,2022,01-17,06:16
020 Gambetta,1,7,8,2022,01-17,06:16
021 Port Marianne,16,0,16,2022,01-17,06:16
022 Clemenceau,5,7,12,2022,01-17,06:16
023 Les Arceaux,4,12,16,2022,01-17,06:16
024 Cit� Mion,3,5,8,2022,01-17,06:16
025 Nouveau Saint-Roch,4,4,8,2022,01-17,06:16
026 Renouvier,0,8,8,2022,01-17,06:16
027 Odysseum,3,5,8,2022,01-17,06:16
028 Saint-Denis,8,0,8,2022,01-17,06:16
029 Richter,8,8,16,2022,01-17,06:16
030 Charles Flahault,5,3,8,2022,01-17,06:16
031 Voltaire,2,6,8,2022,01-17,06:16
032 Pr�s d'Ar�nes,7,1,8,2022,01-17,06:16
033 Garcia Lorca,7,1,8,2022,01-17,06:16
034 Vert Bois,0,16,16,2022,01-17,06:16
035 Malbosc,0,8,8,2022,01-17,06:16
036 Occitanie,3,29,32,2022,01-17,06:16
037 FacdesSciences,10,14,24,2022,01-17,06:16
038 Fac de Lettres,7,9,16,2022,01-17,06:16
039 Aiguelongue,5,3,8,2022,01-17,06:16
040 Jeu de Mail des Abb�s,7,1,8,2022,01-17,06:16
041 Eurom�decine,1,7,8,2022,01-17,06:16
042 Marie Caizergues,2,6,8,2022,01-17,06:16
043 Sabines,1,7,8,2022,01-17,06:16
044 Celleneuve,4,4,8,2022,01-17,06:16
045 Jardin de la Lironde,4,4,8,2022,01-17,06:16
046 P�re Soulas,6,2,8,2022,01-17,06:16
047 Place Viala,3,5,8,2022,01-17,06:16
048 H�tel du D�partement,1,7,8,2022,01-17,06:16
049 Tonnelles,1,7,8,2022,01-17,06:16
050 Parvis Jules Ferry - Gare Saint-Roch,8,0,8,2022,01-17,06:16
051 Pont de Lattes - Gare Saint-Roch,0,12,12,2022,01-17,06:16
053 Deux Ponts - Gare Saint-Roch,3,5,8,2022,01-17,06:16
054 Providence - Ovalie,3,5,8,2022,01-17,06:16
055 P�rols Etang de l'Or,32,36,68,2022,01-17,06:16
056 Albert 1er - Cath�drale,7,5,12,2022,01-17,06:16
057 Saint-Guilhem - Courreau,3,5,8,2022,01-17,06:16
059 Sud De France,0,8,8,2022,01-17,06:16
001 Rue Jules Ferry - Gare Saint-Roch,4,8,12,2022,01-17,06:26
002 Com�die,5,19,24,2022,01-17,06:26
003 Esplanade,0,32,32,2022,01-17,06:26
004 H�tel de Ville,13,3,16,2022,01-17,06:26
005 Corum,3,9,12,2022,01-17,06:26
006 Place Albert 1er - St Charles,16,15,31,2022,01-17,06:26
007 Foch,3,5,8,2022,01-17,06:26
008 Halles Castellane,0,12,12,2022,01-17,06:26
009 Observatoire,4,4,8,2022,01-17,06:26
010 Rondelet,4,12,16,2022,01-17,06:26
011 Plan Cabanes,5,7,12,2022,01-17,06:26
012 Boutonnet,1,11,12,2022,01-17,06:26
013 Emile Combes,6,2,8,2022,01-17,06:26
014 Beaux-Arts,7,1,8,2022,01-17,06:26
015 Les Aubes,6,2,8,2022,01-17,06:26
016 Antigone centre,14,2,16,2022,01-17,06:26
017 M�diath�que Emile Zola,8,8,16,2022,01-17,06:26
018 Nombre d'Or,15,1,16,2022,01-17,06:26
019 Louis Blanc,8,8,16,2022,01-17,06:26
020 Gambetta,1,7,8,2022,01-17,06:26
021 Port Marianne,12,4,16,2022,01-17,06:26
022 Clemenceau,5,7,12,2022,01-17,06:26
023 Les Arceaux,4,12,16,2022,01-17,06:26
024 Cit� Mion,3,5,8,2022,01-17,06:26
025 Nouveau Saint-Roch,4,4,8,2022,01-17,06:26
026 Renouvier,0,8,8,2022,01-17,06:26
027 Odysseum,3,5,8,2022,01-17,06:26
028 Saint-Denis,8,0,8,2022,01-17,06:26
029 Richter,8,8,16,2022,01-17,06:26
030 Charles Flahault,5,3,8,2022,01-17,06:26
031 Voltaire,2,6,8,2022,01-17,06:26
032 Pr�s d'Ar�nes,7,1,8,2022,01-17,06:26
033 Garcia Lorca,7,1,8,2022,01-17,06:26
034 Vert Bois,0,16,16,2022,01-17,06:26
035 Malbosc,0,8,8,2022,01-17,06:26
036 Occitanie,3,29,32,2022,01-17,06:26
037 FacdesSciences,10,14,24,2022,01-17,06:26
038 Fac de Lettres,7,9,16,2022,01-17,06:26
039 Aiguelongue,5,3,8,2022,01-17,06:26
040 Jeu de Mail des Abb�s,7,1,8,2022,01-17,06:26
041 Eurom�decine,1,7,8,2022,01-17,06:26
042 Marie Caizergues,2,6,8,2022,01-17,06:26
043 Sabines,1,7,8,2022,01-17,06:26
044 Celleneuve,4,4,8,2022,01-17,06:26
045 Jardin de la Lironde,4,4,8,2022,01-17,06:26
046 P�re Soulas,6,2,8,2022,01-17,06:26
047 Place Viala,3,5,8,2022,01-17,06:26
048 H�tel du D�partement,1,7,8,2022,01-17,06:26
049 Tonnelles,1,7,8,2022,01-17,06:26
050 Parvis Jules Ferry - Gare Saint-Roch,8,0,8,2022,01-17,06:26
051 Pont de Lattes - Gare Saint-Roch,0,12,12,2022,01-17,06:26
053 Deux Ponts - Gare Saint-Roch,3,5,8,2022,01-17,06:26
054 Providence - Ovalie,3,5,8,2022,01-17,06:26
055 P�rols Etang de l'Or,32,36,68,2022,01-17,06:26
056 Albert 1er - Cath�drale,7,5,12,2022,01-17,06:26
057 Saint-Guilhem - Courreau,3,5,8,2022,01-17,06:26
059 Sud De France,0,8,8,2022,01-17,06:26
001 Rue Jules Ferry - Gare Saint-Roch,4,8,12,2022,01-17,06:36
002 Com�die,5,19,24,2022,01-17,06:36
003 Esplanade,0,32,32,2022,01-17,06:36
004 H�tel de Ville,13,3,16,2022,01-17,06:36
005 Corum,3,9,12,2022,01-17,06:36
006 Place Albert 1er - St Charles,16,15,31,2022,01-17,06:36
007 Foch,3,5,8,2022,01-17,06:36
008 Halles Castellane,0,12,12,2022,01-17,06:36
009 Observatoire,4,4,8,2022,01-17,06:36
010 Rondelet,5,11,16,2022,01-17,06:36
011 Plan Cabanes,5,7,12,2022,01-17,06:36
012 Boutonnet,1,11,12,2022,01-17,06:36
013 Emile Combes,6,2,8,2022,01-17,06:36
014 Beaux-Arts,7,1,8,2022,01-17,06:36
015 Les Aubes,6,2,8,2022,01-17,06:36
016 Antigone centre,14,2,16,2022,01-17,06:36
017 M�diath�que Emile Zola,8,8,16,2022,01-17,06:36
018 Nombre d'Or,15,1,16,2022,01-17,06:36
019 Louis Blanc,8,8,16,2022,01-17,06:36
020 Gambetta,1,7,8,2022,01-17,06:36
021 Port Marianne,4,12,16,2022,01-17,06:36
022 Clemenceau,5,7,12,2022,01-17,06:36
023 Les Arceaux,4,12,16,2022,01-17,06:36
024 Cit� Mion,3,5,8,2022,01-17,06:36
025 Nouveau Saint-Roch,4,4,8,2022,01-17,06:36
026 Renouvier,0,8,8,2022,01-17,06:36
027 Odysseum,3,5,8,2022,01-17,06:36
028 Saint-Denis,8,0,8,2022,01-17,06:36
029 Richter,8,8,16,2022,01-17,06:36
030 Charles Flahault,5,3,8,2022,01-17,06:36
031 Voltaire,2,6,8,2022,01-17,06:36
032 Pr�s d'Ar�nes,7,1,8,2022,01-17,06:36
033 Garcia Lorca,7,1,8,2022,01-17,06:36
034 Vert Bois,0,16,16,2022,01-17,06:36
035 Malbosc,0,8,8,2022,01-17,06:36
036 Occitanie,4,28,32,2022,01-17,06:36
037 FacdesSciences,10,14,24,2022,01-17,06:36
038 Fac de Lettres,7,9,16,2022,01-17,06:36
039 Aiguelongue,5,3,8,2022,01-17,06:36
040 Jeu de Mail des Abb�s,7,1,8,2022,01-17,06:36
041 Eurom�decine,1,7,8,2022,01-17,06:36
042 Marie Caizergues,2,6,8,2022,01-17,06:36
043 Sabines,1,7,8,2022,01-17,06:36
044 Celleneuve,4,4,8,2022,01-17,06:36
045 Jardin de la Lironde,4,4,8,2022,01-17,06:36
046 P�re Soulas,6,2,8,2022,01-17,06:36
047 Place Viala,3,5,8,2022,01-17,06:36
048 H�tel du D�partement,1,7,8,2022,01-17,06:36
049 Tonnelles,1,7,8,2022,01-17,06:36
050 Parvis Jules Ferry - Gare Saint-Roch,8,0,8,2022,01-17,06:36
051 Pont de Lattes - Gare Saint-Roch,0,12,12,2022,01-17,06:36
053 Deux Ponts - Gare Saint-Roch,3,5,8,2022,01-17,06:36
054 Providence - Ovalie,3,5,8,2022,01-17,06:36
055 P�rols Etang de l'Or,32,36,68,2022,01-17,06:36
056 Albert 1er - Cath�drale,7,5,12,2022,01-17,06:36
057 Saint-Guilhem - Courreau,3,5,8,2022,01-17,06:36
059 Sud De France,0,8,8,2022,01-17,06:36
001 Rue Jules Ferry - Gare Saint-Roch,4,8,12,2022,01-17,06:46
002 Com�die,5,19,24,2022,01-17,06:46
003 Esplanade,0,32,32,2022,01-17,06:46
004 H�tel de Ville,13,3,16,2022,01-17,06:46
005 Corum,3,9,12,2022,01-17,06:46
006 Place Albert 1er - St Charles,16,15,31,2022,01-17,06:46
007 Foch,3,5,8,2022,01-17,06:46
008 Halles Castellane,0,12,12,2022,01-17,06:46
009 Observatoire,4,4,8,2022,01-17,06:46
010 Rondelet,5,11,16,2022,01-17,06:46
011 Plan Cabanes,5,7,12,2022,01-17,06:46
012 Boutonnet,1,11,12,2022,01-17,06:46
013 Emile Combes,6,2,8,2022,01-17,06:46
014 Beaux-Arts,7,1,8,2022,01-17,06:46
015 Les Aubes,6,2,8,2022,01-17,06:46
016 Antigone centre,14,2,16,2022,01-17,06:46
017 M�diath�que Emile Zola,8,8,16,2022,01-17,06:46
018 Nombre d'Or,15,1,16,2022,01-17,06:46
019 Louis Blanc,8,8,16,2022,01-17,06:46
020 Gambetta,1,7,8,2022,01-17,06:46
021 Port Marianne,4,12,16,2022,01-17,06:46
022 Clemenceau,5,7,12,2022,01-17,06:46
023 Les Arceaux,4,12,16,2022,01-17,06:46
024 Cit� Mion,3,5,8,2022,01-17,06:46
025 Nouveau Saint-Roch,4,4,8,2022,01-17,06:46
026 Renouvier,0,8,8,2022,01-17,06:46
027 Odysseum,3,5,8,2022,01-17,06:46
028 Saint-Denis,8,0,8,2022,01-17,06:46
029 Richter,8,8,16,2022,01-17,06:46
030 Charles Flahault,5,3,8,2022,01-17,06:46
031 Voltaire,2,6,8,2022,01-17,06:46
032 Pr�s d'Ar�nes,7,1,8,2022,01-17,06:46
033 Garcia Lorca,7,1,8,2022,01-17,06:46
034 Vert Bois,0,16,16,2022,01-17,06:46
035 Malbosc,0,8,8,2022,01-17,06:46
036 Occitanie,4,28,32,2022,01-17,06:46
037 FacdesSciences,10,14,24,2022,01-17,06:46
038 Fac de Lettres,7,9,16,2022,01-17,06:46
039 Aiguelongue,5,3,8,2022,01-17,06:46
040 Jeu de Mail des Abb�s,7,1,8,2022,01-17,06:46
041 Eurom�decine,1,7,8,2022,01-17,06:46
042 Marie Caizergues,2,6,8,2022,01-17,06:46
043 Sabines,1,7,8,2022,01-17,06:46
044 Celleneuve,4,4,8,2022,01-17,06:46
045 Jardin de la Lironde,4,4,8,2022,01-17,06:46
046 P�re Soulas,6,2,8,2022,01-17,06:46
047 Place Viala,3,5,8,2022,01-17,06:46
048 H�tel du D�partement,1,7,8,2022,01-17,06:46
049 Tonnelles,1,7,8,2022,01-17,06:46
050 Parvis Jules Ferry - Gare Saint-Roch,4,4,8,2022,01-17,06:46
051 Pont de Lattes - Gare Saint-Roch,0,12,12,2022,01-17,06:46
053 Deux Ponts - Gare Saint-Roch,3,5,8,2022,01-17,06:46
054 Providence - Ovalie,3,5,8,2022,01-17,06:46
055 P�rols Etang de l'Or,32,36,68,2022,01-17,06:46
056 Albert 1er - Cath�drale,7,5,12,2022,01-17,06:46
057 Saint-Guilhem - Courreau,3,5,8,2022,01-17,06:46
059 Sud De France,0,8,8,2022,01-17,06:46
001 Rue Jules Ferry - Gare Saint-Roch,4,8,12,2022,01-17,06:56
002 Com�die,5,19,24,2022,01-17,06:56
003 Esplanade,16,16,32,2022,01-17,06:56
004 H�tel de Ville,13,3,16,2022,01-17,06:56
005 Corum,3,9,12,2022,01-17,06:56
006 Place Albert 1er - St Charles,16,15,31,2022,01-17,06:56
007 Foch,3,5,8,2022,01-17,06:56
008 Halles Castellane,0,12,12,2022,01-17,06:56
009 Observatoire,4,4,8,2022,01-17,06:56
010 Rondelet,5,11,16,2022,01-17,06:56
011 Plan Cabanes,5,7,12,2022,01-17,06:56
012 Boutonnet,1,11,12,2022,01-17,06:56
013 Emile Combes,6,2,8,2022,01-17,06:56
014 Beaux-Arts,7,1,8,2022,01-17,06:56
015 Les Aubes,6,2,8,2022,01-17,06:56
016 Antigone centre,14,2,16,2022,01-17,06:56
017 M�diath�que Emile Zola,8,8,16,2022,01-17,06:56
018 Nombre d'Or,15,1,16,2022,01-17,06:56
019 Louis Blanc,8,8,16,2022,01-17,06:56
020 Gambetta,1,7,8,2022,01-17,06:56
021 Port Marianne,4,12,16,2022,01-17,06:56
022 Clemenceau,5,7,12,2022,01-17,06:56
023 Les Arceaux,4,12,16,2022,01-17,06:56
024 Cit� Mion,3,5,8,2022,01-17,06:56
025 Nouveau Saint-Roch,4,4,8,2022,01-17,06:56
026 Renouvier,0,8,8,2022,01-17,06:56
027 Odysseum,3,5,8,2022,01-17,06:56
028 Saint-Denis,8,0,8,2022,01-17,06:56
029 Richter,8,8,16,2022,01-17,06:56
030 Charles Flahault,5,3,8,2022,01-17,06:56
031 Voltaire,2,6,8,2022,01-17,06:56
032 Pr�s d'Ar�nes,7,1,8,2022,01-17,06:56
033 Garcia Lorca,7,1,8,2022,01-17,06:56
034 Vert Bois,0,16,16,2022,01-17,06:56
035 Malbosc,0,8,8,2022,01-17,06:56
036 Occitanie,4,28,32,2022,01-17,06:56
037 FacdesSciences,10,14,24,2022,01-17,06:56
038 Fac de Lettres,7,9,16,2022,01-17,06:56
039 Aiguelongue,5,3,8,2022,01-17,06:56
040 Jeu de Mail des Abb�s,7,1,8,2022,01-17,06:56
041 Eurom�decine,1,7,8,2022,01-17,06:56
042 Marie Caizergues,2,6,8,2022,01-17,06:56
043 Sabines,1,7,8,2022,01-17,06:56
044 Celleneuve,4,4,8,2022,01-17,06:56
045 Jardin de la Lironde,4,4,8,2022,01-17,06:56
046 P�re Soulas,6,2,8,2022,01-17,06:56
047 Place Viala,3,5,8,2022,01-17,06:56
048 H�tel du D�partement,1,7,8,2022,01-17,06:56
049 Tonnelles,1,7,8,2022,01-17,06:56
050 Parvis Jules Ferry - Gare Saint-Roch,4,4,8,2022,01-17,06:56
051 Pont de Lattes - Gare Saint-Roch,0,12,12,2022,01-17,06:56
053 Deux Ponts - Gare Saint-Roch,3,5,8,2022,01-17,06:56
054 Providence - Ovalie,3,5,8,2022,01-17,06:56
055 P�rols Etang de l'Or,32,36,68,2022,01-17,06:56
056 Albert 1er - Cath�drale,7,5,12,2022,01-17,06:56
057 Saint-Guilhem - Courreau,3,5,8,2022,01-17,06:56
059 Sud De France,0,8,8,2022,01-17,06:56
001 Rue Jules Ferry - Gare Saint-Roch,4,8,12,2022,01-17,07:07
002 Com�die,5,19,24,2022,01-17,07:07
003 Esplanade,16,16,32,2022,01-17,07:07
004 H�tel de Ville,13,3,16,2022,01-17,07:07
005 Corum,3,9,12,2022,01-17,07:07
006 Place Albert 1er - St Charles,16,15,31,2022,01-17,07:07
007 Foch,3,5,8,2022,01-17,07:07
008 Halles Castellane,0,12,12,2022,01-17,07:07
009 Observatoire,4,4,8,2022,01-17,07:07
010 Rondelet,5,11,16,2022,01-17,07:07
011 Plan Cabanes,5,7,12,2022,01-17,07:07
012 Boutonnet,1,11,12,2022,01-17,07:07
013 Emile Combes,6,2,8,2022,01-17,07:07
014 Beaux-Arts,7,1,8,2022,01-17,07:07
015 Les Aubes,6,2,8,2022,01-17,07:07
016 Antigone centre,14,2,16,2022,01-17,07:07
017 M�diath�que Emile Zola,8,8,16,2022,01-17,07:07
018 Nombre d'Or,15,1,16,2022,01-17,07:07
019 Louis Blanc,8,8,16,2022,01-17,07:07
020 Gambetta,1,7,8,2022,01-17,07:07
021 Port Marianne,4,12,16,2022,01-17,07:07
022 Clemenceau,5,7,12,2022,01-17,07:07
023 Les Arceaux,4,12,16,2022,01-17,07:07
024 Cit� Mion,3,5,8,2022,01-17,07:07
025 Nouveau Saint-Roch,4,4,8,2022,01-17,07:07
026 Renouvier,0,8,8,2022,01-17,07:07
027 Odysseum,3,5,8,2022,01-17,07:07
028 Saint-Denis,8,0,8,2022,01-17,07:07
029 Richter,8,8,16,2022,01-17,07:07
030 Charles Flahault,5,3,8,2022,01-17,07:07
031 Voltaire,2,6,8,2022,01-17,07:07
032 Pr�s d'Ar�nes,7,1,8,2022,01-17,07:07
033 Garcia Lorca,7,1,8,2022,01-17,07:07
034 Vert Bois,0,16,16,2022,01-17,07:07
035 Malbosc,0,8,8,2022,01-17,07:07
036 Occitanie,4,28,32,2022,01-17,07:07
037 FacdesSciences,10,14,24,2022,01-17,07:07
038 Fac de Lettres,7,9,16,2022,01-17,07:07
039 Aiguelongue,5,3,8,2022,01-17,07:07
040 Jeu de Mail des Abb�s,7,1,8,2022,01-17,07:07
041 Eurom�decine,1,7,8,2022,01-17,07:07
042 Marie Caizergues,2,6,8,2022,01-17,07:07
043 Sabines,1,7,8,2022,01-17,07:07
044 Celleneuve,4,4,8,2022,01-17,07:07
045 Jardin de la Lironde,4,4,8,2022,01-17,07:07
046 P�re Soulas,6,2,8,2022,01-17,07:07
047 Place Viala,3,5,8,2022,01-17,07:07
048 H�tel du D�partement,1,7,8,2022,01-17,07:07
049 Tonnelles,1,7,8,2022,01-17,07:07
050 Parvis Jules Ferry - Gare Saint-Roch,4,4,8,2022,01-17,07:07
051 Pont de Lattes - Gare Saint-Roch,0,12,12,2022,01-17,07:07
053 Deux Ponts - Gare Saint-Roch,3,5,8,2022,01-17,07:07
054 Providence - Ovalie,3,5,8,2022,01-17,07:07
055 P�rols Etang de l'Or,32,36,68,2022,01-17,07:07
056 Albert 1er - Cath�drale,7,5,12,2022,01-17,07:07
057 Saint-Guilhem - Courreau,3,5,8,2022,01-17,07:07
059 Sud De France,0,8,8,2022,01-17,07:07
001 Rue Jules Ferry - Gare Saint-Roch,4,8,12,2022,01-17,07:17
002 Com�die,5,19,24,2022,01-17,07:17
003 Esplanade,16,16,32,2022,01-17,07:17
004 H�tel de Ville,13,3,16,2022,01-17,07:17
005 Corum,3,9,12,2022,01-17,07:17
006 Place Albert 1er - St Charles,16,15,31,2022,01-17,07:17
007 Foch,3,5,8,2022,01-17,07:17
008 Halles Castellane,0,12,12,2022,01-17,07:17
009 Observatoire,4,4,8,2022,01-17,07:17
010 Rondelet,5,11,16,2022,01-17,07:17
011 Plan Cabanes,5,7,12,2022,01-17,07:17
012 Boutonnet,1,11,12,2022,01-17,07:17
013 Emile Combes,6,2,8,2022,01-17,07:17
014 Beaux-Arts,7,1,8,2022,01-17,07:17
015 Les Aubes,6,2,8,2022,01-17,07:17
016 Antigone centre,14,2,16,2022,01-17,07:17
017 M�diath�que Emile Zola,8,8,16,2022,01-17,07:17
018 Nombre d'Or,10,6,16,2022,01-17,07:17
019 Louis Blanc,8,8,16,2022,01-17,07:17
020 Gambetta,1,7,8,2022,01-17,07:17
021 Port Marianne,4,12,16,2022,01-17,07:17
022 Clemenceau,5,7,12,2022,01-17,07:17
023 Les Arceaux,4,12,16,2022,01-17,07:17
024 Cit� Mion,3,5,8,2022,01-17,07:17
025 Nouveau Saint-Roch,4,4,8,2022,01-17,07:17
026 Renouvier,0,8,8,2022,01-17,07:17
027 Odysseum,3,5,8,2022,01-17,07:17
028 Saint-Denis,8,0,8,2022,01-17,07:17
029 Richter,8,8,16,2022,01-17,07:17
030 Charles Flahault,5,3,8,2022,01-17,07:17
031 Voltaire,2,6,8,2022,01-17,07:17
032 Pr�s d'Ar�nes,7,1,8,2022,01-17,07:17
033 Garcia Lorca,7,1,8,2022,01-17,07:17
034 Vert Bois,0,16,16,2022,01-17,07:17
035 Malbosc,0,8,8,2022,01-17,07:17
036 Occitanie,3,29,32,2022,01-17,07:17
037 FacdesSciences,10,14,24,2022,01-17,07:17
038 Fac de Lettres,7,9,16,2022,01-17,07:17
039 Aiguelongue,5,3,8,2022,01-17,07:17
040 Jeu de Mail des Abb�s,7,1,8,2022,01-17,07:17
041 Eurom�decine,1,7,8,2022,01-17,07:17
042 Marie Caizergues,2,6,8,2022,01-17,07:17
043 Sabines,1,7,8,2022,01-17,07:17
044 Celleneuve,4,4,8,2022,01-17,07:17
045 Jardin de la Lironde,4,4,8,2022,01-17,07:17
046 P�re Soulas,6,2,8,2022,01-17,07:17
047 Place Viala,3,5,8,2022,01-17,07:17
048 H�tel du D�partement,1,7,8,2022,01-17,07:17
049 Tonnelles,1,7,8,2022,01-17,07:17
050 Parvis Jules Ferry - Gare Saint-Roch,4,4,8,2022,01-17,07:17
051 Pont de Lattes - Gare Saint-Roch,0,12,12,2022,01-17,07:17
053 Deux Ponts - Gare Saint-Roch,3,5,8,2022,01-17,07:17
054 Providence - Ovalie,3,5,8,2022,01-17,07:17
055 P�rols Etang de l'Or,32,36,68,2022,01-17,07:17
056 Albert 1er - Cath�drale,7,5,12,2022,01-17,07:17
057 Saint-Guilhem - Courreau,3,5,8,2022,01-17,07:17
059 Sud De France,0,8,8,2022,01-17,07:17
001 Rue Jules Ferry - Gare Saint-Roch,4,8,12,2022,01-17,07:27
002 Com�die,5,19,24,2022,01-17,07:27
003 Esplanade,16,16,32,2022,01-17,07:27
004 H�tel de Ville,13,3,16,2022,01-17,07:27
005 Corum,3,9,12,2022,01-17,07:27
006 Place Albert 1er - St Charles,16,15,31,2022,01-17,07:27
007 Foch,3,5,8,2022,01-17,07:27
008 Halles Castellane,0,12,12,2022,01-17,07:27
009 Observatoire,4,4,8,2022,01-17,07:27
010 Rondelet,5,11,16,2022,01-17,07:27
011 Plan Cabanes,5,7,12,2022,01-17,07:27
012 Boutonnet,1,11,12,2022,01-17,07:27
013 Emile Combes,6,2,8,2022,01-17,07:27
014 Beaux-Arts,7,1,8,2022,01-17,07:27
015 Les Aubes,6,2,8,2022,01-17,07:27
016 Antigone centre,14,2,16,2022,01-17,07:27
017 M�diath�que Emile Zola,8,8,16,2022,01-17,07:27
018 Nombre d'Or,4,12,16,2022,01-17,07:27
019 Louis Blanc,8,8,16,2022,01-17,07:27
020 Gambetta,1,7,8,2022,01-17,07:27
021 Port Marianne,4,12,16,2022,01-17,07:27
022 Clemenceau,5,7,12,2022,01-17,07:27
023 Les Arceaux,4,12,16,2022,01-17,07:27
024 Cit� Mion,3,5,8,2022,01-17,07:27
025 Nouveau Saint-Roch,4,4,8,2022,01-17,07:27
026 Renouvier,0,8,8,2022,01-17,07:27
027 Odysseum,3,5,8,2022,01-17,07:27
028 Saint-Denis,8,0,8,2022,01-17,07:27
029 Richter,8,8,16,2022,01-17,07:27
030 Charles Flahault,5,3,8,2022,01-17,07:27
031 Voltaire,2,6,8,2022,01-17,07:27
032 Pr�s d'Ar�nes,7,1,8,2022,01-17,07:27
033 Garcia Lorca,7,1,8,2022,01-17,07:27
034 Vert Bois,0,16,16,2022,01-17,07:27
035 Malbosc,0,8,8,2022,01-17,07:27
036 Occitanie,2,30,32,2022,01-17,07:27
037 FacdesSciences,10,14,24,2022,01-17,07:27
038 Fac de Lettres,7,9,16,2022,01-17,07:27
039 Aiguelongue,5,3,8,2022,01-17,07:27
040 Jeu de Mail des Abb�s,7,1,8,2022,01-17,07:27
041 Eurom�decine,1,7,8,2022,01-17,07:27
042 Marie Caizergues,2,6,8,2022,01-17,07:27
043 Sabines,1,7,8,2022,01-17,07:27
044 Celleneuve,4,4,8,2022,01-17,07:27
045 Jardin de la Lironde,4,4,8,2022,01-17,07:27
046 P�re Soulas,6,2,8,2022,01-17,07:27
047 Place Viala,3,5,8,2022,01-17,07:27
048 H�tel du D�partement,1,7,8,2022,01-17,07:27
049 Tonnelles,1,7,8,2022,01-17,07:27
050 Parvis Jules Ferry - Gare Saint-Roch,4,4,8,2022,01-17,07:27
051 Pont de Lattes - Gare Saint-Roch,0,12,12,2022,01-17,07:27
053 Deux Ponts - Gare Saint-Roch,3,5,8,2022,01-17,07:27
054 Providence - Ovalie,3,5,8,2022,01-17,07:27
055 P�rols Etang de l'Or,32,36,68,2022,01-17,07:27
056 Albert 1er - Cath�drale,7,5,12,2022,01-17,07:27
057 Saint-Guilhem - Courreau,3,5,8,2022,01-17,07:27
059 Sud De France,0,8,8,2022,01-17,07:27
001 Rue Jules Ferry - Gare Saint-Roch,4,8,12,2022,01-17,07:37
002 Com�die,5,19,24,2022,01-17,07:37
003 Esplanade,16,16,32,2022,01-17,07:37
004 H�tel de Ville,13,3,16,2022,01-17,07:37
005 Corum,3,9,12,2022,01-17,07:37
006 Place Albert 1er - St Charles,16,15,31,2022,01-17,07:37
007 Foch,3,5,8,2022,01-17,07:37
008 Halles Castellane,0,12,12,2022,01-17,07:37
009 Observatoire,4,4,8,2022,01-17,07:37
010 Rondelet,5,11,16,2022,01-17,07:37
011 Plan Cabanes,5,7,12,2022,01-17,07:37
012 Boutonnet,1,11,12,2022,01-17,07:37
013 Emile Combes,6,2,8,2022,01-17,07:37
014 Beaux-Arts,7,1,8,2022,01-17,07:37
015 Les Aubes,6,2,8,2022,01-17,07:37
016 Antigone centre,14,2,16,2022,01-17,07:37
017 M�diath�que Emile Zola,8,8,16,2022,01-17,07:37
018 Nombre d'Or,4,12,16,2022,01-17,07:37
019 Louis Blanc,8,8,16,2022,01-17,07:37
020 Gambetta,1,7,8,2022,01-17,07:37
021 Port Marianne,4,12,16,2022,01-17,07:37
022 Clemenceau,5,7,12,2022,01-17,07:37
023 Les Arceaux,4,12,16,2022,01-17,07:37
024 Cit� Mion,3,5,8,2022,01-17,07:37
025 Nouveau Saint-Roch,4,4,8,2022,01-17,07:37
026 Renouvier,0,8,8,2022,01-17,07:37
027 Odysseum,3,5,8,2022,01-17,07:37
028 Saint-Denis,6,2,8,2022,01-17,07:37
029 Richter,8,8,16,2022,01-17,07:37
030 Charles Flahault,5,3,8,2022,01-17,07:37
031 Voltaire,2,6,8,2022,01-17,07:37
032 Pr�s d'Ar�nes,7,1,8,2022,01-17,07:37
033 Garcia Lorca,7,1,8,2022,01-17,07:37
034 Vert Bois,0,16,16,2022,01-17,07:37
035 Malbosc,0,8,8,2022,01-17,07:37
036 Occitanie,2,30,32,2022,01-17,07:37
037 FacdesSciences,10,14,24,2022,01-17,07:37
038 Fac de Lettres,7,9,16,2022,01-17,07:37
039 Aiguelongue,5,3,8,2022,01-17,07:37
040 Jeu de Mail des Abb�s,7,1,8,2022,01-17,07:37
041 Eurom�decine,1,7,8,2022,01-17,07:37
042 Marie Caizergues,2,6,8,2022,01-17,07:37
043 Sabines,1,7,8,2022,01-17,07:37
044 Celleneuve,4,4,8,2022,01-17,07:37
045 Jardin de la Lironde,4,4,8,2022,01-17,07:37
046 P�re Soulas,6,2,8,2022,01-17,07:37
047 Place Viala,3,5,8,2022,01-17,07:37
048 H�tel du D�partement,1,7,8,2022,01-17,07:37
049 Tonnelles,1,7,8,2022,01-17,07:37
050 Parvis Jules Ferry - Gare Saint-Roch,4,4,8,2022,01-17,07:37
051 Pont de Lattes - Gare Saint-Roch,0,12,12,2022,01-17,07:37
053 Deux Ponts - Gare Saint-Roch,3,5,8,2022,01-17,07:37
054 Providence - Ovalie,3,5,8,2022,01-17,07:37
055 P�rols Etang de l'Or,32,36,68,2022,01-17,07:37
056 Albert 1er - Cath�drale,7,5,12,2022,01-17,07:37
057 Saint-Guilhem - Courreau,3,5,8,2022,01-17,07:37
059 Sud De France,0,8,8,2022,01-17,07:37
001 Rue Jules Ferry - Gare Saint-Roch,4,8,12,2022,01-17,07:47
002 Com�die,7,17,24,2022,01-17,07:47
003 Esplanade,16,16,32,2022,01-17,07:47
004 H�tel de Ville,13,3,16,2022,01-17,07:47
005 Corum,3,9,12,2022,01-17,07:47
006 Place Albert 1er - St Charles,16,15,31,2022,01-17,07:47
007 Foch,3,5,8,2022,01-17,07:47
008 Halles Castellane,0,12,12,2022,01-17,07:47
009 Observatoire,4,4,8,2022,01-17,07:47
010 Rondelet,5,11,16,2022,01-17,07:47
011 Plan Cabanes,5,7,12,2022,01-17,07:47
012 Boutonnet,1,11,12,2022,01-17,07:47
013 Emile Combes,6,2,8,2022,01-17,07:47
014 Beaux-Arts,7,1,8,2022,01-17,07:47
015 Les Aubes,6,2,8,2022,01-17,07:47
016 Antigone centre,14,2,16,2022,01-17,07:47
017 M�diath�que Emile Zola,8,8,16,2022,01-17,07:47
018 Nombre d'Or,4,12,16,2022,01-17,07:47
019 Louis Blanc,8,8,16,2022,01-17,07:47
020 Gambetta,0,8,8,2022,01-17,07:47
021 Port Marianne,4,12,16,2022,01-17,07:47
022 Clemenceau,4,8,12,2022,01-17,07:47
023 Les Arceaux,4,12,16,2022,01-17,07:47
024 Cit� Mion,3,5,8,2022,01-17,07:47
025 Nouveau Saint-Roch,3,5,8,2022,01-17,07:47
026 Renouvier,0,8,8,2022,01-17,07:47
027 Odysseum,3,5,8,2022,01-17,07:47
028 Saint-Denis,4,4,8,2022,01-17,07:47
029 Richter,8,8,16,2022,01-17,07:47
030 Charles Flahault,5,3,8,2022,01-17,07:47
031 Voltaire,2,6,8,2022,01-17,07:47
032 Pr�s d'Ar�nes,7,1,8,2022,01-17,07:47
033 Garcia Lorca,7,1,8,2022,01-17,07:47
034 Vert Bois,0,16,16,2022,01-17,07:47
035 Malbosc,0,8,8,2022,01-17,07:47
036 Occitanie,2,30,32,2022,01-17,07:47
037 FacdesSciences,8,16,24,2022,01-17,07:47
038 Fac de Lettres,7,9,16,2022,01-17,07:47
039 Aiguelongue,5,3,8,2022,01-17,07:47
040 Jeu de Mail des Abb�s,7,1,8,2022,01-17,07:47
041 Eurom�decine,1,7,8,2022,01-17,07:47
042 Marie Caizergues,2,6,8,2022,01-17,07:47
043 Sabines,1,7,8,2022,01-17,07:47
044 Celleneuve,4,4,8,2022,01-17,07:47
045 Jardin de la Lironde,4,4,8,2022,01-17,07:47
046 P�re Soulas,6,2,8,2022,01-17,07:47
047 Place Viala,3,5,8,2022,01-17,07:47
048 H�tel du D�partement,1,7,8,2022,01-17,07:47
049 Tonnelles,1,7,8,2022,01-17,07:47
050 Parvis Jules Ferry - Gare Saint-Roch,4,4,8,2022,01-17,07:47
051 Pont de Lattes - Gare Saint-Roch,0,12,12,2022,01-17,07:47
053 Deux Ponts - Gare Saint-Roch,3,5,8,2022,01-17,07:47
054 Providence - Ovalie,3,5,8,2022,01-17,07:47
055 P�rols Etang de l'Or,32,36,68,2022,01-17,07:47
056 Albert 1er - Cath�drale,7,5,12,2022,01-17,07:47
057 Saint-Guilhem - Courreau,3,5,8,2022,01-17,07:47
059 Sud De France,0,8,8,2022,01-17,07:47
001 Rue Jules Ferry - Gare Saint-Roch,5,7,12,2022,01-17,07:57
002 Com�die,13,11,24,2022,01-17,07:57
003 Esplanade,16,16,32,2022,01-17,07:57
004 H�tel de Ville,12,4,16,2022,01-17,07:57
005 Corum,3,9,12,2022,01-17,07:57
006 Place Albert 1er - St Charles,17,14,31,2022,01-17,07:57
007 Foch,2,6,8,2022,01-17,07:57
008 Halles Castellane,0,12,12,2022,01-17,07:57
009 Observatoire,4,4,8,2022,01-17,07:57
010 Rondelet,5,11,16,2022,01-17,07:57
011 Plan Cabanes,5,7,12,2022,01-17,07:57
012 Boutonnet,1,11,12,2022,01-17,07:57
013 Emile Combes,6,2,8,2022,01-17,07:57
014 Beaux-Arts,7,1,8,2022,01-17,07:57
015 Les Aubes,6,2,8,2022,01-17,07:57
016 Antigone centre,12,4,16,2022,01-17,07:57
017 M�diath�que Emile Zola,8,8,16,2022,01-17,07:57
018 Nombre d'Or,4,12,16,2022,01-17,07:57
019 Louis Blanc,8,8,16,2022,01-17,07:57
020 Gambetta,0,8,8,2022,01-17,07:57
021 Port Marianne,4,12,16,2022,01-17,07:57
022 Clemenceau,4,8,12,2022,01-17,07:57
023 Les Arceaux,4,12,16,2022,01-17,07:57
024 Cit� Mion,3,5,8,2022,01-17,07:57
025 Nouveau Saint-Roch,3,5,8,2022,01-17,07:57
026 Renouvier,0,8,8,2022,01-17,07:57
027 Odysseum,3,5,8,2022,01-17,07:57
028 Saint-Denis,4,4,8,2022,01-17,07:57
029 Richter,9,7,16,2022,01-17,07:57
030 Charles Flahault,5,3,8,2022,01-17,07:57
031 Voltaire,2,6,8,2022,01-17,07:57
032 Pr�s d'Ar�nes,8,0,8,2022,01-17,07:57
033 Garcia Lorca,7,1,8,2022,01-17,07:57
034 Vert Bois,0,16,16,2022,01-17,07:57
035 Malbosc,0,8,8,2022,01-17,07:57
036 Occitanie,2,30,32,2022,01-17,07:57
037 FacdesSciences,10,14,24,2022,01-17,07:57
038 Fac de Lettres,8,8,16,2022,01-17,07:57
039 Aiguelongue,5,3,8,2022,01-17,07:57
040 Jeu de Mail des Abb�s,7,1,8,2022,01-17,07:57
041 Eurom�decine,1,7,8,2022,01-17,07:57
042 Marie Caizergues,2,6,8,2022,01-17,07:57
043 Sabines,1,7,8,2022,01-17,07:57
044 Celleneuve,4,4,8,2022,01-17,07:57
045 Jardin de la Lironde,4,4,8,2022,01-17,07:57
046 P�re Soulas,6,2,8,2022,01-17,07:57
047 Place Viala,2,6,8,2022,01-17,07:57
048 H�tel du D�partement,1,7,8,2022,01-17,07:57
049 Tonnelles,1,7,8,2022,01-17,07:57
050 Parvis Jules Ferry - Gare Saint-Roch,4,4,8,2022,01-17,07:57
051 Pont de Lattes - Gare Saint-Roch,0,12,12,2022,01-17,07:57
053 Deux Ponts - Gare Saint-Roch,3,5,8,2022,01-17,07:57
054 Providence - Ovalie,3,5,8,2022,01-17,07:57
055 P�rols Etang de l'Or,32,36,68,2022,01-17,07:57
056 Albert 1er - Cath�drale,7,5,12,2022,01-17,07:57
057 Saint-Guilhem - Courreau,2,6,8,2022,01-17,07:57
059 Sud De France,0,8,8,2022,01-17,07:57
001 Rue Jules Ferry - Gare Saint-Roch,3,9,12,2022,01-17,08:08
002 Com�die,13,11,24,2022,01-17,08:08
003 Esplanade,16,16,32,2022,01-17,08:08
004 H�tel de Ville,12,4,16,2022,01-17,08:08
005 Corum,3,9,12,2022,01-17,08:08
006 Place Albert 1er - St Charles,18,13,31,2022,01-17,08:08
007 Foch,1,7,8,2022,01-17,08:08
008 Halles Castellane,0,12,12,2022,01-17,08:08
009 Observatoire,4,4,8,2022,01-17,08:08
010 Rondelet,5,11,16,2022,01-17,08:08
011 Plan Cabanes,4,8,12,2022,01-17,08:08
012 Boutonnet,1,11,12,2022,01-17,08:08
013 Emile Combes,6,2,8,2022,01-17,08:08
014 Beaux-Arts,7,1,8,2022,01-17,08:08
015 Les Aubes,6,2,8,2022,01-17,08:08
016 Antigone centre,5,11,16,2022,01-17,08:08
017 M�diath�que Emile Zola,8,8,16,2022,01-17,08:08
018 Nombre d'Or,4,12,16,2022,01-17,08:08
019 Louis Blanc,8,8,16,2022,01-17,08:08
020 Gambetta,0,8,8,2022,01-17,08:08
021 Port Marianne,4,12,16,2022,01-17,08:08
022 Clemenceau,4,8,12,2022,01-17,08:08
023 Les Arceaux,4,12,16,2022,01-17,08:08
024 Cit� Mion,3,5,8,2022,01-17,08:08
025 Nouveau Saint-Roch,3,5,8,2022,01-17,08:08
026 Renouvier,0,8,8,2022,01-17,08:08
027 Odysseum,3,5,8,2022,01-17,08:08
028 Saint-Denis,4,4,8,2022,01-17,08:08
029 Richter,9,7,16,2022,01-17,08:08
030 Charles Flahault,5,3,8,2022,01-17,08:08
031 Voltaire,2,6,8,2022,01-17,08:08
032 Pr�s d'Ar�nes,8,0,8,2022,01-17,08:08
033 Garcia Lorca,7,1,8,2022,01-17,08:08
034 Vert Bois,0,16,16,2022,01-17,08:08
035 Malbosc,0,8,8,2022,01-17,08:08
036 Occitanie,2,30,32,2022,01-17,08:08
037 FacdesSciences,12,12,24,2022,01-17,08:08
038 Fac de Lettres,8,8,16,2022,01-17,08:08
039 Aiguelongue,5,3,8,2022,01-17,08:08
040 Jeu de Mail des Abb�s,7,1,8,2022,01-17,08:08
041 Eurom�decine,1,7,8,2022,01-17,08:08
042 Marie Caizergues,2,6,8,2022,01-17,08:08
043 Sabines,1,7,8,2022,01-17,08:08
044 Celleneuve,4,4,8,2022,01-17,08:08
045 Jardin de la Lironde,4,4,8,2022,01-17,08:08
046 P�re Soulas,6,2,8,2022,01-17,08:08
047 Place Viala,2,6,8,2022,01-17,08:08
048 H�tel du D�partement,1,7,8,2022,01-17,08:08
049 Tonnelles,1,7,8,2022,01-17,08:08
050 Parvis Jules Ferry - Gare Saint-Roch,4,4,8,2022,01-17,08:08
051 Pont de Lattes - Gare Saint-Roch,0,12,12,2022,01-17,08:08
053 Deux Ponts - Gare Saint-Roch,3,5,8,2022,01-17,08:08
054 Providence - Ovalie,3,5,8,2022,01-17,08:08
055 P�rols Etang de l'Or,32,36,68,2022,01-17,08:08
056 Albert 1er - Cath�drale,7,5,12,2022,01-17,08:08
057 Saint-Guilhem - Courreau,2,6,8,2022,01-17,08:08
059 Sud De France,0,8,8,2022,01-17,08:08
001 Rue Jules Ferry - Gare Saint-Roch,3,9,12,2022,01-17,08:18
002 Com�die,12,12,24,2022,01-17,08:18
003 Esplanade,16,16,32,2022,01-17,08:18
004 H�tel de Ville,12,4,16,2022,01-17,08:18
005 Corum,3,9,12,2022,01-17,08:18
006 Place Albert 1er - St Charles,18,13,31,2022,01-17,08:18
007 Foch,1,7,8,2022,01-17,08:18
008 Halles Castellane,0,12,12,2022,01-17,08:18
009 Observatoire,4,4,8,2022,01-17,08:18
010 Rondelet,5,11,16,2022,01-17,08:18
011 Plan Cabanes,4,8,12,2022,01-17,08:18
012 Boutonnet,1,11,12,2022,01-17,08:18
013 Emile Combes,6,2,8,2022,01-17,08:18
014 Beaux-Arts,8,0,8,2022,01-17,08:18
015 Les Aubes,6,2,8,2022,01-17,08:18
016 Antigone centre,5,11,16,2022,01-17,08:18
017 M�diath�que Emile Zola,8,8,16,2022,01-17,08:18
018 Nombre d'Or,4,12,16,2022,01-17,08:18
019 Louis Blanc,8,8,16,2022,01-17,08:18
020 Gambetta,0,8,8,2022,01-17,08:18
021 Port Marianne,4,12,16,2022,01-17,08:18
022 Clemenceau,4,8,12,2022,01-17,08:18
023 Les Arceaux,4,12,16,2022,01-17,08:18
024 Cit� Mion,3,5,8,2022,01-17,08:18
025 Nouveau Saint-Roch,2,6,8,2022,01-17,08:18
026 Renouvier,0,8,8,2022,01-17,08:18
027 Odysseum,3,5,8,2022,01-17,08:18
028 Saint-Denis,4,4,8,2022,01-17,08:18
029 Richter,9,7,16,2022,01-17,08:18
030 Charles Flahault,6,2,8,2022,01-17,08:18
031 Voltaire,2,6,8,2022,01-17,08:18
032 Pr�s d'Ar�nes,8,0,8,2022,01-17,08:18
033 Garcia Lorca,8,0,8,2022,01-17,08:18
034 Vert Bois,0,16,16,2022,01-17,08:18
035 Malbosc,0,8,8,2022,01-17,08:18
036 Occitanie,1,31,32,2022,01-17,08:18
037 FacdesSciences,13,11,24,2022,01-17,08:18
038 Fac de Lettres,7,9,16,2022,01-17,08:18
039 Aiguelongue,5,3,8,2022,01-17,08:18
040 Jeu de Mail des Abb�s,7,1,8,2022,01-17,08:18
041 Eurom�decine,1,7,8,2022,01-17,08:18
042 Marie Caizergues,2,6,8,2022,01-17,08:18
043 Sabines,1,7,8,2022,01-17,08:18
044 Celleneuve,4,4,8,2022,01-17,08:18
045 Jardin de la Lironde,4,4,8,2022,01-17,08:18
046 P�re Soulas,6,2,8,2022,01-17,08:18
047 Place Viala,2,6,8,2022,01-17,08:18
048 H�tel du D�partement,1,7,8,2022,01-17,08:18
049 Tonnelles,1,7,8,2022,01-17,08:18
050 Parvis Jules Ferry - Gare Saint-Roch,4,4,8,2022,01-17,08:18
051 Pont de Lattes - Gare Saint-Roch,0,12,12,2022,01-17,08:18
053 Deux Ponts - Gare Saint-Roch,3,5,8,2022,01-17,08:18
054 Providence - Ovalie,3,5,8,2022,01-17,08:18
055 P�rols Etang de l'Or,32,36,68,2022,01-17,08:18
056 Albert 1er - Cath�drale,7,5,12,2022,01-17,08:18
057 Saint-Guilhem - Courreau,2,6,8,2022,01-17,08:18
059 Sud De France,0,8,8,2022,01-17,08:18
001 Rue Jules Ferry - Gare Saint-Roch,3,9,12,2022,01-17,08:28
002 Com�die,12,12,24,2022,01-17,08:28
003 Esplanade,16,16,32,2022,01-17,08:28
004 H�tel de Ville,12,4,16,2022,01-17,08:28
005 Corum,3,9,12,2022,01-17,08:28
006 Place Albert 1er - St Charles,18,13,31,2022,01-17,08:28
007 Foch,1,7,8,2022,01-17,08:28
008 Halles Castellane,0,12,12,2022,01-17,08:28
009 Observatoire,4,4,8,2022,01-17,08:28
010 Rondelet,5,11,16,2022,01-17,08:28
011 Plan Cabanes,3,9,12,2022,01-17,08:28
012 Boutonnet,1,11,12,2022,01-17,08:28
013 Emile Combes,6,2,8,2022,01-17,08:28
014 Beaux-Arts,5,3,8,2022,01-17,08:28
015 Les Aubes,6,2,8,2022,01-17,08:28
016 Antigone centre,5,11,16,2022,01-17,08:28
017 M�diath�que Emile Zola,9,7,16,2022,01-17,08:28
018 Nombre d'Or,4,12,16,2022,01-17,08:28
019 Louis Blanc,8,8,16,2022,01-17,08:28
020 Gambetta,0,8,8,2022,01-17,08:28
021 Port Marianne,4,12,16,2022,01-17,08:28
022 Clemenceau,4,8,12,2022,01-17,08:28
023 Les Arceaux,4,12,16,2022,01-17,08:28
024 Cit� Mion,3,5,8,2022,01-17,08:28
025 Nouveau Saint-Roch,2,6,8,2022,01-17,08:28
026 Renouvier,0,8,8,2022,01-17,08:28
027 Odysseum,3,5,8,2022,01-17,08:28
028 Saint-Denis,4,4,8,2022,01-17,08:28
029 Richter,9,7,16,2022,01-17,08:28
030 Charles Flahault,5,3,8,2022,01-17,08:28
031 Voltaire,2,6,8,2022,01-17,08:28
032 Pr�s d'Ar�nes,8,0,8,2022,01-17,08:28
033 Garcia Lorca,8,0,8,2022,01-17,08:28
034 Vert Bois,0,16,16,2022,01-17,08:28
035 Malbosc,0,8,8,2022,01-17,08:28
036 Occitanie,2,30,32,2022,01-17,08:28
037 FacdesSciences,13,11,24,2022,01-17,08:28
038 Fac de Lettres,7,9,16,2022,01-17,08:28
039 Aiguelongue,5,3,8,2022,01-17,08:28
040 Jeu de Mail des Abb�s,7,1,8,2022,01-17,08:28
041 Eurom�decine,1,7,8,2022,01-17,08:28
042 Marie Caizergues,2,6,8,2022,01-17,08:28
043 Sabines,1,7,8,2022,01-17,08:28
044 Celleneuve,4,4,8,2022,01-17,08:28
045 Jardin de la Lironde,4,4,8,2022,01-17,08:28
046 P�re Soulas,5,3,8,2022,01-17,08:28
047 Place Viala,2,6,8,2022,01-17,08:28
048 H�tel du D�partement,1,7,8,2022,01-17,08:28
049 Tonnelles,1,7,8,2022,01-17,08:28
050 Parvis Jules Ferry - Gare Saint-Roch,4,4,8,2022,01-17,08:28
051 Pont de Lattes - Gare Saint-Roch,0,12,12,2022,01-17,08:28
053 Deux Ponts - Gare Saint-Roch,3,5,8,2022,01-17,08:28
054 Providence - Ovalie,3,5,8,2022,01-17,08:28
055 P�rols Etang de l'Or,32,36,68,2022,01-17,08:28
056 Albert 1er - Cath�drale,7,5,12,2022,01-17,08:28
057 Saint-Guilhem - Courreau,2,6,8,2022,01-17,08:28
059 Sud De France,0,8,8,2022,01-17,08:28
001 Rue Jules Ferry - Gare Saint-Roch,3,9,12,2022,01-17,08:38
002 Com�die,12,12,24,2022,01-17,08:38
003 Esplanade,16,16,32,2022,01-17,08:38
004 H�tel de Ville,12,4,16,2022,01-17,08:38
005 Corum,3,9,12,2022,01-17,08:38
006 Place Albert 1er - St Charles,19,12,31,2022,01-17,08:38
007 Foch,1,7,8,2022,01-17,08:38
008 Halles Castellane,0,12,12,2022,01-17,08:38
009 Observatoire,4,4,8,2022,01-17,08:38
010 Rondelet,5,11,16,2022,01-17,08:38
011 Plan Cabanes,3,9,12,2022,01-17,08:38
012 Boutonnet,1,11,12,2022,01-17,08:38
013 Emile Combes,6,2,8,2022,01-17,08:38
014 Beaux-Arts,5,3,8,2022,01-17,08:38
015 Les Aubes,6,2,8,2022,01-17,08:38
016 Antigone centre,5,11,16,2022,01-17,08:38
017 M�diath�que Emile Zola,7,9,16,2022,01-17,08:38
018 Nombre d'Or,4,12,16,2022,01-17,08:38
019 Louis Blanc,7,9,16,2022,01-17,08:38
020 Gambetta,0,8,8,2022,01-17,08:38
021 Port Marianne,4,12,16,2022,01-17,08:38
022 Clemenceau,3,9,12,2022,01-17,08:38
023 Les Arceaux,3,13,16,2022,01-17,08:38
024 Cit� Mion,3,5,8,2022,01-17,08:38
025 Nouveau Saint-Roch,1,7,8,2022,01-17,08:38
026 Renouvier,0,8,8,2022,01-17,08:38
027 Odysseum,3,5,8,2022,01-17,08:38
028 Saint-Denis,4,4,8,2022,01-17,08:38
029 Richter,9,7,16,2022,01-17,08:38
030 Charles Flahault,5,3,8,2022,01-17,08:38
031 Voltaire,2,6,8,2022,01-17,08:38
032 Pr�s d'Ar�nes,8,0,8,2022,01-17,08:38
033 Garcia Lorca,8,0,8,2022,01-17,08:38
034 Vert Bois,0,16,16,2022,01-17,08:38
035 Malbosc,0,8,8,2022,01-17,08:38
036 Occitanie,3,29,32,2022,01-17,08:38
037 FacdesSciences,13,11,24,2022,01-17,08:38
038 Fac de Lettres,7,9,16,2022,01-17,08:38
039 Aiguelongue,5,3,8,2022,01-17,08:38
040 Jeu de Mail des Abb�s,7,1,8,2022,01-17,08:38
041 Eurom�decine,1,7,8,2022,01-17,08:38
042 Marie Caizergues,2,6,8,2022,01-17,08:38
043 Sabines,1,7,8,2022,01-17,08:38
044 Celleneuve,4,4,8,2022,01-17,08:38
045 Jardin de la Lironde,4,4,8,2022,01-17,08:38
046 P�re Soulas,4,4,8,2022,01-17,08:38
047 Place Viala,3,5,8,2022,01-17,08:38
048 H�tel du D�partement,1,7,8,2022,01-17,08:38
049 Tonnelles,1,7,8,2022,01-17,08:38
050 Parvis Jules Ferry - Gare Saint-Roch,4,4,8,2022,01-17,08:38
051 Pont de Lattes - Gare Saint-Roch,0,12,12,2022,01-17,08:38
053 Deux Ponts - Gare Saint-Roch,3,5,8,2022,01-17,08:38
054 Providence - Ovalie,3,5,8,2022,01-17,08:38
055 P�rols Etang de l'Or,32,36,68,2022,01-17,08:38
056 Albert 1er - Cath�drale,7,5,12,2022,01-17,08:38
057 Saint-Guilhem - Courreau,1,7,8,2022,01-17,08:38
059 Sud De France,0,8,8,2022,01-17,08:38
001 Rue Jules Ferry - Gare Saint-Roch,3,9,12,2022,01-17,08:48
002 Com�die,11,13,24,2022,01-17,08:48
003 Esplanade,16,16,32,2022,01-17,08:48
004 H�tel de Ville,12,4,16,2022,01-17,08:48
005 Corum,3,9,12,2022,01-17,08:48
006 Place Albert 1er - St Charles,19,12,31,2022,01-17,08:48
007 Foch,7,1,8,2022,01-17,08:48
008 Halles Castellane,4,8,12,2022,01-17,08:48
009 Observatoire,3,5,8,2022,01-17,08:48
010 Rondelet,5,11,16,2022,01-17,08:48
011 Plan Cabanes,3,9,12,2022,01-17,08:48
012 Boutonnet,1,11,12,2022,01-17,08:48
013 Emile Combes,6,2,8,2022,01-17,08:48
014 Beaux-Arts,5,3,8,2022,01-17,08:48
015 Les Aubes,6,2,8,2022,01-17,08:48
016 Antigone centre,6,10,16,2022,01-17,08:48
017 M�diath�que Emile Zola,8,8,16,2022,01-17,08:48
018 Nombre d'Or,4,12,16,2022,01-17,08:48
019 Louis Blanc,7,9,16,2022,01-17,08:48
020 Gambetta,0,8,8,2022,01-17,08:48
021 Port Marianne,5,11,16,2022,01-17,08:48
022 Clemenceau,3,9,12,2022,01-17,08:48
023 Les Arceaux,2,14,16,2022,01-17,08:48
024 Cit� Mion,3,5,8,2022,01-17,08:48
025 Nouveau Saint-Roch,2,6,8,2022,01-17,08:48
026 Renouvier,0,8,8,2022,01-17,08:48
027 Odysseum,3,5,8,2022,01-17,08:48
028 Saint-Denis,4,4,8,2022,01-17,08:48
029 Richter,10,6,16,2022,01-17,08:48
030 Charles Flahault,5,3,8,2022,01-17,08:48
031 Voltaire,2,6,8,2022,01-17,08:48
032 Pr�s d'Ar�nes,8,0,8,2022,01-17,08:48
033 Garcia Lorca,8,0,8,2022,01-17,08:48
034 Vert Bois,0,16,16,2022,01-17,08:48
035 Malbosc,1,7,8,2022,01-17,08:48
036 Occitanie,3,29,32,2022,01-17,08:48
037 FacdesSciences,12,12,24,2022,01-17,08:48
038 Fac de Lettres,7,9,16,2022,01-17,08:48
039 Aiguelongue,4,4,8,2022,01-17,08:48
040 Jeu de Mail des Abb�s,8,0,8,2022,01-17,08:48
041 Eurom�decine,1,7,8,2022,01-17,08:48
042 Marie Caizergues,2,6,8,2022,01-17,08:48
043 Sabines,1,7,8,2022,01-17,08:48
044 Celleneuve,4,4,8,2022,01-17,08:48
045 Jardin de la Lironde,4,4,8,2022,01-17,08:48
046 P�re Soulas,4,4,8,2022,01-17,08:48
047 Place Viala,3,5,8,2022,01-17,08:48
048 H�tel du D�partement,1,7,8,2022,01-17,08:48
049 Tonnelles,1,7,8,2022,01-17,08:48
050 Parvis Jules Ferry - Gare Saint-Roch,4,4,8,2022,01-17,08:48
051 Pont de Lattes - Gare Saint-Roch,0,12,12,2022,01-17,08:48
053 Deux Ponts - Gare Saint-Roch,3,5,8,2022,01-17,08:48
054 Providence - Ovalie,3,5,8,2022,01-17,08:48
055 P�rols Etang de l'Or,32,36,68,2022,01-17,08:48
056 Albert 1er - Cath�drale,7,5,12,2022,01-17,08:48
057 Saint-Guilhem - Courreau,1,7,8,2022,01-17,08:48
059 Sud De France,0,8,8,2022,01-17,08:48
001 Rue Jules Ferry - Gare Saint-Roch,2,10,12,2022,01-17,08:58
002 Com�die,11,13,24,2022,01-17,08:58
003 Esplanade,16,16,32,2022,01-17,08:58
004 H�tel de Ville,12,4,16,2022,01-17,08:58
005 Corum,3,9,12,2022,01-17,08:58
006 Place Albert 1er - St Charles,20,11,31,2022,01-17,08:58
007 Foch,7,1,8,2022,01-17,08:58
008 Halles Castellane,9,3,12,2022,01-17,08:58
009 Observatoire,3,5,8,2022,01-17,08:58
010 Rondelet,4,12,16,2022,01-17,08:58
011 Plan Cabanes,4,8,12,2022,01-17,08:58
012 Boutonnet,1,11,12,2022,01-17,08:58
013 Emile Combes,6,2,8,2022,01-17,08:58
014 Beaux-Arts,5,3,8,2022,01-17,08:58
015 Les Aubes,6,2,8,2022,01-17,08:58
016 Antigone centre,6,10,16,2022,01-17,08:58
017 M�diath�que Emile Zola,9,7,16,2022,01-17,08:58
018 Nombre d'Or,4,12,16,2022,01-17,08:58
019 Louis Blanc,6,10,16,2022,01-17,08:58
020 Gambetta,0,8,8,2022,01-17,08:58
021 Port Marianne,5,11,16,2022,01-17,08:58
022 Clemenceau,3,9,12,2022,01-17,08:58
023 Les Arceaux,2,14,16,2022,01-17,08:58
024 Cit� Mion,3,5,8,2022,01-17,08:58
025 Nouveau Saint-Roch,2,6,8,2022,01-17,08:58
026 Renouvier,0,8,8,2022,01-17,08:58
027 Odysseum,3,5,8,2022,01-17,08:58
028 Saint-Denis,4,4,8,2022,01-17,08:58
029 Richter,10,6,16,2022,01-17,08:58
030 Charles Flahault,5,3,8,2022,01-17,08:58
031 Voltaire,2,6,8,2022,01-17,08:58
032 Pr�s d'Ar�nes,8,0,8,2022,01-17,08:58
033 Garcia Lorca,8,0,8,2022,01-17,08:58
034 Vert Bois,0,16,16,2022,01-17,08:58
035 Malbosc,1,7,8,2022,01-17,08:58
036 Occitanie,3,29,32,2022,01-17,08:58
037 FacdesSciences,13,11,24,2022,01-17,08:58
038 Fac de Lettres,7,9,16,2022,01-17,08:58
039 Aiguelongue,4,4,8,2022,01-17,08:58
040 Jeu de Mail des Abb�s,8,0,8,2022,01-17,08:58
041 Eurom�decine,1,7,8,2022,01-17,08:58
042 Marie Caizergues,2,6,8,2022,01-17,08:58
043 Sabines,1,7,8,2022,01-17,08:58
044 Celleneuve,4,4,8,2022,01-17,08:58
045 Jardin de la Lironde,4,4,8,2022,01-17,08:58
046 P�re Soulas,4,4,8,2022,01-17,08:58
047 Place Viala,3,5,8,2022,01-17,08:58
048 H�tel du D�partement,1,7,8,2022,01-17,08:58
049 Tonnelles,1,7,8,2022,01-17,08:58
050 Parvis Jules Ferry - Gare Saint-Roch,3,5,8,2022,01-17,08:58
051 Pont de Lattes - Gare Saint-Roch,0,12,12,2022,01-17,08:58
053 Deux Ponts - Gare Saint-Roch,3,5,8,2022,01-17,08:58
054 Providence - Ovalie,3,5,8,2022,01-17,08:58
055 P�rols Etang de l'Or,32,36,68,2022,01-17,08:58
056 Albert 1er - Cath�drale,7,5,12,2022,01-17,08:58
057 Saint-Guilhem - Courreau,0,8,8,2022,01-17,08:58
059 Sud De France,0,8,8,2022,01-17,08:58
001 Rue Jules Ferry - Gare Saint-Roch,1,11,12,2022,01-17,09:09
002 Com�die,11,13,24,2022,01-17,09:09
003 Esplanade,16,16,32,2022,01-17,09:09
004 H�tel de Ville,12,4,16,2022,01-17,09:09
005 Corum,3,9,12,2022,01-17,09:09
006 Place Albert 1er - St Charles,20,11,31,2022,01-17,09:09
007 Foch,7,1,8,2022,01-17,09:09
008 Halles Castellane,9,3,12,2022,01-17,09:09
009 Observatoire,3,5,8,2022,01-17,09:09
010 Rondelet,4,12,16,2022,01-17,09:09
011 Plan Cabanes,4,8,12,2022,01-17,09:09
012 Boutonnet,1,11,12,2022,01-17,09:09
013 Emile Combes,6,2,8,2022,01-17,09:09
014 Beaux-Arts,5,3,8,2022,01-17,09:09
015 Les Aubes,6,2,8,2022,01-17,09:09
016 Antigone centre,6,10,16,2022,01-17,09:09
017 M�diath�que Emile Zola,10,6,16,2022,01-17,09:09
018 Nombre d'Or,4,12,16,2022,01-17,09:09
019 Louis Blanc,6,10,16,2022,01-17,09:09
020 Gambetta,0,8,8,2022,01-17,09:09
021 Port Marianne,5,11,16,2022,01-17,09:09
022 Clemenceau,3,9,12,2022,01-17,09:09
023 Les Arceaux,3,13,16,2022,01-17,09:09
024 Cit� Mion,3,5,8,2022,01-17,09:09
025 Nouveau Saint-Roch,2,6,8,2022,01-17,09:09
026 Renouvier,1,7,8,2022,01-17,09:09
027 Odysseum,4,4,8,2022,01-17,09:09
028 Saint-Denis,4,4,8,2022,01-17,09:09
029 Richter,10,6,16,2022,01-17,09:09
030 Charles Flahault,5,3,8,2022,01-17,09:09
031 Voltaire,2,6,8,2022,01-17,09:09
032 Pr�s d'Ar�nes,8,0,8,2022,01-17,09:09
033 Garcia Lorca,8,0,8,2022,01-17,09:09
034 Vert Bois,0,16,16,2022,01-17,09:09
035 Malbosc,1,7,8,2022,01-17,09:09
036 Occitanie,3,29,32,2022,01-17,09:09
037 FacdesSciences,13,11,24,2022,01-17,09:09
038 Fac de Lettres,7,9,16,2022,01-17,09:09
039 Aiguelongue,4,4,8,2022,01-17,09:09
040 Jeu de Mail des Abb�s,8,0,8,2022,01-17,09:09
041 Eurom�decine,1,7,8,2022,01-17,09:09
042 Marie Caizergues,2,6,8,2022,01-17,09:09
043 Sabines,1,7,8,2022,01-17,09:09
044 Celleneuve,4,4,8,2022,01-17,09:09
045 Jardin de la Lironde,4,4,8,2022,01-17,09:09
046 P�re Soulas,3,5,8,2022,01-17,09:09
047 Place Viala,4,4,8,2022,01-17,09:09
048 H�tel du D�partement,1,7,8,2022,01-17,09:09
049 Tonnelles,1,7,8,2022,01-17,09:09
050 Parvis Jules Ferry - Gare Saint-Roch,3,5,8,2022,01-17,09:09
051 Pont de Lattes - Gare Saint-Roch,0,12,12,2022,01-17,09:09
053 Deux Ponts - Gare Saint-Roch,3,5,8,2022,01-17,09:09
054 Providence - Ovalie,3,5,8,2022,01-17,09:09
055 P�rols Etang de l'Or,32,36,68,2022,01-17,09:09
056 Albert 1er - Cath�drale,7,5,12,2022,01-17,09:09
057 Saint-Guilhem - Courreau,0,8,8,2022,01-17,09:09
059 Sud De France,0,8,8,2022,01-17,09:09
001 Rue Jules Ferry - Gare Saint-Roch,1,11,12,2022,01-17,09:19
002 Com�die,11,13,24,2022,01-17,09:19
003 Esplanade,16,16,32,2022,01-17,09:19
004 H�tel de Ville,12,4,16,2022,01-17,09:19
005 Corum,3,9,12,2022,01-17,09:19
006 Place Albert 1er - St Charles,20,11,31,2022,01-17,09:19
007 Foch,7,1,8,2022,01-17,09:19
008 Halles Castellane,9,3,12,2022,01-17,09:19
009 Observatoire,3,5,8,2022,01-17,09:19
010 Rondelet,4,12,16,2022,01-17,09:19
011 Plan Cabanes,4,8,12,2022,01-17,09:19
012 Boutonnet,1,11,12,2022,01-17,09:19
013 Emile Combes,6,2,8,2022,01-17,09:19
014 Beaux-Arts,5,3,8,2022,01-17,09:19
015 Les Aubes,6,2,8,2022,01-17,09:19
016 Antigone centre,6,10,16,2022,01-17,09:19
017 M�diath�que Emile Zola,10,6,16,2022,01-17,09:19
018 Nombre d'Or,4,12,16,2022,01-17,09:19
019 Louis Blanc,6,10,16,2022,01-17,09:19
020 Gambetta,0,8,8,2022,01-17,09:19
021 Port Marianne,5,11,16,2022,01-17,09:19
022 Clemenceau,3,9,12,2022,01-17,09:19
023 Les Arceaux,3,13,16,2022,01-17,09:19
024 Cit� Mion,3,5,8,2022,01-17,09:19
025 Nouveau Saint-Roch,2,6,8,2022,01-17,09:19
026 Renouvier,1,7,8,2022,01-17,09:19
027 Odysseum,4,4,8,2022,01-17,09:19
028 Saint-Denis,4,4,8,2022,01-17,09:19
029 Richter,10,6,16,2022,01-17,09:19
030 Charles Flahault,5,3,8,2022,01-17,09:19
031 Voltaire,2,6,8,2022,01-17,09:19
032 Pr�s d'Ar�nes,8,0,8,2022,01-17,09:19
033 Garcia Lorca,8,0,8,2022,01-17,09:19
034 Vert Bois,0,16,16,2022,01-17,09:19
035 Malbosc,1,7,8,2022,01-17,09:19
036 Occitanie,3,29,32,2022,01-17,09:19
037 FacdesSciences,13,11,24,2022,01-17,09:19
038 Fac de Lettres,7,9,16,2022,01-17,09:19
039 Aiguelongue,4,4,8,2022,01-17,09:19
040 Jeu de Mail des Abb�s,8,0,8,2022,01-17,09:19
041 Eurom�decine,1,7,8,2022,01-17,09:19
042 Marie Caizergues,2,6,8,2022,01-17,09:19
043 Sabines,1,7,8,2022,01-17,09:19
044 Celleneuve,4,4,8,2022,01-17,09:19
045 Jardin de la Lironde,6,2,8,2022,01-17,09:19
046 P�re Soulas,3,5,8,2022,01-17,09:19
047 Place Viala,4,4,8,2022,01-17,09:19
048 H�tel du D�partement,1,7,8,2022,01-17,09:19
049 Tonnelles,1,7,8,2022,01-17,09:19
050 Parvis Jules Ferry - Gare Saint-Roch,3,5,8,2022,01-17,09:19
051 Pont de Lattes - Gare Saint-Roch,0,12,12,2022,01-17,09:19
053 Deux Ponts - Gare Saint-Roch,3,5,8,2022,01-17,09:19
054 Providence - Ovalie,3,5,8,2022,01-17,09:19
055 P�rols Etang de l'Or,32,36,68,2022,01-17,09:19
056 Albert 1er - Cath�drale,7,5,12,2022,01-17,09:19
057 Saint-Guilhem - Courreau,0,8,8,2022,01-17,09:19
059 Sud De France,0,8,8,2022,01-17,09:19
001 Rue Jules Ferry - Gare Saint-Roch,1,11,12,2022,01-17,09:29
002 Com�die,11,13,24,2022,01-17,09:29
003 Esplanade,15,17,32,2022,01-17,09:29
004 H�tel de Ville,12,4,16,2022,01-17,09:29
005 Corum,3,9,12,2022,01-17,09:29
006 Place Albert 1er - St Charles,20,11,31,2022,01-17,09:29
007 Foch,7,1,8,2022,01-17,09:29
008 Halles Castellane,8,4,12,2022,01-17,09:29
009 Observatoire,3,5,8,2022,01-17,09:29
010 Rondelet,4,12,16,2022,01-17,09:29
011 Plan Cabanes,4,8,12,2022,01-17,09:29
012 Boutonnet,1,11,12,2022,01-17,09:29
013 Emile Combes,6,2,8,2022,01-17,09:29
014 Beaux-Arts,5,3,8,2022,01-17,09:29
015 Les Aubes,6,2,8,2022,01-17,09:29
016 Antigone centre,6,10,16,2022,01-17,09:29
017 M�diath�que Emile Zola,9,7,16,2022,01-17,09:29
018 Nombre d'Or,4,12,16,2022,01-17,09:29
019 Louis Blanc,7,9,16,2022,01-17,09:29
020 Gambetta,0,8,8,2022,01-17,09:29
021 Port Marianne,5,11,16,2022,01-17,09:29
022 Clemenceau,3,9,12,2022,01-17,09:29
023 Les Arceaux,3,13,16,2022,01-17,09:29
024 Cit� Mion,3,5,8,2022,01-17,09:29
025 Nouveau Saint-Roch,2,6,8,2022,01-17,09:29
026 Renouvier,1,7,8,2022,01-17,09:29
027 Odysseum,4,4,8,2022,01-17,09:29
028 Saint-Denis,4,4,8,2022,01-17,09:29
029 Richter,10,6,16,2022,01-17,09:29
030 Charles Flahault,5,3,8,2022,01-17,09:29
031 Voltaire,2,6,8,2022,01-17,09:29
032 Pr�s d'Ar�nes,8,0,8,2022,01-17,09:29
033 Garcia Lorca,8,0,8,2022,01-17,09:29
034 Vert Bois,0,16,16,2022,01-17,09:29
035 Malbosc,1,7,8,2022,01-17,09:29
036 Occitanie,3,29,32,2022,01-17,09:29
037 FacdesSciences,13,11,24,2022,01-17,09:29
038 Fac de Lettres,7,9,16,2022,01-17,09:29
039 Aiguelongue,4,4,8,2022,01-17,09:29
040 Jeu de Mail des Abb�s,8,0,8,2022,01-17,09:29
041 Eurom�decine,1,7,8,2022,01-17,09:29
042 Marie Caizergues,2,6,8,2022,01-17,09:29
043 Sabines,1,7,8,2022,01-17,09:29
044 Celleneuve,4,4,8,2022,01-17,09:29
045 Jardin de la Lironde,6,2,8,2022,01-17,09:29
046 P�re Soulas,3,5,8,2022,01-17,09:29
047 Place Viala,4,4,8,2022,01-17,09:29
048 H�tel du D�partement,1,7,8,2022,01-17,09:29
049 Tonnelles,0,8,8,2022,01-17,09:29
050 Parvis Jules Ferry - Gare Saint-Roch,3,5,8,2022,01-17,09:29
051 Pont de Lattes - Gare Saint-Roch,0,12,12,2022,01-17,09:29
053 Deux Ponts - Gare Saint-Roch,3,5,8,2022,01-17,09:29
054 Providence - Ovalie,3,5,8,2022,01-17,09:29
055 P�rols Etang de l'Or,32,36,68,2022,01-17,09:29
056 Albert 1er - Cath�drale,7,5,12,2022,01-17,09:29
057 Saint-Guilhem - Courreau,0,8,8,2022,01-17,09:29
059 Sud De France,0,8,8,2022,01-17,09:29
001 Rue Jules Ferry - Gare Saint-Roch,1,11,12,2022,01-17,09:39
002 Com�die,12,12,24,2022,01-17,09:39
003 Esplanade,15,17,32,2022,01-17,09:39
004 H�tel de Ville,13,3,16,2022,01-17,09:39
005 Corum,2,10,12,2022,01-17,09:39
006 Place Albert 1er - St Charles,20,11,31,2022,01-17,09:39
007 Foch,7,1,8,2022,01-17,09:39
008 Halles Castellane,8,4,12,2022,01-17,09:39
009 Observatoire,3,5,8,2022,01-17,09:39
010 Rondelet,4,12,16,2022,01-17,09:39
011 Plan Cabanes,4,8,12,2022,01-17,09:39
012 Boutonnet,2,10,12,2022,01-17,09:39
013 Emile Combes,6,2,8,2022,01-17,09:39
014 Beaux-Arts,5,3,8,2022,01-17,09:39
015 Les Aubes,6,2,8,2022,01-17,09:39
016 Antigone centre,6,10,16,2022,01-17,09:39
017 M�diath�que Emile Zola,9,7,16,2022,01-17,09:39
018 Nombre d'Or,5,11,16,2022,01-17,09:39
019 Louis Blanc,8,8,16,2022,01-17,09:39
020 Gambetta,0,8,8,2022,01-17,09:39
021 Port Marianne,5,11,16,2022,01-17,09:39
022 Clemenceau,2,10,12,2022,01-17,09:39
023 Les Arceaux,3,13,16,2022,01-17,09:39
024 Cit� Mion,3,5,8,2022,01-17,09:39
025 Nouveau Saint-Roch,2,6,8,2022,01-17,09:39
026 Renouvier,1,7,8,2022,01-17,09:39
027 Odysseum,4,4,8,2022,01-17,09:39
028 Saint-Denis,4,4,8,2022,01-17,09:39
029 Richter,11,5,16,2022,01-17,09:39
030 Charles Flahault,5,3,8,2022,01-17,09:39
031 Voltaire,2,6,8,2022,01-17,09:39
032 Pr�s d'Ar�nes,8,0,8,2022,01-17,09:39
033 Garcia Lorca,8,0,8,2022,01-17,09:39
034 Vert Bois,0,16,16,2022,01-17,09:39
035 Malbosc,1,7,8,2022,01-17,09:39
036 Occitanie,3,29,32,2022,01-17,09:39
037 FacdesSciences,14,10,24,2022,01-17,09:39
038 Fac de Lettres,6,10,16,2022,01-17,09:39
039 Aiguelongue,4,4,8,2022,01-17,09:39
040 Jeu de Mail des Abb�s,8,0,8,2022,01-17,09:39
041 Eurom�decine,1,7,8,2022,01-17,09:39
042 Marie Caizergues,1,7,8,2022,01-17,09:39
043 Sabines,1,7,8,2022,01-17,09:39
044 Celleneuve,4,4,8,2022,01-17,09:39
045 Jardin de la Lironde,6,2,8,2022,01-17,09:39
046 P�re Soulas,1,7,8,2022,01-17,09:39
047 Place Viala,4,4,8,2022,01-17,09:39
048 H�tel du D�partement,1,7,8,2022,01-17,09:39
049 Tonnelles,0,8,8,2022,01-17,09:39
050 Parvis Jules Ferry - Gare Saint-Roch,3,5,8,2022,01-17,09:39
051 Pont de Lattes - Gare Saint-Roch,0,12,12,2022,01-17,09:39
053 Deux Ponts - Gare Saint-Roch,3,5,8,2022,01-17,09:39
054 Providence - Ovalie,3,5,8,2022,01-17,09:39
055 P�rols Etang de l'Or,32,36,68,2022,01-17,09:39
056 Albert 1er - Cath�drale,7,5,12,2022,01-17,09:39
057 Saint-Guilhem - Courreau,0,8,8,2022,01-17,09:39
059 Sud De France,0,8,8,2022,01-17,09:39
001 Rue Jules Ferry - Gare Saint-Roch,1,11,12,2022,01-17,09:49
002 Com�die,12,12,24,2022,01-17,09:49
003 Esplanade,17,15,32,2022,01-17,09:49
004 H�tel de Ville,13,3,16,2022,01-17,09:49
005 Corum,2,10,12,2022,01-17,09:49
006 Place Albert 1er - St Charles,20,11,31,2022,01-17,09:49
007 Foch,6,2,8,2022,01-17,09:49
008 Halles Castellane,8,4,12,2022,01-17,09:49
009 Observatoire,3,5,8,2022,01-17,09:49
010 Rondelet,4,12,16,2022,01-17,09:49
011 Plan Cabanes,3,9,12,2022,01-17,09:49
012 Boutonnet,2,10,12,2022,01-17,09:49
013 Emile Combes,6,2,8,2022,01-17,09:49
014 Beaux-Arts,5,3,8,2022,01-17,09:49
015 Les Aubes,6,2,8,2022,01-17,09:49
016 Antigone centre,6,10,16,2022,01-17,09:49
017 M�diath�que Emile Zola,10,6,16,2022,01-17,09:49
018 Nombre d'Or,5,11,16,2022,01-17,09:49
019 Louis Blanc,8,8,16,2022,01-17,09:49
020 Gambetta,0,8,8,2022,01-17,09:49
021 Port Marianne,5,11,16,2022,01-17,09:49
022 Clemenceau,2,10,12,2022,01-17,09:49
023 Les Arceaux,3,13,16,2022,01-17,09:49
024 Cit� Mion,3,5,8,2022,01-17,09:49
025 Nouveau Saint-Roch,2,6,8,2022,01-17,09:49
026 Renouvier,1,7,8,2022,01-17,09:49
027 Odysseum,4,4,8,2022,01-17,09:49
028 Saint-Denis,3,5,8,2022,01-17,09:49
029 Richter,12,4,16,2022,01-17,09:49
030 Charles Flahault,5,3,8,2022,01-17,09:49
031 Voltaire,2,6,8,2022,01-17,09:49
032 Pr�s d'Ar�nes,8,0,8,2022,01-17,09:49
033 Garcia Lorca,8,0,8,2022,01-17,09:49
034 Vert Bois,0,16,16,2022,01-17,09:49
035 Malbosc,1,7,8,2022,01-17,09:49
036 Occitanie,3,29,32,2022,01-17,09:49
037 FacdesSciences,16,8,24,2022,01-17,09:49
038 Fac de Lettres,7,9,16,2022,01-17,09:49
039 Aiguelongue,4,4,8,2022,01-17,09:49
040 Jeu de Mail des Abb�s,8,0,8,2022,01-17,09:49
041 Eurom�decine,1,7,8,2022,01-17,09:49
042 Marie Caizergues,1,7,8,2022,01-17,09:49
043 Sabines,1,7,8,2022,01-17,09:49
044 Celleneuve,4,4,8,2022,01-17,09:49
045 Jardin de la Lironde,6,2,8,2022,01-17,09:49
046 P�re Soulas,1,7,8,2022,01-17,09:49
047 Place Viala,3,5,8,2022,01-17,09:49
048 H�tel du D�partement,1,7,8,2022,01-17,09:49
049 Tonnelles,0,8,8,2022,01-17,09:49
050 Parvis Jules Ferry - Gare Saint-Roch,3,5,8,2022,01-17,09:49
051 Pont de Lattes - Gare Saint-Roch,0,12,12,2022,01-17,09:49
053 Deux Ponts - Gare Saint-Roch,3,5,8,2022,01-17,09:49
054 Providence - Ovalie,3,5,8,2022,01-17,09:49
055 P�rols Etang de l'Or,26,42,68,2022,01-17,09:49
056 Albert 1er - Cath�drale,7,5,12,2022,01-17,09:49
057 Saint-Guilhem - Courreau,0,8,8,2022,01-17,09:49
059 Sud De France,0,8,8,2022,01-17,09:49
001 Rue Jules Ferry - Gare Saint-Roch,1,11,12,2022,01-17,09:59
002 Com�die,13,11,24,2022,01-17,09:59
003 Esplanade,17,15,32,2022,01-17,09:59
004 H�tel de Ville,13,3,16,2022,01-17,09:59
005 Corum,2,10,12,2022,01-17,09:59
006 Place Albert 1er - St Charles,20,11,31,2022,01-17,09:59
007 Foch,6,2,8,2022,01-17,09:59
008 Halles Castellane,8,4,12,2022,01-17,09:59
009 Observatoire,4,4,8,2022,01-17,09:59
010 Rondelet,4,12,16,2022,01-17,09:59
011 Plan Cabanes,3,9,12,2022,01-17,09:59
012 Boutonnet,2,10,12,2022,01-17,09:59
013 Emile Combes,6,2,8,2022,01-17,09:59
014 Beaux-Arts,5,3,8,2022,01-17,09:59
015 Les Aubes,6,2,8,2022,01-17,09:59
016 Antigone centre,6,10,16,2022,01-17,09:59
017 M�diath�que Emile Zola,8,8,16,2022,01-17,09:59
018 Nombre d'Or,5,11,16,2022,01-17,09:59
019 Louis Blanc,8,8,16,2022,01-17,09:59
020 Gambetta,0,8,8,2022,01-17,09:59
021 Port Marianne,5,11,16,2022,01-17,09:59
022 Clemenceau,2,10,12,2022,01-17,09:59
023 Les Arceaux,3,13,16,2022,01-17,09:59
024 Cit� Mion,3,5,8,2022,01-17,09:59
025 Nouveau Saint-Roch,2,6,8,2022,01-17,09:59
026 Renouvier,1,7,8,2022,01-17,09:59
027 Odysseum,4,4,8,2022,01-17,09:59
028 Saint-Denis,3,5,8,2022,01-17,09:59
029 Richter,12,4,16,2022,01-17,09:59
030 Charles Flahault,5,3,8,2022,01-17,09:59
031 Voltaire,2,6,8,2022,01-17,09:59
032 Pr�s d'Ar�nes,8,0,8,2022,01-17,09:59
033 Garcia Lorca,8,0,8,2022,01-17,09:59
034 Vert Bois,0,16,16,2022,01-17,09:59
035 Malbosc,1,7,8,2022,01-17,09:59
036 Occitanie,2,30,32,2022,01-17,09:59
037 FacdesSciences,16,8,24,2022,01-17,09:59
038 Fac de Lettres,7,9,16,2022,01-17,09:59
039 Aiguelongue,4,4,8,2022,01-17,09:59
040 Jeu de Mail des Abb�s,8,0,8,2022,01-17,09:59
041 Eurom�decine,1,7,8,2022,01-17,09:59
042 Marie Caizergues,1,7,8,2022,01-17,09:59
043 Sabines,1,7,8,2022,01-17,09:59
044 Celleneuve,4,4,8,2022,01-17,09:59
045 Jardin de la Lironde,6,2,8,2022,01-17,09:59
046 P�re Soulas,1,7,8,2022,01-17,09:59
047 Place Viala,3,5,8,2022,01-17,09:59
048 H�tel du D�partement,1,7,8,2022,01-17,09:59
049 Tonnelles,0,8,8,2022,01-17,09:59
050 Parvis Jules Ferry - Gare Saint-Roch,3,5,8,2022,01-17,09:59
051 Pont de Lattes - Gare Saint-Roch,0,12,12,2022,01-17,09:59
053 Deux Ponts - Gare Saint-Roch,3,5,8,2022,01-17,09:59
054 Providence - Ovalie,3,5,8,2022,01-17,09:59
055 P�rols Etang de l'Or,26,42,68,2022,01-17,09:59
056 Albert 1er - Cath�drale,7,5,12,2022,01-17,09:59
057 Saint-Guilhem - Courreau,0,8,8,2022,01-17,09:59
059 Sud De France,0,8,8,2022,01-17,09:59
001 Rue Jules Ferry - Gare Saint-Roch,1,11,12,2022,01-17,10:10
002 Com�die,13,11,24,2022,01-17,10:10
003 Esplanade,17,15,32,2022,01-17,10:10
004 H�tel de Ville,13,3,16,2022,01-17,10:10
005 Corum,3,9,12,2022,01-17,10:10
006 Place Albert 1er - St Charles,20,11,31,2022,01-17,10:10
007 Foch,6,2,8,2022,01-17,10:10
008 Halles Castellane,8,4,12,2022,01-17,10:10
009 Observatoire,4,4,8,2022,01-17,10:10
010 Rondelet,4,12,16,2022,01-17,10:10
011 Plan Cabanes,3,9,12,2022,01-17,10:10
012 Boutonnet,2,10,12,2022,01-17,10:10
013 Emile Combes,6,2,8,2022,01-17,10:10
014 Beaux-Arts,5,3,8,2022,01-17,10:10
015 Les Aubes,6,2,8,2022,01-17,10:10
016 Antigone centre,6,10,16,2022,01-17,10:10
017 M�diath�que Emile Zola,8,8,16,2022,01-17,10:10
018 Nombre d'Or,5,11,16,2022,01-17,10:10
019 Louis Blanc,8,8,16,2022,01-17,10:10
020 Gambetta,0,8,8,2022,01-17,10:10
021 Port Marianne,5,11,16,2022,01-17,10:10
022 Clemenceau,2,10,12,2022,01-17,10:10
023 Les Arceaux,3,13,16,2022,01-17,10:10
024 Cit� Mion,3,5,8,2022,01-17,10:10
025 Nouveau Saint-Roch,2,6,8,2022,01-17,10:10
026 Renouvier,1,7,8,2022,01-17,10:10
027 Odysseum,4,4,8,2022,01-17,10:10
028 Saint-Denis,3,5,8,2022,01-17,10:10
029 Richter,12,4,16,2022,01-17,10:10
030 Charles Flahault,5,3,8,2022,01-17,10:10
031 Voltaire,2,6,8,2022,01-17,10:10
032 Pr�s d'Ar�nes,8,0,8,2022,01-17,10:10
033 Garcia Lorca,8,0,8,2022,01-17,10:10
034 Vert Bois,0,16,16,2022,01-17,10:10
035 Malbosc,1,7,8,2022,01-17,10:10
036 Occitanie,2,30,32,2022,01-17,10:10
037 FacdesSciences,15,9,24,2022,01-17,10:10
038 Fac de Lettres,7,9,16,2022,01-17,10:10
039 Aiguelongue,4,4,8,2022,01-17,10:10
040 Jeu de Mail des Abb�s,8,0,8,2022,01-17,10:10
041 Eurom�decine,1,7,8,2022,01-17,10:10
042 Marie Caizergues,1,7,8,2022,01-17,10:10
043 Sabines,1,7,8,2022,01-17,10:10
044 Celleneuve,4,4,8,2022,01-17,10:10
045 Jardin de la Lironde,6,2,8,2022,01-17,10:10
046 P�re Soulas,1,7,8,2022,01-17,10:10
047 Place Viala,3,5,8,2022,01-17,10:10
048 H�tel du D�partement,1,7,8,2022,01-17,10:10
049 Tonnelles,0,8,8,2022,01-17,10:10
050 Parvis Jules Ferry - Gare Saint-Roch,3,5,8,2022,01-17,10:10
051 Pont de Lattes - Gare Saint-Roch,0,12,12,2022,01-17,10:10
053 Deux Ponts - Gare Saint-Roch,3,5,8,2022,01-17,10:10
054 Providence - Ovalie,3,5,8,2022,01-17,10:10
055 P�rols Etang de l'Or,26,42,68,2022,01-17,10:10
056 Albert 1er - Cath�drale,7,5,12,2022,01-17,10:10
057 Saint-Guilhem - Courreau,0,8,8,2022,01-17,10:10
059 Sud De France,0,8,8,2022,01-17,10:10
001 Rue Jules Ferry - Gare Saint-Roch,0,12,12,2022,01-17,10:20
002 Com�die,13,11,24,2022,01-17,10:20
003 Esplanade,17,15,32,2022,01-17,10:20
004 H�tel de Ville,13,3,16,2022,01-17,10:20
005 Corum,3,9,12,2022,01-17,10:20
006 Place Albert 1er - St Charles,20,11,31,2022,01-17,10:20
007 Foch,6,2,8,2022,01-17,10:20
008 Halles Castellane,8,4,12,2022,01-17,10:20
009 Observatoire,4,4,8,2022,01-17,10:20
010 Rondelet,4,12,16,2022,01-17,10:20
011 Plan Cabanes,3,9,12,2022,01-17,10:20
012 Boutonnet,2,10,12,2022,01-17,10:20
013 Emile Combes,6,2,8,2022,01-17,10:20
014 Beaux-Arts,5,3,8,2022,01-17,10:20
015 Les Aubes,6,2,8,2022,01-17,10:20
016 Antigone centre,6,10,16,2022,01-17,10:20
017 M�diath�que Emile Zola,7,9,16,2022,01-17,10:20
018 Nombre d'Or,5,11,16,2022,01-17,10:20
019 Louis Blanc,8,8,16,2022,01-17,10:20
020 Gambetta,0,8,8,2022,01-17,10:20
021 Port Marianne,5,11,16,2022,01-17,10:20
022 Clemenceau,2,10,12,2022,01-17,10:20
023 Les Arceaux,3,13,16,2022,01-17,10:20
024 Cit� Mion,3,5,8,2022,01-17,10:20
025 Nouveau Saint-Roch,2,6,8,2022,01-17,10:20
026 Renouvier,1,7,8,2022,01-17,10:20
027 Odysseum,4,4,8,2022,01-17,10:20
028 Saint-Denis,3,5,8,2022,01-17,10:20
029 Richter,12,4,16,2022,01-17,10:20
030 Charles Flahault,5,3,8,2022,01-17,10:20
031 Voltaire,2,6,8,2022,01-17,10:20
032 Pr�s d'Ar�nes,8,0,8,2022,01-17,10:20
033 Garcia Lorca,8,0,8,2022,01-17,10:20
034 Vert Bois,0,16,16,2022,01-17,10:20
035 Malbosc,1,7,8,2022,01-17,10:20
036 Occitanie,2,30,32,2022,01-17,10:20
037 FacdesSciences,15,9,24,2022,01-17,10:20
038 Fac de Lettres,7,9,16,2022,01-17,10:20
039 Aiguelongue,4,4,8,2022,01-17,10:20
040 Jeu de Mail des Abb�s,8,0,8,2022,01-17,10:20
041 Eurom�decine,1,7,8,2022,01-17,10:20
042 Marie Caizergues,1,7,8,2022,01-17,10:20
043 Sabines,1,7,8,2022,01-17,10:20
044 Celleneuve,4,4,8,2022,01-17,10:20
045 Jardin de la Lironde,6,2,8,2022,01-17,10:20
046 P�re Soulas,1,7,8,2022,01-17,10:20
047 Place Viala,2,6,8,2022,01-17,10:20
048 H�tel du D�partement,1,7,8,2022,01-17,10:20
049 Tonnelles,0,8,8,2022,01-17,10:20
050 Parvis Jules Ferry - Gare Saint-Roch,3,5,8,2022,01-17,10:20
051 Pont de Lattes - Gare Saint-Roch,0,12,12,2022,01-17,10:20
053 Deux Ponts - Gare Saint-Roch,3,5,8,2022,01-17,10:20
054 Providence - Ovalie,3,5,8,2022,01-17,10:20
055 P�rols Etang de l'Or,26,42,68,2022,01-17,10:20
056 Albert 1er - Cath�drale,7,5,12,2022,01-17,10:20
057 Saint-Guilhem - Courreau,0,8,8,2022,01-17,10:20
059 Sud De France,0,8,8,2022,01-17,10:20
001 Rue Jules Ferry - Gare Saint-Roch,0,12,12,2022,01-17,10:30
002 Com�die,13,11,24,2022,01-17,10:30
003 Esplanade,15,17,32,2022,01-17,10:30
004 H�tel de Ville,13,3,16,2022,01-17,10:30
005 Corum,4,8,12,2022,01-17,10:30
006 Place Albert 1er - St Charles,20,11,31,2022,01-17,10:30
007 Foch,6,2,8,2022,01-17,10:30
008 Halles Castellane,8,4,12,2022,01-17,10:30
009 Observatoire,4,4,8,2022,01-17,10:30
010 Rondelet,4,12,16,2022,01-17,10:30
011 Plan Cabanes,3,9,12,2022,01-17,10:30
012 Boutonnet,3,9,12,2022,01-17,10:30
013 Emile Combes,6,2,8,2022,01-17,10:30
014 Beaux-Arts,5,3,8,2022,01-17,10:30
015 Les Aubes,6,2,8,2022,01-17,10:30
016 Antigone centre,6,10,16,2022,01-17,10:30
017 M�diath�que Emile Zola,7,9,16,2022,01-17,10:30
018 Nombre d'Or,5,11,16,2022,01-17,10:30
019 Louis Blanc,8,8,16,2022,01-17,10:30
020 Gambetta,0,8,8,2022,01-17,10:30
021 Port Marianne,5,11,16,2022,01-17,10:30
022 Clemenceau,2,10,12,2022,01-17,10:30
023 Les Arceaux,3,13,16,2022,01-17,10:30
024 Cit� Mion,3,5,8,2022,01-17,10:30
025 Nouveau Saint-Roch,2,6,8,2022,01-17,10:30
026 Renouvier,1,7,8,2022,01-17,10:30
027 Odysseum,4,4,8,2022,01-17,10:30
028 Saint-Denis,3,5,8,2022,01-17,10:30
029 Richter,12,4,16,2022,01-17,10:30
030 Charles Flahault,5,3,8,2022,01-17,10:30
031 Voltaire,2,6,8,2022,01-17,10:30
032 Pr�s d'Ar�nes,8,0,8,2022,01-17,10:30
033 Garcia Lorca,8,0,8,2022,01-17,10:30
034 Vert Bois,0,16,16,2022,01-17,10:30
035 Malbosc,1,7,8,2022,01-17,10:30
036 Occitanie,2,30,32,2022,01-17,10:30
037 FacdesSciences,15,9,24,2022,01-17,10:30
038 Fac de Lettres,7,9,16,2022,01-17,10:30
039 Aiguelongue,4,4,8,2022,01-17,10:30
040 Jeu de Mail des Abb�s,8,0,8,2022,01-17,10:30
041 Eurom�decine,1,7,8,2022,01-17,10:30
042 Marie Caizergues,1,7,8,2022,01-17,10:30
043 Sabines,1,7,8,2022,01-17,10:30
044 Celleneuve,4,4,8,2022,01-17,10:30
045 Jardin de la Lironde,6,2,8,2022,01-17,10:30
046 P�re Soulas,1,7,8,2022,01-17,10:30
047 Place Viala,2,6,8,2022,01-17,10:30
048 H�tel du D�partement,1,7,8,2022,01-17,10:30
049 Tonnelles,0,8,8,2022,01-17,10:30
050 Parvis Jules Ferry - Gare Saint-Roch,3,5,8,2022,01-17,10:30
051 Pont de Lattes - Gare Saint-Roch,0,12,12,2022,01-17,10:30
053 Deux Ponts - Gare Saint-Roch,3,5,8,2022,01-17,10:30
054 Providence - Ovalie,3,5,8,2022,01-17,10:30
055 P�rols Etang de l'Or,26,42,68,2022,01-17,10:30
056 Albert 1er - Cath�drale,7,5,12,2022,01-17,10:30
057 Saint-Guilhem - Courreau,0,8,8,2022,01-17,10:30
059 Sud De France,0,8,8,2022,01-17,10:30
001 Rue Jules Ferry - Gare Saint-Roch,0,12,12,2022,01-17,10:40
002 Com�die,13,11,24,2022,01-17,10:40
003 Esplanade,15,17,32,2022,01-17,10:40
004 H�tel de Ville,14,2,16,2022,01-17,10:40
005 Corum,4,8,12,2022,01-17,10:40
006 Place Albert 1er - St Charles,20,11,31,2022,01-17,10:40
007 Foch,6,2,8,2022,01-17,10:40
008 Halles Castellane,8,4,12,2022,01-17,10:40
009 Observatoire,4,4,8,2022,01-17,10:40
010 Rondelet,4,12,16,2022,01-17,10:40
011 Plan Cabanes,3,9,12,2022,01-17,10:40
012 Boutonnet,4,8,12,2022,01-17,10:40
013 Emile Combes,6,2,8,2022,01-17,10:40
014 Beaux-Arts,5,3,8,2022,01-17,10:40
015 Les Aubes,6,2,8,2022,01-17,10:40
016 Antigone centre,6,10,16,2022,01-17,10:40
017 M�diath�que Emile Zola,7,9,16,2022,01-17,10:40
018 Nombre d'Or,5,11,16,2022,01-17,10:40
019 Louis Blanc,8,8,16,2022,01-17,10:40
020 Gambetta,0,8,8,2022,01-17,10:40
021 Port Marianne,5,11,16,2022,01-17,10:40
022 Clemenceau,2,10,12,2022,01-17,10:40
023 Les Arceaux,3,13,16,2022,01-17,10:40
024 Cit� Mion,3,5,8,2022,01-17,10:40
025 Nouveau Saint-Roch,2,6,8,2022,01-17,10:40
026 Renouvier,1,7,8,2022,01-17,10:40
027 Odysseum,4,4,8,2022,01-17,10:40
028 Saint-Denis,4,4,8,2022,01-17,10:40
029 Richter,12,4,16,2022,01-17,10:40
030 Charles Flahault,5,3,8,2022,01-17,10:40
031 Voltaire,1,7,8,2022,01-17,10:40
032 Pr�s d'Ar�nes,7,1,8,2022,01-17,10:40
033 Garcia Lorca,4,4,8,2022,01-17,10:40
034 Vert Bois,0,16,16,2022,01-17,10:40
035 Malbosc,1,7,8,2022,01-17,10:40
036 Occitanie,3,29,32,2022,01-17,10:40
037 FacdesSciences,13,11,24,2022,01-17,10:40
038 Fac de Lettres,7,9,16,2022,01-17,10:40
039 Aiguelongue,4,4,8,2022,01-17,10:40
040 Jeu de Mail des Abb�s,8,0,8,2022,01-17,10:40
041 Eurom�decine,1,7,8,2022,01-17,10:40
042 Marie Caizergues,1,7,8,2022,01-17,10:40
043 Sabines,1,7,8,2022,01-17,10:40
044 Celleneuve,4,4,8,2022,01-17,10:40
045 Jardin de la Lironde,6,2,8,2022,01-17,10:40
046 P�re Soulas,1,7,8,2022,01-17,10:40
047 Place Viala,1,7,8,2022,01-17,10:40
048 H�tel du D�partement,1,7,8,2022,01-17,10:40
049 Tonnelles,0,8,8,2022,01-17,10:40
050 Parvis Jules Ferry - Gare Saint-Roch,3,5,8,2022,01-17,10:40
051 Pont de Lattes - Gare Saint-Roch,0,12,12,2022,01-17,10:40
053 Deux Ponts - Gare Saint-Roch,3,5,8,2022,01-17,10:40
054 Providence - Ovalie,3,5,8,2022,01-17,10:40
055 P�rols Etang de l'Or,26,42,68,2022,01-17,10:40
056 Albert 1er - Cath�drale,7,5,12,2022,01-17,10:40
057 Saint-Guilhem - Courreau,0,8,8,2022,01-17,10:40
059 Sud De France,0,8,8,2022,01-17,10:40
001 Rue Jules Ferry - Gare Saint-Roch,0,12,12,2022,01-17,10:50
002 Com�die,13,11,24,2022,01-17,10:50
003 Esplanade,15,17,32,2022,01-17,10:50
004 H�tel de Ville,14,2,16,2022,01-17,10:50
005 Corum,5,7,12,2022,01-17,10:50
006 Place Albert 1er - St Charles,20,11,31,2022,01-17,10:50
007 Foch,6,2,8,2022,01-17,10:50
008 Halles Castellane,8,4,12,2022,01-17,10:50
009 Observatoire,5,3,8,2022,01-17,10:50
010 Rondelet,4,12,16,2022,01-17,10:50
011 Plan Cabanes,3,9,12,2022,01-17,10:50
012 Boutonnet,4,8,12,2022,01-17,10:50
013 Emile Combes,6,2,8,2022,01-17,10:50
014 Beaux-Arts,5,3,8,2022,01-17,10:50
015 Les Aubes,6,2,8,2022,01-17,10:50
016 Antigone centre,6,10,16,2022,01-17,10:50
017 M�diath�que Emile Zola,8,8,16,2022,01-17,10:50
018 Nombre d'Or,4,12,16,2022,01-17,10:50
019 Louis Blanc,8,8,16,2022,01-17,10:50
020 Gambetta,0,8,8,2022,01-17,10:50
021 Port Marianne,5,11,16,2022,01-17,10:50
022 Clemenceau,2,10,12,2022,01-17,10:50
023 Les Arceaux,3,13,16,2022,01-17,10:50
024 Cit� Mion,3,5,8,2022,01-17,10:50
025 Nouveau Saint-Roch,2,6,8,2022,01-17,10:50
026 Renouvier,1,7,8,2022,01-17,10:50
027 Odysseum,4,4,8,2022,01-17,10:50
028 Saint-Denis,4,4,8,2022,01-17,10:50
029 Richter,12,4,16,2022,01-17,10:50
030 Charles Flahault,5,3,8,2022,01-17,10:50
031 Voltaire,1,7,8,2022,01-17,10:50
032 Pr�s d'Ar�nes,7,1,8,2022,01-17,10:50
033 Garcia Lorca,4,4,8,2022,01-17,10:50
034 Vert Bois,0,16,16,2022,01-17,10:50
035 Malbosc,1,7,8,2022,01-17,10:50
036 Occitanie,3,29,32,2022,01-17,10:50
037 FacdesSciences,13,11,24,2022,01-17,10:50
038 Fac de Lettres,8,8,16,2022,01-17,10:50
039 Aiguelongue,4,4,8,2022,01-17,10:50
040 Jeu de Mail des Abb�s,8,0,8,2022,01-17,10:50
041 Eurom�decine,1,7,8,2022,01-17,10:50
042 Marie Caizergues,1,7,8,2022,01-17,10:50
043 Sabines,1,7,8,2022,01-17,10:50
044 Celleneuve,4,4,8,2022,01-17,10:50
045 Jardin de la Lironde,6,2,8,2022,01-17,10:50
046 P�re Soulas,1,7,8,2022,01-17,10:50
047 Place Viala,1,7,8,2022,01-17,10:50
048 H�tel du D�partement,1,7,8,2022,01-17,10:50
049 Tonnelles,0,8,8,2022,01-17,10:50
050 Parvis Jules Ferry - Gare Saint-Roch,3,5,8,2022,01-17,10:50
051 Pont de Lattes - Gare Saint-Roch,0,12,12,2022,01-17,10:50
053 Deux Ponts - Gare Saint-Roch,3,5,8,2022,01-17,10:50
054 Providence - Ovalie,3,5,8,2022,01-17,10:50
055 P�rols Etang de l'Or,26,42,68,2022,01-17,10:50
056 Albert 1er - Cath�drale,7,5,12,2022,01-17,10:50
057 Saint-Guilhem - Courreau,0,8,8,2022,01-17,10:50
059 Sud De France,0,8,8,2022,01-17,10:50
001 Rue Jules Ferry - Gare Saint-Roch,6,6,12,2022,01-17,11:00
002 Com�die,11,13,24,2022,01-17,11:00
003 Esplanade,15,17,32,2022,01-17,11:00
004 H�tel de Ville,13,3,16,2022,01-17,11:00
005 Corum,5,7,12,2022,01-17,11:00
006 Place Albert 1er - St Charles,20,11,31,2022,01-17,11:00
007 Foch,6,2,8,2022,01-17,11:00
008 Halles Castellane,8,4,12,2022,01-17,11:00
009 Observatoire,5,3,8,2022,01-17,11:00
010 Rondelet,4,12,16,2022,01-17,11:00
011 Plan Cabanes,3,9,12,2022,01-17,11:00
012 Boutonnet,5,7,12,2022,01-17,11:00
013 Emile Combes,6,2,8,2022,01-17,11:00
014 Beaux-Arts,5,3,8,2022,01-17,11:00
015 Les Aubes,6,2,8,2022,01-17,11:00
016 Antigone centre,6,10,16,2022,01-17,11:00
017 M�diath�que Emile Zola,8,8,16,2022,01-17,11:00
018 Nombre d'Or,3,13,16,2022,01-17,11:00
019 Louis Blanc,8,8,16,2022,01-17,11:00
020 Gambetta,0,8,8,2022,01-17,11:00
021 Port Marianne,5,11,16,2022,01-17,11:00
022 Clemenceau,2,10,12,2022,01-17,11:00
023 Les Arceaux,3,13,16,2022,01-17,11:00
024 Cit� Mion,3,5,8,2022,01-17,11:00
025 Nouveau Saint-Roch,2,6,8,2022,01-17,11:00
026 Renouvier,1,7,8,2022,01-17,11:00
027 Odysseum,4,4,8,2022,01-17,11:00
028 Saint-Denis,4,4,8,2022,01-17,11:00
029 Richter,12,4,16,2022,01-17,11:00
030 Charles Flahault,5,3,8,2022,01-17,11:00
031 Voltaire,1,7,8,2022,01-17,11:00
032 Pr�s d'Ar�nes,7,1,8,2022,01-17,11:00
033 Garcia Lorca,5,3,8,2022,01-17,11:00
034 Vert Bois,0,16,16,2022,01-17,11:00
035 Malbosc,1,7,8,2022,01-17,11:00
036 Occitanie,3,29,32,2022,01-17,11:00
037 FacdesSciences,13,11,24,2022,01-17,11:00
038 Fac de Lettres,8,8,16,2022,01-17,11:00
039 Aiguelongue,4,4,8,2022,01-17,11:00
040 Jeu de Mail des Abb�s,8,0,8,2022,01-17,11:00
041 Eurom�decine,1,7,8,2022,01-17,11:00
042 Marie Caizergues,1,7,8,2022,01-17,11:00
043 Sabines,1,7,8,2022,01-17,11:00
044 Celleneuve,4,4,8,2022,01-17,11:00
045 Jardin de la Lironde,6,2,8,2022,01-17,11:00
046 P�re Soulas,1,7,8,2022,01-17,11:00
047 Place Viala,1,7,8,2022,01-17,11:00
048 H�tel du D�partement,1,7,8,2022,01-17,11:00
049 Tonnelles,0,8,8,2022,01-17,11:00
050 Parvis Jules Ferry - Gare Saint-Roch,3,5,8,2022,01-17,11:00
051 Pont de Lattes - Gare Saint-Roch,0,12,12,2022,01-17,11:00
053 Deux Ponts - Gare Saint-Roch,3,5,8,2022,01-17,11:00
054 Providence - Ovalie,3,5,8,2022,01-17,11:00
055 P�rols Etang de l'Or,26,42,68,2022,01-17,11:00
056 Albert 1er - Cath�drale,7,5,12,2022,01-17,11:00
057 Saint-Guilhem - Courreau,0,8,8,2022,01-17,11:00
059 Sud De France,0,8,8,2022,01-17,11:00
001 Rue Jules Ferry - Gare Saint-Roch,6,6,12,2022,01-17,11:11
002 Com�die,11,13,24,2022,01-17,11:11
003 Esplanade,15,17,32,2022,01-17,11:11
004 H�tel de Ville,12,4,16,2022,01-17,11:11
005 Corum,5,7,12,2022,01-17,11:11
006 Place Albert 1er - St Charles,20,11,31,2022,01-17,11:11
007 Foch,6,2,8,2022,01-17,11:11
008 Halles Castellane,8,4,12,2022,01-17,11:11
009 Observatoire,5,3,8,2022,01-17,11:11
010 Rondelet,4,12,16,2022,01-17,11:11
011 Plan Cabanes,3,9,12,2022,01-17,11:11
012 Boutonnet,5,7,12,2022,01-17,11:11
013 Emile Combes,6,2,8,2022,01-17,11:11
014 Beaux-Arts,5,3,8,2022,01-17,11:11
015 Les Aubes,6,2,8,2022,01-17,11:11
016 Antigone centre,6,10,16,2022,01-17,11:11
017 M�diath�que Emile Zola,8,8,16,2022,01-17,11:11
018 Nombre d'Or,3,13,16,2022,01-17,11:11
019 Louis Blanc,8,8,16,2022,01-17,11:11
020 Gambetta,4,4,8,2022,01-17,11:11
021 Port Marianne,5,11,16,2022,01-17,11:11
022 Clemenceau,2,10,12,2022,01-17,11:11
023 Les Arceaux,2,14,16,2022,01-17,11:11
024 Cit� Mion,3,5,8,2022,01-17,11:11
025 Nouveau Saint-Roch,2,6,8,2022,01-17,11:11
026 Renouvier,1,7,8,2022,01-17,11:11
027 Odysseum,4,4,8,2022,01-17,11:11
028 Saint-Denis,4,4,8,2022,01-17,11:11
029 Richter,11,5,16,2022,01-17,11:11
030 Charles Flahault,5,3,8,2022,01-17,11:11
031 Voltaire,1,7,8,2022,01-17,11:11
032 Pr�s d'Ar�nes,7,1,8,2022,01-17,11:11
033 Garcia Lorca,5,3,8,2022,01-17,11:11
034 Vert Bois,0,16,16,2022,01-17,11:11
035 Malbosc,1,7,8,2022,01-17,11:11
036 Occitanie,3,29,32,2022,01-17,11:11
037 FacdesSciences,13,11,24,2022,01-17,11:11
038 Fac de Lettres,8,8,16,2022,01-17,11:11
039 Aiguelongue,4,4,8,2022,01-17,11:11
040 Jeu de Mail des Abb�s,8,0,8,2022,01-17,11:11
041 Eurom�decine,1,7,8,2022,01-17,11:11
042 Marie Caizergues,1,7,8,2022,01-17,11:11
043 Sabines,1,7,8,2022,01-17,11:11
044 Celleneuve,3,5,8,2022,01-17,11:11
045 Jardin de la Lironde,6,2,8,2022,01-17,11:11
046 P�re Soulas,1,7,8,2022,01-17,11:11
047 Place Viala,1,7,8,2022,01-17,11:11
048 H�tel du D�partement,1,7,8,2022,01-17,11:11
049 Tonnelles,0,8,8,2022,01-17,11:11
050 Parvis Jules Ferry - Gare Saint-Roch,3,5,8,2022,01-17,11:11
051 Pont de Lattes - Gare Saint-Roch,0,12,12,2022,01-17,11:11
053 Deux Ponts - Gare Saint-Roch,3,5,8,2022,01-17,11:11
054 Providence - Ovalie,3,5,8,2022,01-17,11:11
055 P�rols Etang de l'Or,26,42,68,2022,01-17,11:11
056 Albert 1er - Cath�drale,7,5,12,2022,01-17,11:11
057 Saint-Guilhem - Courreau,5,3,8,2022,01-17,11:11
059 Sud De France,0,8,8,2022,01-17,11:11
001 Rue Jules Ferry - Gare Saint-Roch,6,6,12,2022,01-17,11:21
002 Com�die,11,13,24,2022,01-17,11:21
003 Esplanade,14,18,32,2022,01-17,11:21
004 H�tel de Ville,12,4,16,2022,01-17,11:21
005 Corum,5,7,12,2022,01-17,11:21
006 Place Albert 1er - St Charles,12,19,31,2022,01-17,11:21
007 Foch,6,2,8,2022,01-17,11:21
008 Halles Castellane,8,4,12,2022,01-17,11:21
009 Observatoire,5,3,8,2022,01-17,11:21
010 Rondelet,4,12,16,2022,01-17,11:21
011 Plan Cabanes,2,10,12,2022,01-17,11:21
012 Boutonnet,5,7,12,2022,01-17,11:21
013 Emile Combes,6,2,8,2022,01-17,11:21
014 Beaux-Arts,5,3,8,2022,01-17,11:21
015 Les Aubes,6,2,8,2022,01-17,11:21
016 Antigone centre,7,9,16,2022,01-17,11:21
017 M�diath�que Emile Zola,10,6,16,2022,01-17,11:21
018 Nombre d'Or,3,13,16,2022,01-17,11:21
019 Louis Blanc,7,9,16,2022,01-17,11:21
020 Gambetta,5,3,8,2022,01-17,11:21
021 Port Marianne,5,11,16,2022,01-17,11:21
022 Clemenceau,2,10,12,2022,01-17,11:21
023 Les Arceaux,2,14,16,2022,01-17,11:21
024 Cit� Mion,3,5,8,2022,01-17,11:21
025 Nouveau Saint-Roch,2,6,8,2022,01-17,11:21
026 Renouvier,1,7,8,2022,01-17,11:21
027 Odysseum,4,4,8,2022,01-17,11:21
028 Saint-Denis,4,4,8,2022,01-17,11:21
029 Richter,11,5,16,2022,01-17,11:21
030 Charles Flahault,5,3,8,2022,01-17,11:21
031 Voltaire,1,7,8,2022,01-17,11:21
032 Pr�s d'Ar�nes,7,1,8,2022,01-17,11:21
033 Garcia Lorca,5,3,8,2022,01-17,11:21
034 Vert Bois,0,16,16,2022,01-17,11:21
035 Malbosc,1,7,8,2022,01-17,11:21
036 Occitanie,2,30,32,2022,01-17,11:21
037 FacdesSciences,14,10,24,2022,01-17,11:21
038 Fac de Lettres,8,8,16,2022,01-17,11:21
039 Aiguelongue,4,4,8,2022,01-17,11:21
040 Jeu de Mail des Abb�s,8,0,8,2022,01-17,11:21
041 Eurom�decine,1,7,8,2022,01-17,11:21
042 Marie Caizergues,1,7,8,2022,01-17,11:21
043 Sabines,1,7,8,2022,01-17,11:21
044 Celleneuve,3,5,8,2022,01-17,11:21
045 Jardin de la Lironde,6,2,8,2022,01-17,11:21
046 P�re Soulas,1,7,8,2022,01-17,11:21
047 Place Viala,1,7,8,2022,01-17,11:21
048 H�tel du D�partement,1,7,8,2022,01-17,11:21
049 Tonnelles,0,8,8,2022,01-17,11:21
050 Parvis Jules Ferry - Gare Saint-Roch,3,5,8,2022,01-17,11:21
051 Pont de Lattes - Gare Saint-Roch,0,12,12,2022,01-17,11:21
053 Deux Ponts - Gare Saint-Roch,3,5,8,2022,01-17,11:21
054 Providence - Ovalie,3,5,8,2022,01-17,11:21
055 P�rols Etang de l'Or,26,42,68,2022,01-17,11:21
056 Albert 1er - Cath�drale,7,5,12,2022,01-17,11:21
057 Saint-Guilhem - Courreau,5,3,8,2022,01-17,11:21
059 Sud De France,0,8,8,2022,01-17,11:21
001 Rue Jules Ferry - Gare Saint-Roch,6,6,12,2022,01-17,11:31
002 Com�die,11,13,24,2022,01-17,11:31
003 Esplanade,13,19,32,2022,01-17,11:31
004 H�tel de Ville,13,3,16,2022,01-17,11:31
005 Corum,5,7,12,2022,01-17,11:31
006 Place Albert 1er - St Charles,12,19,31,2022,01-17,11:31
007 Foch,6,2,8,2022,01-17,11:31
008 Halles Castellane,8,4,12,2022,01-17,11:31
009 Observatoire,5,3,8,2022,01-17,11:31
010 Rondelet,4,12,16,2022,01-17,11:31
011 Plan Cabanes,3,9,12,2022,01-17,11:31
012 Boutonnet,5,7,12,2022,01-17,11:31
013 Emile Combes,6,2,8,2022,01-17,11:31
014 Beaux-Arts,5,3,8,2022,01-17,11:31
015 Les Aubes,6,2,8,2022,01-17,11:31
016 Antigone centre,7,9,16,2022,01-17,11:31
017 M�diath�que Emile Zola,10,6,16,2022,01-17,11:31
018 Nombre d'Or,2,14,16,2022,01-17,11:31
019 Louis Blanc,7,9,16,2022,01-17,11:31
020 Gambetta,5,3,8,2022,01-17,11:31
021 Port Marianne,5,11,16,2022,01-17,11:31
022 Clemenceau,2,10,12,2022,01-17,11:31
023 Les Arceaux,2,14,16,2022,01-17,11:31
024 Cit� Mion,3,5,8,2022,01-17,11:31
025 Nouveau Saint-Roch,2,6,8,2022,01-17,11:31
026 Renouvier,1,7,8,2022,01-17,11:31
027 Odysseum,4,4,8,2022,01-17,11:31
028 Saint-Denis,4,4,8,2022,01-17,11:31
029 Richter,11,5,16,2022,01-17,11:31
030 Charles Flahault,5,3,8,2022,01-17,11:31
031 Voltaire,1,7,8,2022,01-17,11:31
032 Pr�s d'Ar�nes,7,1,8,2022,01-17,11:31
033 Garcia Lorca,5,3,8,2022,01-17,11:31
034 Vert Bois,0,16,16,2022,01-17,11:31
035 Malbosc,1,7,8,2022,01-17,11:31
036 Occitanie,2,30,32,2022,01-17,11:31
037 FacdesSciences,12,12,24,2022,01-17,11:31
038 Fac de Lettres,8,8,16,2022,01-17,11:31
039 Aiguelongue,4,4,8,2022,01-17,11:31
040 Jeu de Mail des Abb�s,8,0,8,2022,01-17,11:31
041 Eurom�decine,1,7,8,2022,01-17,11:31
042 Marie Caizergues,2,6,8,2022,01-17,11:31
043 Sabines,1,7,8,2022,01-17,11:31
044 Celleneuve,2,6,8,2022,01-17,11:31
045 Jardin de la Lironde,6,2,8,2022,01-17,11:31
046 P�re Soulas,1,7,8,2022,01-17,11:31
047 Place Viala,1,7,8,2022,01-17,11:31
048 H�tel du D�partement,1,7,8,2022,01-17,11:31
049 Tonnelles,0,8,8,2022,01-17,11:31
050 Parvis Jules Ferry - Gare Saint-Roch,2,6,8,2022,01-17,11:31
051 Pont de Lattes - Gare Saint-Roch,0,12,12,2022,01-17,11:31
053 Deux Ponts - Gare Saint-Roch,3,5,8,2022,01-17,11:31
054 Providence - Ovalie,3,5,8,2022,01-17,11:31
055 P�rols Etang de l'Or,26,42,68,2022,01-17,11:31
056 Albert 1er - Cath�drale,7,5,12,2022,01-17,11:31
057 Saint-Guilhem - Courreau,5,3,8,2022,01-17,11:31
059 Sud De France,0,8,8,2022,01-17,11:31
001 Rue Jules Ferry - Gare Saint-Roch,5,7,12,2022,01-17,11:41
002 Com�die,11,13,24,2022,01-17,11:41
003 Esplanade,13,19,32,2022,01-17,11:41
004 H�tel de Ville,13,3,16,2022,01-17,11:41
005 Corum,5,7,12,2022,01-17,11:41
006 Place Albert 1er - St Charles,12,19,31,2022,01-17,11:41
007 Foch,6,2,8,2022,01-17,11:41
008 Halles Castellane,8,4,12,2022,01-17,11:41
009 Observatoire,5,3,8,2022,01-17,11:41
010 Rondelet,4,12,16,2022,01-17,11:41
011 Plan Cabanes,3,9,12,2022,01-17,11:41
012 Boutonnet,6,6,12,2022,01-17,11:41
013 Emile Combes,6,2,8,2022,01-17,11:41
014 Beaux-Arts,5,3,8,2022,01-17,11:41
015 Les Aubes,6,2,8,2022,01-17,11:41
016 Antigone centre,7,9,16,2022,01-17,11:41
017 M�diath�que Emile Zola,10,6,16,2022,01-17,11:41
018 Nombre d'Or,2,14,16,2022,01-17,11:41
019 Louis Blanc,7,9,16,2022,01-17,11:41
020 Gambetta,5,3,8,2022,01-17,11:41
021 Port Marianne,5,11,16,2022,01-17,11:41
022 Clemenceau,2,10,12,2022,01-17,11:41
023 Les Arceaux,2,14,16,2022,01-17,11:41
024 Cit� Mion,3,5,8,2022,01-17,11:41
025 Nouveau Saint-Roch,2,6,8,2022,01-17,11:41
026 Renouvier,1,7,8,2022,01-17,11:41
027 Odysseum,4,4,8,2022,01-17,11:41
028 Saint-Denis,4,4,8,2022,01-17,11:41
029 Richter,11,5,16,2022,01-17,11:41
030 Charles Flahault,5,3,8,2022,01-17,11:41
031 Voltaire,1,7,8,2022,01-17,11:41
032 Pr�s d'Ar�nes,7,1,8,2022,01-17,11:41
033 Garcia Lorca,5,3,8,2022,01-17,11:41
034 Vert Bois,0,16,16,2022,01-17,11:41
035 Malbosc,1,7,8,2022,01-17,11:41
036 Occitanie,2,30,32,2022,01-17,11:41
037 FacdesSciences,12,12,24,2022,01-17,11:41
038 Fac de Lettres,7,9,16,2022,01-17,11:41
039 Aiguelongue,4,4,8,2022,01-17,11:41
040 Jeu de Mail des Abb�s,8,0,8,2022,01-17,11:41
041 Eurom�decine,1,7,8,2022,01-17,11:41
042 Marie Caizergues,1,7,8,2022,01-17,11:41
043 Sabines,1,7,8,2022,01-17,11:41
044 Celleneuve,2,6,8,2022,01-17,11:41
045 Jardin de la Lironde,6,2,8,2022,01-17,11:41
046 P�re Soulas,1,7,8,2022,01-17,11:41
047 Place Viala,1,7,8,2022,01-17,11:41
048 H�tel du D�partement,1,7,8,2022,01-17,11:41
049 Tonnelles,5,3,8,2022,01-17,11:41
050 Parvis Jules Ferry - Gare Saint-Roch,2,6,8,2022,01-17,11:41
051 Pont de Lattes - Gare Saint-Roch,0,12,12,2022,01-17,11:41
053 Deux Ponts - Gare Saint-Roch,3,5,8,2022,01-17,11:41
054 Providence - Ovalie,3,5,8,2022,01-17,11:41
055 P�rols Etang de l'Or,26,42,68,2022,01-17,11:41
056 Albert 1er - Cath�drale,7,5,12,2022,01-17,11:41
057 Saint-Guilhem - Courreau,5,3,8,2022,01-17,11:41
059 Sud De France,0,8,8,2022,01-17,11:41
001 Rue Jules Ferry - Gare Saint-Roch,5,7,12,2022,01-17,11:51
002 Com�die,11,13,24,2022,01-17,11:51
003 Esplanade,13,19,32,2022,01-17,11:51
004 H�tel de Ville,13,3,16,2022,01-17,11:51
005 Corum,5,7,12,2022,01-17,11:51
006 Place Albert 1er - St Charles,11,20,31,2022,01-17,11:51
007 Foch,6,2,8,2022,01-17,11:51
008 Halles Castellane,8,4,12,2022,01-17,11:51
009 Observatoire,5,3,8,2022,01-17,11:51
010 Rondelet,4,12,16,2022,01-17,11:51
011 Plan Cabanes,3,9,12,2022,01-17,11:51
012 Boutonnet,7,5,12,2022,01-17,11:51
013 Emile Combes,6,2,8,2022,01-17,11:51
014 Beaux-Arts,5,3,8,2022,01-17,11:51
015 Les Aubes,7,1,8,2022,01-17,11:51
016 Antigone centre,8,8,16,2022,01-17,11:51
017 M�diath�que Emile Zola,10,6,16,2022,01-17,11:51
018 Nombre d'Or,2,14,16,2022,01-17,11:51
019 Louis Blanc,7,9,16,2022,01-17,11:51
020 Gambetta,5,3,8,2022,01-17,11:51
021 Port Marianne,5,11,16,2022,01-17,11:51
022 Clemenceau,2,10,12,2022,01-17,11:51
023 Les Arceaux,2,14,16,2022,01-17,11:51
024 Cit� Mion,3,5,8,2022,01-17,11:51
025 Nouveau Saint-Roch,3,5,8,2022,01-17,11:51
026 Renouvier,1,7,8,2022,01-17,11:51
027 Odysseum,4,4,8,2022,01-17,11:51
028 Saint-Denis,4,4,8,2022,01-17,11:51
029 Richter,11,5,16,2022,01-17,11:51
030 Charles Flahault,5,3,8,2022,01-17,11:51
031 Voltaire,0,8,8,2022,01-17,11:51
032 Pr�s d'Ar�nes,7,1,8,2022,01-17,11:51
033 Garcia Lorca,5,3,8,2022,01-17,11:51
034 Vert Bois,0,16,16,2022,01-17,11:51
035 Malbosc,1,7,8,2022,01-17,11:51
036 Occitanie,1,31,32,2022,01-17,11:51
037 FacdesSciences,12,12,24,2022,01-17,11:51
038 Fac de Lettres,7,9,16,2022,01-17,11:51
039 Aiguelongue,4,4,8,2022,01-17,11:51
040 Jeu de Mail des Abb�s,8,0,8,2022,01-17,11:51
041 Eurom�decine,4,4,8,2022,01-17,11:51
042 Marie Caizergues,1,7,8,2022,01-17,11:51
043 Sabines,1,7,8,2022,01-17,11:51
044 Celleneuve,2,6,8,2022,01-17,11:51
045 Jardin de la Lironde,6,2,8,2022,01-17,11:51
046 P�re Soulas,1,7,8,2022,01-17,11:51
047 Place Viala,1,7,8,2022,01-17,11:51
048 H�tel du D�partement,1,7,8,2022,01-17,11:51
049 Tonnelles,5,3,8,2022,01-17,11:51
050 Parvis Jules Ferry - Gare Saint-Roch,3,5,8,2022,01-17,11:51
051 Pont de Lattes - Gare Saint-Roch,0,12,12,2022,01-17,11:51
053 Deux Ponts - Gare Saint-Roch,3,5,8,2022,01-17,11:51
054 Providence - Ovalie,3,5,8,2022,01-17,11:51
055 P�rols Etang de l'Or,26,42,68,2022,01-17,11:51
056 Albert 1er - Cath�drale,7,5,12,2022,01-17,11:51
057 Saint-Guilhem - Courreau,5,3,8,2022,01-17,11:51
059 Sud De France,0,8,8,2022,01-17,11:51
001 Rue Jules Ferry - Gare Saint-Roch,5,7,12,2022,01-17,12:01
002 Com�die,11,13,24,2022,01-17,12:01
003 Esplanade,13,19,32,2022,01-17,12:01
004 H�tel de Ville,13,3,16,2022,01-17,12:01
005 Corum,5,7,12,2022,01-17,12:01
006 Place Albert 1er - St Charles,10,21,31,2022,01-17,12:01
007 Foch,6,2,8,2022,01-17,12:01
008 Halles Castellane,9,3,12,2022,01-17,12:01
009 Observatoire,5,3,8,2022,01-17,12:01
010 Rondelet,4,12,16,2022,01-17,12:01
011 Plan Cabanes,2,10,12,2022,01-17,12:01
012 Boutonnet,7,5,12,2022,01-17,12:01
013 Emile Combes,6,2,8,2022,01-17,12:01
014 Beaux-Arts,5,3,8,2022,01-17,12:01
015 Les Aubes,7,1,8,2022,01-17,12:01
016 Antigone centre,8,8,16,2022,01-17,12:01
017 M�diath�que Emile Zola,10,6,16,2022,01-17,12:01
018 Nombre d'Or,2,14,16,2022,01-17,12:01
019 Louis Blanc,6,10,16,2022,01-17,12:01
020 Gambetta,5,3,8,2022,01-17,12:01
021 Port Marianne,5,11,16,2022,01-17,12:01
022 Clemenceau,2,10,12,2022,01-17,12:01
023 Les Arceaux,2,14,16,2022,01-17,12:01
024 Cit� Mion,2,6,8,2022,01-17,12:01
025 Nouveau Saint-Roch,3,5,8,2022,01-17,12:01
026 Renouvier,1,7,8,2022,01-17,12:01
027 Odysseum,4,4,8,2022,01-17,12:01
028 Saint-Denis,4,4,8,2022,01-17,12:01
029 Richter,11,5,16,2022,01-17,12:01
030 Charles Flahault,5,3,8,2022,01-17,12:01
031 Voltaire,0,8,8,2022,01-17,12:01
032 Pr�s d'Ar�nes,7,1,8,2022,01-17,12:01
033 Garcia Lorca,5,3,8,2022,01-17,12:01
034 Vert Bois,0,16,16,2022,01-17,12:01
035 Malbosc,1,7,8,2022,01-17,12:01
036 Occitanie,1,31,32,2022,01-17,12:01
037 FacdesSciences,12,12,24,2022,01-17,12:01
038 Fac de Lettres,7,9,16,2022,01-17,12:01
039 Aiguelongue,4,4,8,2022,01-17,12:01
040 Jeu de Mail des Abb�s,8,0,8,2022,01-17,12:01
041 Eurom�decine,4,4,8,2022,01-17,12:01
042 Marie Caizergues,1,7,8,2022,01-17,12:01
043 Sabines,1,7,8,2022,01-17,12:01
044 Celleneuve,2,6,8,2022,01-17,12:01
045 Jardin de la Lironde,6,2,8,2022,01-17,12:01
046 P�re Soulas,1,7,8,2022,01-17,12:01
047 Place Viala,1,7,8,2022,01-17,12:01
048 H�tel du D�partement,1,7,8,2022,01-17,12:01
049 Tonnelles,5,3,8,2022,01-17,12:01
050 Parvis Jules Ferry - Gare Saint-Roch,4,4,8,2022,01-17,12:01
051 Pont de Lattes - Gare Saint-Roch,0,12,12,2022,01-17,12:01
053 Deux Ponts - Gare Saint-Roch,3,5,8,2022,01-17,12:01
054 Providence - Ovalie,3,5,8,2022,01-17,12:01
055 P�rols Etang de l'Or,26,42,68,2022,01-17,12:01
056 Albert 1er - Cath�drale,7,5,12,2022,01-17,12:01
057 Saint-Guilhem - Courreau,5,3,8,2022,01-17,12:01
059 Sud De France,0,8,8,2022,01-17,12:01
001 Rue Jules Ferry - Gare Saint-Roch,5,7,12,2022,01-17,12:12
002 Com�die,11,13,24,2022,01-17,12:12
003 Esplanade,12,20,32,2022,01-17,12:12
004 H�tel de Ville,14,2,16,2022,01-17,12:12
005 Corum,5,7,12,2022,01-17,12:12
006 Place Albert 1er - St Charles,10,21,31,2022,01-17,12:12
007 Foch,6,2,8,2022,01-17,12:12
008 Halles Castellane,9,3,12,2022,01-17,12:12
009 Observatoire,6,2,8,2022,01-17,12:12
010 Rondelet,4,12,16,2022,01-17,12:12
011 Plan Cabanes,2,10,12,2022,01-17,12:12
012 Boutonnet,7,5,12,2022,01-17,12:12
013 Emile Combes,6,2,8,2022,01-17,12:12
014 Beaux-Arts,5,3,8,2022,01-17,12:12
015 Les Aubes,7,1,8,2022,01-17,12:12
016 Antigone centre,8,8,16,2022,01-17,12:12
017 M�diath�que Emile Zola,10,6,16,2022,01-17,12:12
018 Nombre d'Or,2,14,16,2022,01-17,12:12
019 Louis Blanc,6,10,16,2022,01-17,12:12
020 Gambetta,5,3,8,2022,01-17,12:12
021 Port Marianne,4,12,16,2022,01-17,12:12
022 Clemenceau,2,10,12,2022,01-17,12:12
023 Les Arceaux,1,15,16,2022,01-17,12:12
024 Cit� Mion,2,6,8,2022,01-17,12:12
025 Nouveau Saint-Roch,3,5,8,2022,01-17,12:12
026 Renouvier,1,7,8,2022,01-17,12:12
027 Odysseum,4,4,8,2022,01-17,12:12
028 Saint-Denis,4,4,8,2022,01-17,12:12
029 Richter,11,5,16,2022,01-17,12:12
030 Charles Flahault,6,2,8,2022,01-17,12:12
031 Voltaire,0,8,8,2022,01-17,12:12
032 Pr�s d'Ar�nes,6,2,8,2022,01-17,12:12
033 Garcia Lorca,5,3,8,2022,01-17,12:12
034 Vert Bois,0,16,16,2022,01-17,12:12
035 Malbosc,1,7,8,2022,01-17,12:12
036 Occitanie,2,30,32,2022,01-17,12:12
037 FacdesSciences,12,12,24,2022,01-17,12:12
038 Fac de Lettres,7,9,16,2022,01-17,12:12
039 Aiguelongue,4,4,8,2022,01-17,12:12
040 Jeu de Mail des Abb�s,8,0,8,2022,01-17,12:12
041 Eurom�decine,4,4,8,2022,01-17,12:12
042 Marie Caizergues,1,7,8,2022,01-17,12:12
043 Sabines,1,7,8,2022,01-17,12:12
044 Celleneuve,2,6,8,2022,01-17,12:12
045 Jardin de la Lironde,6,2,8,2022,01-17,12:12
046 P�re Soulas,1,7,8,2022,01-17,12:12
047 Place Viala,1,7,8,2022,01-17,12:12
048 H�tel du D�partement,1,7,8,2022,01-17,12:12
049 Tonnelles,5,3,8,2022,01-17,12:12
050 Parvis Jules Ferry - Gare Saint-Roch,4,4,8,2022,01-17,12:12
051 Pont de Lattes - Gare Saint-Roch,0,12,12,2022,01-17,12:12
053 Deux Ponts - Gare Saint-Roch,3,5,8,2022,01-17,12:12
054 Providence - Ovalie,3,5,8,2022,01-17,12:12
055 P�rols Etang de l'Or,26,42,68,2022,01-17,12:12
056 Albert 1er - Cath�drale,7,5,12,2022,01-17,12:12
057 Saint-Guilhem - Courreau,5,3,8,2022,01-17,12:12
059 Sud De France,0,8,8,2022,01-17,12:12
001 Rue Jules Ferry - Gare Saint-Roch,5,7,12,2022,01-17,12:22
002 Com�die,11,13,24,2022,01-17,12:22
003 Esplanade,11,21,32,2022,01-17,12:22
004 H�tel de Ville,13,3,16,2022,01-17,12:22
005 Corum,5,7,12,2022,01-17,12:22
006 Place Albert 1er - St Charles,10,21,31,2022,01-17,12:22
007 Foch,6,2,8,2022,01-17,12:22
008 Halles Castellane,9,3,12,2022,01-17,12:22
009 Observatoire,6,2,8,2022,01-17,12:22
010 Rondelet,4,12,16,2022,01-17,12:22
011 Plan Cabanes,3,9,12,2022,01-17,12:22
012 Boutonnet,7,5,12,2022,01-17,12:22
013 Emile Combes,6,2,8,2022,01-17,12:22
014 Beaux-Arts,5,3,8,2022,01-17,12:22
015 Les Aubes,7,1,8,2022,01-17,12:22
016 Antigone centre,8,8,16,2022,01-17,12:22
017 M�diath�que Emile Zola,10,6,16,2022,01-17,12:22
018 Nombre d'Or,2,14,16,2022,01-17,12:22
019 Louis Blanc,6,10,16,2022,01-17,12:22
020 Gambetta,5,3,8,2022,01-17,12:22
021 Port Marianne,4,12,16,2022,01-17,12:22
022 Clemenceau,2,10,12,2022,01-17,12:22
023 Les Arceaux,1,15,16,2022,01-17,12:22
024 Cit� Mion,2,6,8,2022,01-17,12:22
025 Nouveau Saint-Roch,3,5,8,2022,01-17,12:22
026 Renouvier,1,7,8,2022,01-17,12:22
027 Odysseum,4,4,8,2022,01-17,12:22
028 Saint-Denis,4,4,8,2022,01-17,12:22
029 Richter,9,7,16,2022,01-17,12:22
030 Charles Flahault,5,3,8,2022,01-17,12:22
031 Voltaire,0,8,8,2022,01-17,12:22
032 Pr�s d'Ar�nes,7,1,8,2022,01-17,12:22
033 Garcia Lorca,5,3,8,2022,01-17,12:22
034 Vert Bois,0,16,16,2022,01-17,12:22
035 Malbosc,1,7,8,2022,01-17,12:22
036 Occitanie,1,31,32,2022,01-17,12:22
037 FacdesSciences,12,12,24,2022,01-17,12:22
038 Fac de Lettres,7,9,16,2022,01-17,12:22
039 Aiguelongue,4,4,8,2022,01-17,12:22
040 Jeu de Mail des Abb�s,8,0,8,2022,01-17,12:22
041 Eurom�decine,4,4,8,2022,01-17,12:22
042 Marie Caizergues,1,7,8,2022,01-17,12:22
043 Sabines,1,7,8,2022,01-17,12:22
044 Celleneuve,2,6,8,2022,01-17,12:22
045 Jardin de la Lironde,7,1,8,2022,01-17,12:22
046 P�re Soulas,1,7,8,2022,01-17,12:22
047 Place Viala,1,7,8,2022,01-17,12:22
048 H�tel du D�partement,1,7,8,2022,01-17,12:22
049 Tonnelles,5,3,8,2022,01-17,12:22
050 Parvis Jules Ferry - Gare Saint-Roch,4,4,8,2022,01-17,12:22
051 Pont de Lattes - Gare Saint-Roch,0,12,12,2022,01-17,12:22
053 Deux Ponts - Gare Saint-Roch,3,5,8,2022,01-17,12:22
054 Providence - Ovalie,3,5,8,2022,01-17,12:22
055 P�rols Etang de l'Or,26,42,68,2022,01-17,12:22
056 Albert 1er - Cath�drale,7,5,12,2022,01-17,12:22
057 Saint-Guilhem - Courreau,5,3,8,2022,01-17,12:22
059 Sud De France,0,8,8,2022,01-17,12:22
001 Rue Jules Ferry - Gare Saint-Roch,5,7,12,2022,01-17,12:32
002 Com�die,11,13,24,2022,01-17,12:32
003 Esplanade,11,21,32,2022,01-17,12:32
004 H�tel de Ville,13,3,16,2022,01-17,12:32
005 Corum,5,7,12,2022,01-17,12:32
006 Place Albert 1er - St Charles,10,21,31,2022,01-17,12:32
007 Foch,6,2,8,2022,01-17,12:32
008 Halles Castellane,9,3,12,2022,01-17,12:32
009 Observatoire,6,2,8,2022,01-17,12:32
010 Rondelet,4,12,16,2022,01-17,12:32
011 Plan Cabanes,3,9,12,2022,01-17,12:32
012 Boutonnet,6,6,12,2022,01-17,12:32
013 Emile Combes,6,2,8,2022,01-17,12:32
014 Beaux-Arts,5,3,8,2022,01-17,12:32
015 Les Aubes,7,1,8,2022,01-17,12:32
016 Antigone centre,8,8,16,2022,01-17,12:32
017 M�diath�que Emile Zola,9,7,16,2022,01-17,12:32
018 Nombre d'Or,4,12,16,2022,01-17,12:32
019 Louis Blanc,6,10,16,2022,01-17,12:32
020 Gambetta,5,3,8,2022,01-17,12:32
021 Port Marianne,4,12,16,2022,01-17,12:32
022 Clemenceau,2,10,12,2022,01-17,12:32
023 Les Arceaux,1,15,16,2022,01-17,12:32
024 Cit� Mion,2,6,8,2022,01-17,12:32
025 Nouveau Saint-Roch,3,5,8,2022,01-17,12:32
026 Renouvier,1,7,8,2022,01-17,12:32
027 Odysseum,4,4,8,2022,01-17,12:32
028 Saint-Denis,4,4,8,2022,01-17,12:32
029 Richter,9,7,16,2022,01-17,12:32
030 Charles Flahault,5,3,8,2022,01-17,12:32
031 Voltaire,0,8,8,2022,01-17,12:32
032 Pr�s d'Ar�nes,7,1,8,2022,01-17,12:32
033 Garcia Lorca,5,3,8,2022,01-17,12:32
034 Vert Bois,0,16,16,2022,01-17,12:32
035 Malbosc,1,7,8,2022,01-17,12:32
036 Occitanie,1,31,32,2022,01-17,12:32
037 FacdesSciences,12,12,24,2022,01-17,12:32
038 Fac de Lettres,5,11,16,2022,01-17,12:32
039 Aiguelongue,4,4,8,2022,01-17,12:32
040 Jeu de Mail des Abb�s,8,0,8,2022,01-17,12:32
041 Eurom�decine,4,4,8,2022,01-17,12:32
042 Marie Caizergues,1,7,8,2022,01-17,12:32
043 Sabines,1,7,8,2022,01-17,12:32
044 Celleneuve,1,7,8,2022,01-17,12:32
045 Jardin de la Lironde,7,1,8,2022,01-17,12:32
046 P�re Soulas,1,7,8,2022,01-17,12:32
047 Place Viala,1,7,8,2022,01-17,12:32
048 H�tel du D�partement,1,7,8,2022,01-17,12:32
049 Tonnelles,5,3,8,2022,01-17,12:32
050 Parvis Jules Ferry - Gare Saint-Roch,4,4,8,2022,01-17,12:32
051 Pont de Lattes - Gare Saint-Roch,0,12,12,2022,01-17,12:32
053 Deux Ponts - Gare Saint-Roch,3,5,8,2022,01-17,12:32
054 Providence - Ovalie,3,5,8,2022,01-17,12:32
055 P�rols Etang de l'Or,26,42,68,2022,01-17,12:32
056 Albert 1er - Cath�drale,7,5,12,2022,01-17,12:32
057 Saint-Guilhem - Courreau,5,3,8,2022,01-17,12:32
059 Sud De France,0,8,8,2022,01-17,12:32
001 Rue Jules Ferry - Gare Saint-Roch,4,8,12,2022,01-17,12:42
002 Com�die,10,14,24,2022,01-17,12:42
003 Esplanade,11,21,32,2022,01-17,12:42
004 H�tel de Ville,13,3,16,2022,01-17,12:42
005 Corum,6,6,12,2022,01-17,12:42
006 Place Albert 1er - St Charles,10,21,31,2022,01-17,12:42
007 Foch,6,2,8,2022,01-17,12:42
008 Halles Castellane,8,4,12,2022,01-17,12:42
009 Observatoire,6,2,8,2022,01-17,12:42
010 Rondelet,4,12,16,2022,01-17,12:42
011 Plan Cabanes,3,9,12,2022,01-17,12:42
012 Boutonnet,7,5,12,2022,01-17,12:42
013 Emile Combes,6,2,8,2022,01-17,12:42
014 Beaux-Arts,5,3,8,2022,01-17,12:42
015 Les Aubes,7,1,8,2022,01-17,12:42
016 Antigone centre,8,8,16,2022,01-17,12:42
017 M�diath�que Emile Zola,9,7,16,2022,01-17,12:42
018 Nombre d'Or,4,12,16,2022,01-17,12:42
019 Louis Blanc,4,12,16,2022,01-17,12:42
020 Gambetta,5,3,8,2022,01-17,12:42
021 Port Marianne,5,11,16,2022,01-17,12:42
022 Clemenceau,2,10,12,2022,01-17,12:42
023 Les Arceaux,1,15,16,2022,01-17,12:42
024 Cit� Mion,2,6,8,2022,01-17,12:42
025 Nouveau Saint-Roch,5,3,8,2022,01-17,12:42
026 Renouvier,1,7,8,2022,01-17,12:42
027 Odysseum,4,4,8,2022,01-17,12:42
028 Saint-Denis,5,3,8,2022,01-17,12:42
029 Richter,9,7,16,2022,01-17,12:42
030 Charles Flahault,5,3,8,2022,01-17,12:42
031 Voltaire,0,8,8,2022,01-17,12:42
032 Pr�s d'Ar�nes,6,2,8,2022,01-17,12:42
033 Garcia Lorca,5,3,8,2022,01-17,12:42
034 Vert Bois,0,16,16,2022,01-17,12:42
035 Malbosc,1,7,8,2022,01-17,12:42
036 Occitanie,1,31,32,2022,01-17,12:42
037 FacdesSciences,15,9,24,2022,01-17,12:42
038 Fac de Lettres,5,11,16,2022,01-17,12:42
039 Aiguelongue,4,4,8,2022,01-17,12:42
040 Jeu de Mail des Abb�s,8,0,8,2022,01-17,12:42
041 Eurom�decine,4,4,8,2022,01-17,12:42
042 Marie Caizergues,1,7,8,2022,01-17,12:42
043 Sabines,1,7,8,2022,01-17,12:42
044 Celleneuve,1,7,8,2022,01-17,12:42
045 Jardin de la Lironde,7,1,8,2022,01-17,12:42
046 P�re Soulas,1,7,8,2022,01-17,12:42
047 Place Viala,1,7,8,2022,01-17,12:42
048 H�tel du D�partement,1,7,8,2022,01-17,12:42
049 Tonnelles,5,3,8,2022,01-17,12:42
050 Parvis Jules Ferry - Gare Saint-Roch,4,4,8,2022,01-17,12:42
051 Pont de Lattes - Gare Saint-Roch,1,11,12,2022,01-17,12:42
053 Deux Ponts - Gare Saint-Roch,3,5,8,2022,01-17,12:42
054 Providence - Ovalie,3,5,8,2022,01-17,12:42
055 P�rols Etang de l'Or,26,42,68,2022,01-17,12:42
056 Albert 1er - Cath�drale,7,5,12,2022,01-17,12:42
057 Saint-Guilhem - Courreau,5,3,8,2022,01-17,12:42
059 Sud De France,0,8,8,2022,01-17,12:42
001 Rue Jules Ferry - Gare Saint-Roch,4,8,12,2022,01-17,12:52
002 Com�die,10,14,24,2022,01-17,12:52
003 Esplanade,11,21,32,2022,01-17,12:52
004 H�tel de Ville,13,3,16,2022,01-17,12:52
005 Corum,6,6,12,2022,01-17,12:52
006 Place Albert 1er - St Charles,10,21,31,2022,01-17,12:52
007 Foch,6,2,8,2022,01-17,12:52
008 Halles Castellane,8,4,12,2022,01-17,12:52
009 Observatoire,6,2,8,2022,01-17,12:52
010 Rondelet,4,12,16,2022,01-17,12:52
011 Plan Cabanes,3,9,12,2022,01-17,12:52
012 Boutonnet,7,5,12,2022,01-17,12:52
013 Emile Combes,6,2,8,2022,01-17,12:52
014 Beaux-Arts,5,3,8,2022,01-17,12:52
015 Les Aubes,7,1,8,2022,01-17,12:52
016 Antigone centre,8,8,16,2022,01-17,12:52
017 M�diath�que Emile Zola,10,6,16,2022,01-17,12:52
018 Nombre d'Or,4,12,16,2022,01-17,12:52
019 Louis Blanc,4,12,16,2022,01-17,12:52
020 Gambetta,5,3,8,2022,01-17,12:52
021 Port Marianne,5,11,16,2022,01-17,12:52
022 Clemenceau,1,11,12,2022,01-17,12:52
023 Les Arceaux,1,15,16,2022,01-17,12:52
024 Cit� Mion,2,6,8,2022,01-17,12:52
025 Nouveau Saint-Roch,5,3,8,2022,01-17,12:52
026 Renouvier,1,7,8,2022,01-17,12:52
027 Odysseum,4,4,8,2022,01-17,12:52
028 Saint-Denis,5,3,8,2022,01-17,12:52
029 Richter,9,7,16,2022,01-17,12:52
030 Charles Flahault,5,3,8,2022,01-17,12:52
031 Voltaire,0,8,8,2022,01-17,12:52
032 Pr�s d'Ar�nes,6,2,8,2022,01-17,12:52
033 Garcia Lorca,5,3,8,2022,01-17,12:52
034 Vert Bois,0,16,16,2022,01-17,12:52
035 Malbosc,1,7,8,2022,01-17,12:52
036 Occitanie,1,31,32,2022,01-17,12:52
037 FacdesSciences,14,10,24,2022,01-17,12:52
038 Fac de Lettres,5,11,16,2022,01-17,12:52
039 Aiguelongue,4,4,8,2022,01-17,12:52
040 Jeu de Mail des Abb�s,8,0,8,2022,01-17,12:52
041 Eurom�decine,4,4,8,2022,01-17,12:52
042 Marie Caizergues,1,7,8,2022,01-17,12:52
043 Sabines,1,7,8,2022,01-17,12:52
044 Celleneuve,1,7,8,2022,01-17,12:52
045 Jardin de la Lironde,7,1,8,2022,01-17,12:52
046 P�re Soulas,1,7,8,2022,01-17,12:52
047 Place Viala,1,7,8,2022,01-17,12:52
048 H�tel du D�partement,1,7,8,2022,01-17,12:52
049 Tonnelles,5,3,8,2022,01-17,12:52
050 Parvis Jules Ferry - Gare Saint-Roch,4,4,8,2022,01-17,12:52
051 Pont de Lattes - Gare Saint-Roch,1,11,12,2022,01-17,12:52
053 Deux Ponts - Gare Saint-Roch,3,5,8,2022,01-17,12:52
054 Providence - Ovalie,3,5,8,2022,01-17,12:52
055 P�rols Etang de l'Or,26,42,68,2022,01-17,12:52
056 Albert 1er - Cath�drale,7,5,12,2022,01-17,12:52
057 Saint-Guilhem - Courreau,5,3,8,2022,01-17,12:52
059 Sud De France,0,8,8,2022,01-17,12:52
001 Rue Jules Ferry - Gare Saint-Roch,5,7,12,2022,01-17,13:03
002 Com�die,10,14,24,2022,01-17,13:03
003 Esplanade,10,22,32,2022,01-17,13:03
004 H�tel de Ville,13,3,16,2022,01-17,13:03
005 Corum,6,6,12,2022,01-17,13:03
006 Place Albert 1er - St Charles,10,21,31,2022,01-17,13:03
007 Foch,6,2,8,2022,01-17,13:03
008 Halles Castellane,8,4,12,2022,01-17,13:03
009 Observatoire,7,1,8,2022,01-17,13:03
010 Rondelet,4,12,16,2022,01-17,13:03
011 Plan Cabanes,3,9,12,2022,01-17,13:03
012 Boutonnet,6,6,12,2022,01-17,13:03
013 Emile Combes,7,1,8,2022,01-17,13:03
014 Beaux-Arts,5,3,8,2022,01-17,13:03
015 Les Aubes,7,1,8,2022,01-17,13:03
016 Antigone centre,8,8,16,2022,01-17,13:03
017 M�diath�que Emile Zola,11,5,16,2022,01-17,13:03
018 Nombre d'Or,4,12,16,2022,01-17,13:03
019 Louis Blanc,4,12,16,2022,01-17,13:03
020 Gambetta,5,3,8,2022,01-17,13:03
021 Port Marianne,5,11,16,2022,01-17,13:03
022 Clemenceau,1,11,12,2022,01-17,13:03
023 Les Arceaux,0,16,16,2022,01-17,13:03
024 Cit� Mion,2,6,8,2022,01-17,13:03
025 Nouveau Saint-Roch,5,3,8,2022,01-17,13:03
026 Renouvier,1,7,8,2022,01-17,13:03
027 Odysseum,4,4,8,2022,01-17,13:03
028 Saint-Denis,5,3,8,2022,01-17,13:03
029 Richter,9,7,16,2022,01-17,13:03
030 Charles Flahault,5,3,8,2022,01-17,13:03
031 Voltaire,0,8,8,2022,01-17,13:03
032 Pr�s d'Ar�nes,6,2,8,2022,01-17,13:03
033 Garcia Lorca,5,3,8,2022,01-17,13:03
034 Vert Bois,0,16,16,2022,01-17,13:03
035 Malbosc,1,7,8,2022,01-17,13:03
036 Occitanie,1,31,32,2022,01-17,13:03
037 FacdesSciences,14,10,24,2022,01-17,13:03
038 Fac de Lettres,6,10,16,2022,01-17,13:03
039 Aiguelongue,4,4,8,2022,01-17,13:03
040 Jeu de Mail des Abb�s,8,0,8,2022,01-17,13:03
041 Eurom�decine,4,4,8,2022,01-17,13:03
042 Marie Caizergues,1,7,8,2022,01-17,13:03
043 Sabines,1,7,8,2022,01-17,13:03
044 Celleneuve,1,7,8,2022,01-17,13:03
045 Jardin de la Lironde,7,1,8,2022,01-17,13:03
046 P�re Soulas,1,7,8,2022,01-17,13:03
047 Place Viala,1,7,8,2022,01-17,13:03
048 H�tel du D�partement,1,7,8,2022,01-17,13:03
049 Tonnelles,5,3,8,2022,01-17,13:03
050 Parvis Jules Ferry - Gare Saint-Roch,4,4,8,2022,01-17,13:03
051 Pont de Lattes - Gare Saint-Roch,1,11,12,2022,01-17,13:03
053 Deux Ponts - Gare Saint-Roch,3,5,8,2022,01-17,13:03
054 Providence - Ovalie,3,5,8,2022,01-17,13:03
055 P�rols Etang de l'Or,26,42,68,2022,01-17,13:03
056 Albert 1er - Cath�drale,7,5,12,2022,01-17,13:03
057 Saint-Guilhem - Courreau,5,3,8,2022,01-17,13:03
059 Sud De France,0,8,8,2022,01-17,13:03
001 Rue Jules Ferry - Gare Saint-Roch,5,7,12,2022,01-17,13:13
002 Com�die,10,14,24,2022,01-17,13:13
003 Esplanade,9,23,32,2022,01-17,13:13
004 H�tel de Ville,13,3,16,2022,01-17,13:13
005 Corum,6,6,12,2022,01-17,13:13
006 Place Albert 1er - St Charles,9,22,31,2022,01-17,13:13
007 Foch,5,3,8,2022,01-17,13:13
008 Halles Castellane,8,4,12,2022,01-17,13:13
009 Observatoire,7,1,8,2022,01-17,13:13
010 Rondelet,4,12,16,2022,01-17,13:13
011 Plan Cabanes,3,9,12,2022,01-17,13:13
012 Boutonnet,6,6,12,2022,01-17,13:13
013 Emile Combes,7,1,8,2022,01-17,13:13
014 Beaux-Arts,5,3,8,2022,01-17,13:13
015 Les Aubes,7,1,8,2022,01-17,13:13
016 Antigone centre,8,8,16,2022,01-17,13:13
017 M�diath�que Emile Zola,11,5,16,2022,01-17,13:13
018 Nombre d'Or,4,12,16,2022,01-17,13:13
019 Louis Blanc,5,11,16,2022,01-17,13:13
020 Gambetta,5,3,8,2022,01-17,13:13
021 Port Marianne,5,11,16,2022,01-17,13:13
022 Clemenceau,1,11,12,2022,01-17,13:13
023 Les Arceaux,0,16,16,2022,01-17,13:13
024 Cit� Mion,2,6,8,2022,01-17,13:13
025 Nouveau Saint-Roch,4,4,8,2022,01-17,13:13
026 Renouvier,1,7,8,2022,01-17,13:13
027 Odysseum,4,4,8,2022,01-17,13:13
028 Saint-Denis,4,4,8,2022,01-17,13:13
029 Richter,9,7,16,2022,01-17,13:13
030 Charles Flahault,5,3,8,2022,01-17,13:13
031 Voltaire,1,7,8,2022,01-17,13:13
032 Pr�s d'Ar�nes,6,2,8,2022,01-17,13:13
033 Garcia Lorca,5,3,8,2022,01-17,13:13
034 Vert Bois,0,16,16,2022,01-17,13:13
035 Malbosc,1,7,8,2022,01-17,13:13
036 Occitanie,1,31,32,2022,01-17,13:13
037 FacdesSciences,14,10,24,2022,01-17,13:13
038 Fac de Lettres,6,10,16,2022,01-17,13:13
039 Aiguelongue,4,4,8,2022,01-17,13:13
040 Jeu de Mail des Abb�s,8,0,8,2022,01-17,13:13
041 Eurom�decine,4,4,8,2022,01-17,13:13
042 Marie Caizergues,1,7,8,2022,01-17,13:13
043 Sabines,1,7,8,2022,01-17,13:13
044 Celleneuve,1,7,8,2022,01-17,13:13
045 Jardin de la Lironde,7,1,8,2022,01-17,13:13
046 P�re Soulas,2,6,8,2022,01-17,13:13
047 Place Viala,1,7,8,2022,01-17,13:13
048 H�tel du D�partement,1,7,8,2022,01-17,13:13
049 Tonnelles,5,3,8,2022,01-17,13:13
050 Parvis Jules Ferry - Gare Saint-Roch,6,2,8,2022,01-17,13:13
051 Pont de Lattes - Gare Saint-Roch,1,11,12,2022,01-17,13:13
053 Deux Ponts - Gare Saint-Roch,3,5,8,2022,01-17,13:13
054 Providence - Ovalie,3,5,8,2022,01-17,13:13
055 P�rols Etang de l'Or,26,42,68,2022,01-17,13:13
056 Albert 1er - Cath�drale,7,5,12,2022,01-17,13:13
057 Saint-Guilhem - Courreau,5,3,8,2022,01-17,13:13
059 Sud De France,0,8,8,2022,01-17,13:13
001 Rue Jules Ferry - Gare Saint-Roch,5,7,12,2022,01-17,13:23
002 Com�die,10,14,24,2022,01-17,13:23
003 Esplanade,9,23,32,2022,01-17,13:23
004 H�tel de Ville,14,2,16,2022,01-17,13:23
005 Corum,6,6,12,2022,01-17,13:23
006 Place Albert 1er - St Charles,9,22,31,2022,01-17,13:23
007 Foch,5,3,8,2022,01-17,13:23
008 Halles Castellane,8,4,12,2022,01-17,13:23
009 Observatoire,7,1,8,2022,01-17,13:23
010 Rondelet,2,14,16,2022,01-17,13:23
011 Plan Cabanes,2,10,12,2022,01-17,13:23
012 Boutonnet,6,6,12,2022,01-17,13:23
013 Emile Combes,7,1,8,2022,01-17,13:23
014 Beaux-Arts,5,3,8,2022,01-17,13:23
015 Les Aubes,7,1,8,2022,01-17,13:23
016 Antigone centre,10,6,16,2022,01-17,13:23
017 M�diath�que Emile Zola,11,5,16,2022,01-17,13:23
018 Nombre d'Or,4,12,16,2022,01-17,13:23
019 Louis Blanc,5,11,16,2022,01-17,13:23
020 Gambetta,5,3,8,2022,01-17,13:23
021 Port Marianne,5,11,16,2022,01-17,13:23
022 Clemenceau,1,11,12,2022,01-17,13:23
023 Les Arceaux,0,16,16,2022,01-17,13:23
024 Cit� Mion,2,6,8,2022,01-17,13:23
025 Nouveau Saint-Roch,4,4,8,2022,01-17,13:23
026 Renouvier,1,7,8,2022,01-17,13:23
027 Odysseum,5,3,8,2022,01-17,13:23
028 Saint-Denis,4,4,8,2022,01-17,13:23
029 Richter,9,7,16,2022,01-17,13:23
030 Charles Flahault,5,3,8,2022,01-17,13:23
031 Voltaire,1,7,8,2022,01-17,13:23
032 Pr�s d'Ar�nes,6,2,8,2022,01-17,13:23
033 Garcia Lorca,5,3,8,2022,01-17,13:23
034 Vert Bois,0,16,16,2022,01-17,13:23
035 Malbosc,1,7,8,2022,01-17,13:23
036 Occitanie,1,31,32,2022,01-17,13:23
037 FacdesSciences,11,13,24,2022,01-17,13:23
038 Fac de Lettres,7,9,16,2022,01-17,13:23
039 Aiguelongue,4,4,8,2022,01-17,13:23
040 Jeu de Mail des Abb�s,8,0,8,2022,01-17,13:23
041 Eurom�decine,4,4,8,2022,01-17,13:23
042 Marie Caizergues,1,7,8,2022,01-17,13:23
043 Sabines,1,7,8,2022,01-17,13:23
044 Celleneuve,1,7,8,2022,01-17,13:23
045 Jardin de la Lironde,7,1,8,2022,01-17,13:23
046 P�re Soulas,2,6,8,2022,01-17,13:23
047 Place Viala,1,7,8,2022,01-17,13:23
048 H�tel du D�partement,1,7,8,2022,01-17,13:23
049 Tonnelles,5,3,8,2022,01-17,13:23
050 Parvis Jules Ferry - Gare Saint-Roch,6,2,8,2022,01-17,13:23
051 Pont de Lattes - Gare Saint-Roch,1,11,12,2022,01-17,13:23
053 Deux Ponts - Gare Saint-Roch,3,5,8,2022,01-17,13:23
054 Providence - Ovalie,3,5,8,2022,01-17,13:23
055 P�rols Etang de l'Or,26,42,68,2022,01-17,13:23
056 Albert 1er - Cath�drale,7,5,12,2022,01-17,13:23
057 Saint-Guilhem - Courreau,5,3,8,2022,01-17,13:23
059 Sud De France,0,8,8,2022,01-17,13:23
001 Rue Jules Ferry - Gare Saint-Roch,5,7,12,2022,01-17,13:33
002 Com�die,10,14,24,2022,01-17,13:33
003 Esplanade,9,23,32,2022,01-17,13:33
004 H�tel de Ville,14,2,16,2022,01-17,13:33
005 Corum,5,7,12,2022,01-17,13:33
006 Place Albert 1er - St Charles,9,22,31,2022,01-17,13:33
007 Foch,5,3,8,2022,01-17,13:33
008 Halles Castellane,8,4,12,2022,01-17,13:33
009 Observatoire,7,1,8,2022,01-17,13:33
010 Rondelet,2,14,16,2022,01-17,13:33
011 Plan Cabanes,2,10,12,2022,01-17,13:33
012 Boutonnet,6,6,12,2022,01-17,13:33
013 Emile Combes,7,1,8,2022,01-17,13:33
014 Beaux-Arts,5,3,8,2022,01-17,13:33
015 Les Aubes,6,1,8,2022,01-17,13:33
016 Antigone centre,10,6,16,2022,01-17,13:33
017 M�diath�que Emile Zola,11,5,16,2022,01-17,13:33
018 Nombre d'Or,4,12,16,2022,01-17,13:33
019 Louis Blanc,5,11,16,2022,01-17,13:33
020 Gambetta,5,3,8,2022,01-17,13:33
021 Port Marianne,5,11,16,2022,01-17,13:33
022 Clemenceau,1,11,12,2022,01-17,13:33
023 Les Arceaux,0,16,16,2022,01-17,13:33
024 Cit� Mion,2,6,8,2022,01-17,13:33
025 Nouveau Saint-Roch,5,3,8,2022,01-17,13:33
026 Renouvier,1,7,8,2022,01-17,13:33
027 Odysseum,5,3,8,2022,01-17,13:33
028 Saint-Denis,3,5,8,2022,01-17,13:33
029 Richter,10,6,16,2022,01-17,13:33
030 Charles Flahault,5,3,8,2022,01-17,13:33
031 Voltaire,1,7,8,2022,01-17,13:33
032 Pr�s d'Ar�nes,6,2,8,2022,01-17,13:33
033 Garcia Lorca,4,4,8,2022,01-17,13:33
034 Vert Bois,0,16,16,2022,01-17,13:33
035 Malbosc,1,7,8,2022,01-17,13:33
036 Occitanie,1,31,32,2022,01-17,13:33
037 FacdesSciences,11,13,24,2022,01-17,13:33
038 Fac de Lettres,7,9,16,2022,01-17,13:33
039 Aiguelongue,5,3,8,2022,01-17,13:33
040 Jeu de Mail des Abb�s,8,0,8,2022,01-17,13:33
041 Eurom�decine,4,4,8,2022,01-17,13:33
042 Marie Caizergues,1,7,8,2022,01-17,13:33
043 Sabines,1,7,8,2022,01-17,13:33
044 Celleneuve,1,7,8,2022,01-17,13:33
045 Jardin de la Lironde,7,1,8,2022,01-17,13:33
046 P�re Soulas,2,6,8,2022,01-17,13:33
047 Place Viala,1,7,8,2022,01-17,13:33
048 H�tel du D�partement,1,7,8,2022,01-17,13:33
049 Tonnelles,5,3,8,2022,01-17,13:33
050 Parvis Jules Ferry - Gare Saint-Roch,6,2,8,2022,01-17,13:33
051 Pont de Lattes - Gare Saint-Roch,1,11,12,2022,01-17,13:33
053 Deux Ponts - Gare Saint-Roch,3,5,8,2022,01-17,13:33
054 Providence - Ovalie,3,5,8,2022,01-17,13:33
055 P�rols Etang de l'Or,25,43,68,2022,01-17,13:33
056 Albert 1er - Cath�drale,7,5,12,2022,01-17,13:33
057 Saint-Guilhem - Courreau,5,3,8,2022,01-17,13:33
059 Sud De France,0,8,8,2022,01-17,13:33
001 Rue Jules Ferry - Gare Saint-Roch,5,7,12,2022,01-17,13:43
002 Com�die,10,14,24,2022,01-17,13:43
003 Esplanade,10,22,32,2022,01-17,13:43
004 H�tel de Ville,14,2,16,2022,01-17,13:43
005 Corum,5,7,12,2022,01-17,13:43
006 Place Albert 1er - St Charles,9,22,31,2022,01-17,13:43
007 Foch,5,3,8,2022,01-17,13:43
008 Halles Castellane,8,4,12,2022,01-17,13:43
009 Observatoire,7,1,8,2022,01-17,13:43
010 Rondelet,2,14,16,2022,01-17,13:43
011 Plan Cabanes,2,10,12,2022,01-17,13:43
012 Boutonnet,6,6,12,2022,01-17,13:43
013 Emile Combes,7,1,8,2022,01-17,13:43
014 Beaux-Arts,5,3,8,2022,01-17,13:43
015 Les Aubes,6,1,8,2022,01-17,13:43
016 Antigone centre,10,6,16,2022,01-17,13:43
017 M�diath�que Emile Zola,11,5,16,2022,01-17,13:43
018 Nombre d'Or,4,12,16,2022,01-17,13:43
019 Louis Blanc,5,11,16,2022,01-17,13:43
020 Gambetta,5,3,8,2022,01-17,13:43
021 Port Marianne,5,11,16,2022,01-17,13:43
022 Clemenceau,1,11,12,2022,01-17,13:43
023 Les Arceaux,0,16,16,2022,01-17,13:43
024 Cit� Mion,2,6,8,2022,01-17,13:43
025 Nouveau Saint-Roch,5,3,8,2022,01-17,13:43
026 Renouvier,1,7,8,2022,01-17,13:43
027 Odysseum,5,3,8,2022,01-17,13:43
028 Saint-Denis,3,5,8,2022,01-17,13:43
029 Richter,10,6,16,2022,01-17,13:43
030 Charles Flahault,5,3,8,2022,01-17,13:43
031 Voltaire,1,7,8,2022,01-17,13:43
032 Pr�s d'Ar�nes,6,2,8,2022,01-17,13:43
033 Garcia Lorca,4,4,8,2022,01-17,13:43
034 Vert Bois,0,16,16,2022,01-17,13:43
035 Malbosc,1,7,8,2022,01-17,13:43
036 Occitanie,4,28,32,2022,01-17,13:43
037 FacdesSciences,9,15,24,2022,01-17,13:43
038 Fac de Lettres,8,8,16,2022,01-17,13:43
039 Aiguelongue,5,3,8,2022,01-17,13:43
040 Jeu de Mail des Abb�s,8,0,8,2022,01-17,13:43
041 Eurom�decine,4,4,8,2022,01-17,13:43
042 Marie Caizergues,1,7,8,2022,01-17,13:43
043 Sabines,1,7,8,2022,01-17,13:43
044 Celleneuve,1,7,8,2022,01-17,13:43
045 Jardin de la Lironde,7,1,8,2022,01-17,13:43
046 P�re Soulas,2,6,8,2022,01-17,13:43
047 Place Viala,1,7,8,2022,01-17,13:43
048 H�tel du D�partement,1,7,8,2022,01-17,13:43
049 Tonnelles,5,3,8,2022,01-17,13:43
050 Parvis Jules Ferry - Gare Saint-Roch,6,2,8,2022,01-17,13:43
051 Pont de Lattes - Gare Saint-Roch,1,11,12,2022,01-17,13:43
053 Deux Ponts - Gare Saint-Roch,3,5,8,2022,01-17,13:43
054 Providence - Ovalie,3,5,8,2022,01-17,13:43
055 P�rols Etang de l'Or,25,43,68,2022,01-17,13:43
056 Albert 1er - Cath�drale,7,5,12,2022,01-17,13:43
057 Saint-Guilhem - Courreau,5,3,8,2022,01-17,13:43
059 Sud De France,0,8,8,2022,01-17,13:43
001 Rue Jules Ferry - Gare Saint-Roch,5,7,12,2022,01-17,13:53
002 Com�die,10,14,24,2022,01-17,13:53
003 Esplanade,11,21,32,2022,01-17,13:53
004 H�tel de Ville,14,2,16,2022,01-17,13:53
005 Corum,5,7,12,2022,01-17,13:53
006 Place Albert 1er - St Charles,9,22,31,2022,01-17,13:53
007 Foch,3,5,8,2022,01-17,13:53
008 Halles Castellane,8,4,12,2022,01-17,13:53
009 Observatoire,7,1,8,2022,01-17,13:53
010 Rondelet,2,14,16,2022,01-17,13:53
011 Plan Cabanes,2,10,12,2022,01-17,13:53
012 Boutonnet,5,7,12,2022,01-17,13:53
013 Emile Combes,7,1,8,2022,01-17,13:53
014 Beaux-Arts,5,3,8,2022,01-17,13:53
015 Les Aubes,6,1,8,2022,01-17,13:53
016 Antigone centre,10,6,16,2022,01-17,13:53
017 M�diath�que Emile Zola,11,5,16,2022,01-17,13:53
018 Nombre d'Or,4,12,16,2022,01-17,13:53
019 Louis Blanc,4,12,16,2022,01-17,13:53
020 Gambetta,5,3,8,2022,01-17,13:53
021 Port Marianne,4,12,16,2022,01-17,13:53
022 Clemenceau,1,11,12,2022,01-17,13:53
023 Les Arceaux,0,16,16,2022,01-17,13:53
024 Cit� Mion,2,6,8,2022,01-17,13:53
025 Nouveau Saint-Roch,5,3,8,2022,01-17,13:53
026 Renouvier,1,7,8,2022,01-17,13:53
027 Odysseum,5,3,8,2022,01-17,13:53
028 Saint-Denis,3,5,8,2022,01-17,13:53
029 Richter,11,5,16,2022,01-17,13:53
030 Charles Flahault,5,3,8,2022,01-17,13:53
031 Voltaire,2,6,8,2022,01-17,13:53
032 Pr�s d'Ar�nes,6,2,8,2022,01-17,13:53
033 Garcia Lorca,4,4,8,2022,01-17,13:53
034 Vert Bois,0,16,16,2022,01-17,13:53
035 Malbosc,1,7,8,2022,01-17,13:53
036 Occitanie,5,27,32,2022,01-17,13:53
037 FacdesSciences,8,16,24,2022,01-17,13:53
038 Fac de Lettres,8,8,16,2022,01-17,13:53
039 Aiguelongue,5,3,8,2022,01-17,13:53
040 Jeu de Mail des Abb�s,8,0,8,2022,01-17,13:53
041 Eurom�decine,4,4,8,2022,01-17,13:53
042 Marie Caizergues,0,8,8,2022,01-17,13:53
043 Sabines,1,7,8,2022,01-17,13:53
044 Celleneuve,2,6,8,2022,01-17,13:53
045 Jardin de la Lironde,7,1,8,2022,01-17,13:53
046 P�re Soulas,3,5,8,2022,01-17,13:53
047 Place Viala,1,7,8,2022,01-17,13:53
048 H�tel du D�partement,1,7,8,2022,01-17,13:53
049 Tonnelles,5,3,8,2022,01-17,13:53
050 Parvis Jules Ferry - Gare Saint-Roch,6,2,8,2022,01-17,13:53
051 Pont de Lattes - Gare Saint-Roch,1,11,12,2022,01-17,13:53
053 Deux Ponts - Gare Saint-Roch,3,5,8,2022,01-17,13:53
054 Providence - Ovalie,3,5,8,2022,01-17,13:53
055 P�rols Etang de l'Or,25,43,68,2022,01-17,13:53
056 Albert 1er - Cath�drale,7,5,12,2022,01-17,13:53
057 Saint-Guilhem - Courreau,5,3,8,2022,01-17,13:53
059 Sud De France,0,8,8,2022,01-17,13:53
001 Rue Jules Ferry - Gare Saint-Roch,5,7,12,2022,01-17,14:04
002 Com�die,10,14,24,2022,01-17,14:04
003 Esplanade,13,19,32,2022,01-17,14:04
004 H�tel de Ville,14,2,16,2022,01-17,14:04
005 Corum,6,6,12,2022,01-17,14:04
006 Place Albert 1er - St Charles,9,22,31,2022,01-17,14:04
007 Foch,1,7,8,2022,01-17,14:04
008 Halles Castellane,8,4,12,2022,01-17,14:04
009 Observatoire,7,1,8,2022,01-17,14:04
010 Rondelet,2,14,16,2022,01-17,14:04
011 Plan Cabanes,2,10,12,2022,01-17,14:04
012 Boutonnet,5,7,12,2022,01-17,14:04
013 Emile Combes,7,1,8,2022,01-17,14:04
014 Beaux-Arts,5,3,8,2022,01-17,14:04
015 Les Aubes,6,1,8,2022,01-17,14:04
016 Antigone centre,9,7,16,2022,01-17,14:04
017 M�diath�que Emile Zola,11,5,16,2022,01-17,14:04
018 Nombre d'Or,5,11,16,2022,01-17,14:04
019 Louis Blanc,4,12,16,2022,01-17,14:04
020 Gambetta,5,3,8,2022,01-17,14:04
021 Port Marianne,4,12,16,2022,01-17,14:04
022 Clemenceau,1,11,12,2022,01-17,14:04
023 Les Arceaux,0,16,16,2022,01-17,14:04
024 Cit� Mion,2,6,8,2022,01-17,14:04
025 Nouveau Saint-Roch,5,3,8,2022,01-17,14:04
026 Renouvier,1,7,8,2022,01-17,14:04
027 Odysseum,5,3,8,2022,01-17,14:04
028 Saint-Denis,3,5,8,2022,01-17,14:04
029 Richter,12,4,16,2022,01-17,14:04
030 Charles Flahault,5,3,8,2022,01-17,14:04
031 Voltaire,2,6,8,2022,01-17,14:04
032 Pr�s d'Ar�nes,6,2,8,2022,01-17,14:04
033 Garcia Lorca,5,3,8,2022,01-17,14:04
034 Vert Bois,0,16,16,2022,01-17,14:04
035 Malbosc,1,7,8,2022,01-17,14:04
036 Occitanie,5,27,32,2022,01-17,14:04
037 FacdesSciences,8,16,24,2022,01-17,14:04
038 Fac de Lettres,8,8,16,2022,01-17,14:04
039 Aiguelongue,5,3,8,2022,01-17,14:04
040 Jeu de Mail des Abb�s,8,0,8,2022,01-17,14:04
041 Eurom�decine,4,4,8,2022,01-17,14:04
042 Marie Caizergues,0,8,8,2022,01-17,14:04
043 Sabines,1,7,8,2022,01-17,14:04
044 Celleneuve,1,7,8,2022,01-17,14:04
045 Jardin de la Lironde,7,1,8,2022,01-17,14:04
046 P�re Soulas,4,4,8,2022,01-17,14:04
047 Place Viala,1,7,8,2022,01-17,14:04
048 H�tel du D�partement,1,7,8,2022,01-17,14:04
049 Tonnelles,5,3,8,2022,01-17,14:04
050 Parvis Jules Ferry - Gare Saint-Roch,6,2,8,2022,01-17,14:04
051 Pont de Lattes - Gare Saint-Roch,1,11,12,2022,01-17,14:04
053 Deux Ponts - Gare Saint-Roch,3,5,8,2022,01-17,14:04
054 Providence - Ovalie,3,5,8,2022,01-17,14:04
055 P�rols Etang de l'Or,24,44,68,2022,01-17,14:04
056 Albert 1er - Cath�drale,6,6,12,2022,01-17,14:04
057 Saint-Guilhem - Courreau,3,5,8,2022,01-17,14:04
059 Sud De France,0,8,8,2022,01-17,14:04
001 Rue Jules Ferry - Gare Saint-Roch,6,6,12,2022,01-17,14:14
002 Com�die,10,14,24,2022,01-17,14:14
003 Esplanade,14,18,32,2022,01-17,14:14
004 H�tel de Ville,14,2,16,2022,01-17,14:14
005 Corum,6,6,12,2022,01-17,14:14
006 Place Albert 1er - St Charles,9,22,31,2022,01-17,14:14
007 Foch,1,7,8,2022,01-17,14:14
008 Halles Castellane,8,4,12,2022,01-17,14:14
009 Observatoire,7,1,8,2022,01-17,14:14
010 Rondelet,2,14,16,2022,01-17,14:14
011 Plan Cabanes,2,10,12,2022,01-17,14:14
012 Boutonnet,5,7,12,2022,01-17,14:14
013 Emile Combes,7,1,8,2022,01-17,14:14
014 Beaux-Arts,5,3,8,2022,01-17,14:14
015 Les Aubes,6,1,8,2022,01-17,14:14
016 Antigone centre,9,7,16,2022,01-17,14:14
017 M�diath�que Emile Zola,11,5,16,2022,01-17,14:14
018 Nombre d'Or,5,11,16,2022,01-17,14:14
019 Louis Blanc,4,12,16,2022,01-17,14:14
020 Gambetta,5,3,8,2022,01-17,14:14
021 Port Marianne,4,12,16,2022,01-17,14:14
022 Clemenceau,1,11,12,2022,01-17,14:14
023 Les Arceaux,0,16,16,2022,01-17,14:14
024 Cit� Mion,2,6,8,2022,01-17,14:14
025 Nouveau Saint-Roch,5,3,8,2022,01-17,14:14
026 Renouvier,1,7,8,2022,01-17,14:14
027 Odysseum,5,3,8,2022,01-17,14:14
028 Saint-Denis,3,5,8,2022,01-17,14:14
029 Richter,12,4,16,2022,01-17,14:14
030 Charles Flahault,5,3,8,2022,01-17,14:14
031 Voltaire,2,6,8,2022,01-17,14:14
032 Pr�s d'Ar�nes,6,2,8,2022,01-17,14:14
033 Garcia Lorca,5,3,8,2022,01-17,14:14
034 Vert Bois,0,16,16,2022,01-17,14:14
035 Malbosc,1,7,8,2022,01-17,14:14
036 Occitanie,5,27,32,2022,01-17,14:14
037 FacdesSciences,10,14,24,2022,01-17,14:14
038 Fac de Lettres,8,8,16,2022,01-17,14:14
039 Aiguelongue,5,3,8,2022,01-17,14:14
040 Jeu de Mail des Abb�s,8,0,8,2022,01-17,14:14
041 Eurom�decine,4,4,8,2022,01-17,14:14
042 Marie Caizergues,0,8,8,2022,01-17,14:14
043 Sabines,1,7,8,2022,01-17,14:14
044 Celleneuve,1,7,8,2022,01-17,14:14
045 Jardin de la Lironde,7,1,8,2022,01-17,14:14
046 P�re Soulas,4,4,8,2022,01-17,14:14
047 Place Viala,1,7,8,2022,01-17,14:14
048 H�tel du D�partement,1,7,8,2022,01-17,14:14
049 Tonnelles,5,3,8,2022,01-17,14:14
050 Parvis Jules Ferry - Gare Saint-Roch,6,2,8,2022,01-17,14:14
051 Pont de Lattes - Gare Saint-Roch,1,11,12,2022,01-17,14:14
053 Deux Ponts - Gare Saint-Roch,3,5,8,2022,01-17,14:14
054 Providence - Ovalie,3,5,8,2022,01-17,14:14
055 P�rols Etang de l'Or,24,44,68,2022,01-17,14:14
056 Albert 1er - Cath�drale,6,6,12,2022,01-17,14:14
057 Saint-Guilhem - Courreau,2,6,8,2022,01-17,14:14
059 Sud De France,0,8,8,2022,01-17,14:14
001 Rue Jules Ferry - Gare Saint-Roch,6,6,12,2022,01-17,14:24
002 Com�die,12,12,24,2022,01-17,14:24
003 Esplanade,13,19,32,2022,01-17,14:24
004 H�tel de Ville,14,2,16,2022,01-17,14:24
005 Corum,6,6,12,2022,01-17,14:24
006 Place Albert 1er - St Charles,10,21,31,2022,01-17,14:24
007 Foch,1,7,8,2022,01-17,14:24
008 Halles Castellane,8,4,12,2022,01-17,14:24
009 Observatoire,8,0,8,2022,01-17,14:24
010 Rondelet,2,14,16,2022,01-17,14:24
011 Plan Cabanes,2,10,12,2022,01-17,14:24
012 Boutonnet,5,7,12,2022,01-17,14:24
013 Emile Combes,7,1,8,2022,01-17,14:24
014 Beaux-Arts,5,3,8,2022,01-17,14:24
015 Les Aubes,6,1,8,2022,01-17,14:24
016 Antigone centre,9,7,16,2022,01-17,14:24
017 M�diath�que Emile Zola,11,5,16,2022,01-17,14:24
018 Nombre d'Or,5,11,16,2022,01-17,14:24
019 Louis Blanc,4,12,16,2022,01-17,14:24
020 Gambetta,5,3,8,2022,01-17,14:24
021 Port Marianne,2,14,16,2022,01-17,14:24
022 Clemenceau,1,11,12,2022,01-17,14:24
023 Les Arceaux,0,16,16,2022,01-17,14:24
024 Cit� Mion,2,6,8,2022,01-17,14:24
025 Nouveau Saint-Roch,5,3,8,2022,01-17,14:24
026 Renouvier,1,7,8,2022,01-17,14:24
027 Odysseum,5,3,8,2022,01-17,14:24
028 Saint-Denis,3,5,8,2022,01-17,14:24
029 Richter,12,4,16,2022,01-17,14:24
030 Charles Flahault,5,3,8,2022,01-17,14:24
031 Voltaire,2,6,8,2022,01-17,14:24
032 Pr�s d'Ar�nes,6,2,8,2022,01-17,14:24
033 Garcia Lorca,5,3,8,2022,01-17,14:24
034 Vert Bois,0,16,16,2022,01-17,14:24
035 Malbosc,1,7,8,2022,01-17,14:24
036 Occitanie,5,27,32,2022,01-17,14:24
037 FacdesSciences,11,13,24,2022,01-17,14:24
038 Fac de Lettres,8,8,16,2022,01-17,14:24
039 Aiguelongue,5,3,8,2022,01-17,14:24
040 Jeu de Mail des Abb�s,8,0,8,2022,01-17,14:24
041 Eurom�decine,4,4,8,2022,01-17,14:24
042 Marie Caizergues,0,8,8,2022,01-17,14:24
043 Sabines,1,7,8,2022,01-17,14:24
044 Celleneuve,1,7,8,2022,01-17,14:24
045 Jardin de la Lironde,7,1,8,2022,01-17,14:24
046 P�re Soulas,4,4,8,2022,01-17,14:24
047 Place Viala,1,7,8,2022,01-17,14:24
048 H�tel du D�partement,1,7,8,2022,01-17,14:24
049 Tonnelles,5,3,8,2022,01-17,14:24
050 Parvis Jules Ferry - Gare Saint-Roch,6,2,8,2022,01-17,14:24
051 Pont de Lattes - Gare Saint-Roch,1,11,12,2022,01-17,14:24
053 Deux Ponts - Gare Saint-Roch,3,5,8,2022,01-17,14:24
054 Providence - Ovalie,3,5,8,2022,01-17,14:24
055 P�rols Etang de l'Or,24,44,68,2022,01-17,14:24
056 Albert 1er - Cath�drale,6,6,12,2022,01-17,14:24
057 Saint-Guilhem - Courreau,2,6,8,2022,01-17,14:24
059 Sud De France,0,8,8,2022,01-17,14:24
001 Rue Jules Ferry - Gare Saint-Roch,6,6,12,2022,01-17,14:34
002 Com�die,12,12,24,2022,01-17,14:34
003 Esplanade,13,19,32,2022,01-17,14:34
004 H�tel de Ville,14,2,16,2022,01-17,14:34
005 Corum,6,6,12,2022,01-17,14:34
006 Place Albert 1er - St Charles,10,21,31,2022,01-17,14:34
007 Foch,1,7,8,2022,01-17,14:34
008 Halles Castellane,8,4,12,2022,01-17,14:34
009 Observatoire,8,0,8,2022,01-17,14:34
010 Rondelet,2,14,16,2022,01-17,14:34
011 Plan Cabanes,2,10,12,2022,01-17,14:34
012 Boutonnet,5,7,12,2022,01-17,14:34
013 Emile Combes,7,1,8,2022,01-17,14:34
014 Beaux-Arts,5,3,8,2022,01-17,14:34
015 Les Aubes,6,1,8,2022,01-17,14:34
016 Antigone centre,9,7,16,2022,01-17,14:34
017 M�diath�que Emile Zola,11,5,16,2022,01-17,14:34
018 Nombre d'Or,5,11,16,2022,01-17,14:34
019 Louis Blanc,4,12,16,2022,01-17,14:34
020 Gambetta,5,3,8,2022,01-17,14:34
021 Port Marianne,2,14,16,2022,01-17,14:34
022 Clemenceau,1,11,12,2022,01-17,14:34
023 Les Arceaux,0,16,16,2022,01-17,14:34
024 Cit� Mion,2,6,8,2022,01-17,14:34
025 Nouveau Saint-Roch,5,3,8,2022,01-17,14:34
026 Renouvier,1,7,8,2022,01-17,14:34
027 Odysseum,5,3,8,2022,01-17,14:34
028 Saint-Denis,3,5,8,2022,01-17,14:34
029 Richter,12,4,16,2022,01-17,14:34
030 Charles Flahault,4,4,8,2022,01-17,14:34
031 Voltaire,2,6,8,2022,01-17,14:34
032 Pr�s d'Ar�nes,6,2,8,2022,01-17,14:34
033 Garcia Lorca,5,3,8,2022,01-17,14:34
034 Vert Bois,0,16,16,2022,01-17,14:34
035 Malbosc,1,7,8,2022,01-17,14:34
036 Occitanie,5,27,32,2022,01-17,14:34
037 FacdesSciences,11,13,24,2022,01-17,14:34
038 Fac de Lettres,8,8,16,2022,01-17,14:34
039 Aiguelongue,5,3,8,2022,01-17,14:34
040 Jeu de Mail des Abb�s,8,0,8,2022,01-17,14:34
041 Eurom�decine,4,4,8,2022,01-17,14:34
042 Marie Caizergues,0,8,8,2022,01-17,14:34
043 Sabines,1,7,8,2022,01-17,14:34
044 Celleneuve,1,7,8,2022,01-17,14:34
045 Jardin de la Lironde,7,1,8,2022,01-17,14:34
046 P�re Soulas,4,4,8,2022,01-17,14:34
047 Place Viala,1,7,8,2022,01-17,14:34
048 H�tel du D�partement,1,7,8,2022,01-17,14:34
049 Tonnelles,5,3,8,2022,01-17,14:34
050 Parvis Jules Ferry - Gare Saint-Roch,6,2,8,2022,01-17,14:34
051 Pont de Lattes - Gare Saint-Roch,1,11,12,2022,01-17,14:34
053 Deux Ponts - Gare Saint-Roch,3,5,8,2022,01-17,14:34
054 Providence - Ovalie,3,5,8,2022,01-17,14:34
055 P�rols Etang de l'Or,22,46,68,2022,01-17,14:34
056 Albert 1er - Cath�drale,3,9,12,2022,01-17,14:34
057 Saint-Guilhem - Courreau,2,6,8,2022,01-17,14:34
059 Sud De France,0,8,8,2022,01-17,14:34
001 Rue Jules Ferry - Gare Saint-Roch,6,6,12,2022,01-17,14:44
002 Com�die,12,12,24,2022,01-17,14:44
003 Esplanade,13,19,32,2022,01-17,14:44
004 H�tel de Ville,14,2,16,2022,01-17,14:44
005 Corum,6,6,12,2022,01-17,14:44
006 Place Albert 1er - St Charles,10,21,31,2022,01-17,14:44
007 Foch,1,7,8,2022,01-17,14:44
008 Halles Castellane,8,4,12,2022,01-17,14:44
009 Observatoire,8,0,8,2022,01-17,14:44
010 Rondelet,2,14,16,2022,01-17,14:44
011 Plan Cabanes,2,10,12,2022,01-17,14:44
012 Boutonnet,6,6,12,2022,01-17,14:44
013 Emile Combes,7,1,8,2022,01-17,14:44
014 Beaux-Arts,5,3,8,2022,01-17,14:44
015 Les Aubes,6,1,8,2022,01-17,14:44
016 Antigone centre,9,7,16,2022,01-17,14:44
017 M�diath�que Emile Zola,11,5,16,2022,01-17,14:44
018 Nombre d'Or,5,11,16,2022,01-17,14:44
019 Louis Blanc,4,12,16,2022,01-17,14:44
020 Gambetta,5,3,8,2022,01-17,14:44
021 Port Marianne,1,15,16,2022,01-17,14:44
022 Clemenceau,1,11,12,2022,01-17,14:44
023 Les Arceaux,0,16,16,2022,01-17,14:44
024 Cit� Mion,2,6,8,2022,01-17,14:44
025 Nouveau Saint-Roch,5,3,8,2022,01-17,14:44
026 Renouvier,1,7,8,2022,01-17,14:44
027 Odysseum,5,3,8,2022,01-17,14:44
028 Saint-Denis,3,5,8,2022,01-17,14:44
029 Richter,11,5,16,2022,01-17,14:44
030 Charles Flahault,3,5,8,2022,01-17,14:44
031 Voltaire,3,5,8,2022,01-17,14:44
032 Pr�s d'Ar�nes,6,2,8,2022,01-17,14:44
033 Garcia Lorca,5,3,8,2022,01-17,14:44
034 Vert Bois,0,16,16,2022,01-17,14:44
035 Malbosc,1,7,8,2022,01-17,14:44
036 Occitanie,5,27,32,2022,01-17,14:44
037 FacdesSciences,11,13,24,2022,01-17,14:44
038 Fac de Lettres,9,7,16,2022,01-17,14:44
039 Aiguelongue,5,3,8,2022,01-17,14:44
040 Jeu de Mail des Abb�s,8,0,8,2022,01-17,14:44
041 Eurom�decine,4,4,8,2022,01-17,14:44
042 Marie Caizergues,0,8,8,2022,01-17,14:44
043 Sabines,1,7,8,2022,01-17,14:44
044 Celleneuve,1,7,8,2022,01-17,14:44
045 Jardin de la Lironde,7,1,8,2022,01-17,14:44
046 P�re Soulas,5,3,8,2022,01-17,14:44
047 Place Viala,1,7,8,2022,01-17,14:44
048 H�tel du D�partement,1,7,8,2022,01-17,14:44
049 Tonnelles,5,3,8,2022,01-17,14:44
050 Parvis Jules Ferry - Gare Saint-Roch,7,1,8,2022,01-17,14:44
051 Pont de Lattes - Gare Saint-Roch,1,11,12,2022,01-17,14:44
053 Deux Ponts - Gare Saint-Roch,3,5,8,2022,01-17,14:44
054 Providence - Ovalie,3,5,8,2022,01-17,14:44
055 P�rols Etang de l'Or,22,46,68,2022,01-17,14:44
056 Albert 1er - Cath�drale,3,9,12,2022,01-17,14:44
057 Saint-Guilhem - Courreau,2,6,8,2022,01-17,14:44
059 Sud De France,0,8,8,2022,01-17,14:44
001 Rue Jules Ferry - Gare Saint-Roch,8,4,12,2022,01-17,14:54
002 Com�die,12,12,24,2022,01-17,14:54
003 Esplanade,12,20,32,2022,01-17,14:54
004 H�tel de Ville,14,2,16,2022,01-17,14:54
005 Corum,7,5,12,2022,01-17,14:54
006 Place Albert 1er - St Charles,10,21,31,2022,01-17,14:54
007 Foch,1,7,8,2022,01-17,14:54
008 Halles Castellane,8,4,12,2022,01-17,14:54
009 Observatoire,8,0,8,2022,01-17,14:54
010 Rondelet,2,14,16,2022,01-17,14:54
011 Plan Cabanes,2,10,12,2022,01-17,14:54
012 Boutonnet,6,6,12,2022,01-17,14:54
013 Emile Combes,7,1,8,2022,01-17,14:54
014 Beaux-Arts,5,3,8,2022,01-17,14:54
015 Les Aubes,5,2,8,2022,01-17,14:54
016 Antigone centre,9,7,16,2022,01-17,14:54
017 M�diath�que Emile Zola,11,5,16,2022,01-17,14:54
018 Nombre d'Or,4,12,16,2022,01-17,14:54
019 Louis Blanc,4,12,16,2022,01-17,14:54
020 Gambetta,5,3,8,2022,01-17,14:54
021 Port Marianne,1,15,16,2022,01-17,14:54
022 Clemenceau,1,11,12,2022,01-17,14:54
023 Les Arceaux,0,16,16,2022,01-17,14:54
024 Cit� Mion,2,6,8,2022,01-17,14:54
025 Nouveau Saint-Roch,5,3,8,2022,01-17,14:54
026 Renouvier,1,7,8,2022,01-17,14:54
027 Odysseum,4,4,8,2022,01-17,14:54
028 Saint-Denis,3,5,8,2022,01-17,14:54
029 Richter,11,5,16,2022,01-17,14:54
030 Charles Flahault,3,5,8,2022,01-17,14:54
031 Voltaire,3,5,8,2022,01-17,14:54
032 Pr�s d'Ar�nes,6,2,8,2022,01-17,14:54
033 Garcia Lorca,5,3,8,2022,01-17,14:54
034 Vert Bois,0,16,16,2022,01-17,14:54
035 Malbosc,1,7,8,2022,01-17,14:54
036 Occitanie,5,27,32,2022,01-17,14:54
037 FacdesSciences,11,13,24,2022,01-17,14:54
038 Fac de Lettres,9,7,16,2022,01-17,14:54
039 Aiguelongue,3,5,8,2022,01-17,14:54
040 Jeu de Mail des Abb�s,8,0,8,2022,01-17,14:54
041 Eurom�decine,4,4,8,2022,01-17,14:54
042 Marie Caizergues,0,8,8,2022,01-17,14:54
043 Sabines,1,7,8,2022,01-17,14:54
044 Celleneuve,1,7,8,2022,01-17,14:54
045 Jardin de la Lironde,7,1,8,2022,01-17,14:54
046 P�re Soulas,3,5,8,2022,01-17,14:54
047 Place Viala,1,7,8,2022,01-17,14:54
048 H�tel du D�partement,1,7,8,2022,01-17,14:54
049 Tonnelles,5,3,8,2022,01-17,14:54
050 Parvis Jules Ferry - Gare Saint-Roch,7,1,8,2022,01-17,14:54
051 Pont de Lattes - Gare Saint-Roch,1,11,12,2022,01-17,14:54
053 Deux Ponts - Gare Saint-Roch,3,5,8,2022,01-17,14:54
054 Providence - Ovalie,3,5,8,2022,01-17,14:54
055 P�rols Etang de l'Or,22,46,68,2022,01-17,14:54
056 Albert 1er - Cath�drale,3,9,12,2022,01-17,14:54
057 Saint-Guilhem - Courreau,2,6,8,2022,01-17,14:54
059 Sud De France,0,8,8,2022,01-17,14:54
001 Rue Jules Ferry - Gare Saint-Roch,8,4,12,2022,01-17,15:05
002 Com�die,12,12,24,2022,01-17,15:05
003 Esplanade,12,20,32,2022,01-17,15:05
004 H�tel de Ville,14,2,16,2022,01-17,15:05
005 Corum,7,5,12,2022,01-17,15:05
006 Place Albert 1er - St Charles,11,20,31,2022,01-17,15:05
007 Foch,1,7,8,2022,01-17,15:05
008 Halles Castellane,5,7,12,2022,01-17,15:05
009 Observatoire,8,0,8,2022,01-17,15:05
010 Rondelet,2,14,16,2022,01-17,15:05
011 Plan Cabanes,2,10,12,2022,01-17,15:05
012 Boutonnet,6,6,12,2022,01-17,15:05
013 Emile Combes,7,1,8,2022,01-17,15:05
014 Beaux-Arts,5,3,8,2022,01-17,15:05
015 Les Aubes,5,2,8,2022,01-17,15:05
016 Antigone centre,9,7,16,2022,01-17,15:05
017 M�diath�que Emile Zola,8,8,16,2022,01-17,15:05
018 Nombre d'Or,4,12,16,2022,01-17,15:05
019 Louis Blanc,4,12,16,2022,01-17,15:05
020 Gambetta,5,3,8,2022,01-17,15:05
021 Port Marianne,1,15,16,2022,01-17,15:05
022 Clemenceau,1,11,12,2022,01-17,15:05
023 Les Arceaux,0,16,16,2022,01-17,15:05
024 Cit� Mion,2,6,8,2022,01-17,15:05
025 Nouveau Saint-Roch,5,3,8,2022,01-17,15:05
026 Renouvier,0,8,8,2022,01-17,15:05
027 Odysseum,4,4,8,2022,01-17,15:05
028 Saint-Denis,3,5,8,2022,01-17,15:05
029 Richter,9,7,16,2022,01-17,15:05
030 Charles Flahault,3,5,8,2022,01-17,15:05
031 Voltaire,3,5,8,2022,01-17,15:05
032 Pr�s d'Ar�nes,6,2,8,2022,01-17,15:05
033 Garcia Lorca,5,3,8,2022,01-17,15:05
034 Vert Bois,0,16,16,2022,01-17,15:05
035 Malbosc,1,7,8,2022,01-17,15:05
036 Occitanie,5,27,32,2022,01-17,15:05
037 FacdesSciences,13,11,24,2022,01-17,15:05
038 Fac de Lettres,9,7,16,2022,01-17,15:05
039 Aiguelongue,3,5,8,2022,01-17,15:05
040 Jeu de Mail des Abb�s,8,0,8,2022,01-17,15:05
041 Eurom�decine,4,4,8,2022,01-17,15:05
042 Marie Caizergues,0,8,8,2022,01-17,15:05
043 Sabines,1,7,8,2022,01-17,15:05
044 Celleneuve,1,7,8,2022,01-17,15:05
045 Jardin de la Lironde,7,1,8,2022,01-17,15:05
046 P�re Soulas,3,5,8,2022,01-17,15:05
047 Place Viala,1,7,8,2022,01-17,15:05
048 H�tel du D�partement,1,7,8,2022,01-17,15:05
049 Tonnelles,5,3,8,2022,01-17,15:05
050 Parvis Jules Ferry - Gare Saint-Roch,7,1,8,2022,01-17,15:05
051 Pont de Lattes - Gare Saint-Roch,1,11,12,2022,01-17,15:05
053 Deux Ponts - Gare Saint-Roch,3,5,8,2022,01-17,15:05
054 Providence - Ovalie,3,5,8,2022,01-17,15:05
055 P�rols Etang de l'Or,22,46,68,2022,01-17,15:05
056 Albert 1er - Cath�drale,3,9,12,2022,01-17,15:05
057 Saint-Guilhem - Courreau,2,6,8,2022,01-17,15:05
059 Sud De France,0,8,8,2022,01-17,15:05
001 Rue Jules Ferry - Gare Saint-Roch,8,4,12,2022,01-17,15:15
002 Com�die,12,12,24,2022,01-17,15:15
003 Esplanade,12,20,32,2022,01-17,15:15
004 H�tel de Ville,14,2,16,2022,01-17,15:15
005 Corum,7,5,12,2022,01-17,15:15
006 Place Albert 1er - St Charles,11,20,31,2022,01-17,15:15
007 Foch,1,7,8,2022,01-17,15:15
008 Halles Castellane,6,6,12,2022,01-17,15:15
009 Observatoire,8,0,8,2022,01-17,15:15
010 Rondelet,2,14,16,2022,01-17,15:15
011 Plan Cabanes,3,9,12,2022,01-17,15:15
012 Boutonnet,6,6,12,2022,01-17,15:15
013 Emile Combes,7,1,8,2022,01-17,15:15
014 Beaux-Arts,5,3,8,2022,01-17,15:15
015 Les Aubes,5,2,8,2022,01-17,15:15
016 Antigone centre,9,7,16,2022,01-17,15:15
017 M�diath�que Emile Zola,6,10,16,2022,01-17,15:15
018 Nombre d'Or,10,6,16,2022,01-17,15:15
019 Louis Blanc,4,12,16,2022,01-17,15:15
020 Gambetta,5,3,8,2022,01-17,15:15
021 Port Marianne,1,15,16,2022,01-17,15:15
022 Clemenceau,1,11,12,2022,01-17,15:15
023 Les Arceaux,0,16,16,2022,01-17,15:15
024 Cit� Mion,2,6,8,2022,01-17,15:15
025 Nouveau Saint-Roch,5,3,8,2022,01-17,15:15
026 Renouvier,0,8,8,2022,01-17,15:15
027 Odysseum,6,2,8,2022,01-17,15:15
028 Saint-Denis,3,5,8,2022,01-17,15:15
029 Richter,9,7,16,2022,01-17,15:15
030 Charles Flahault,3,5,8,2022,01-17,15:15
031 Voltaire,3,5,8,2022,01-17,15:15
032 Pr�s d'Ar�nes,6,2,8,2022,01-17,15:15
033 Garcia Lorca,5,3,8,2022,01-17,15:15
034 Vert Bois,0,16,16,2022,01-17,15:15
035 Malbosc,1,7,8,2022,01-17,15:15
036 Occitanie,5,27,32,2022,01-17,15:15
037 FacdesSciences,13,11,24,2022,01-17,15:15
038 Fac de Lettres,9,7,16,2022,01-17,15:15
039 Aiguelongue,3,5,8,2022,01-17,15:15
040 Jeu de Mail des Abb�s,8,0,8,2022,01-17,15:15
041 Eurom�decine,4,4,8,2022,01-17,15:15
042 Marie Caizergues,0,8,8,2022,01-17,15:15
043 Sabines,0,8,8,2022,01-17,15:15
044 Celleneuve,1,7,8,2022,01-17,15:15
045 Jardin de la Lironde,7,1,8,2022,01-17,15:15
046 P�re Soulas,4,4,8,2022,01-17,15:15
047 Place Viala,1,7,8,2022,01-17,15:15
048 H�tel du D�partement,0,8,8,2022,01-17,15:15
049 Tonnelles,5,3,8,2022,01-17,15:15
050 Parvis Jules Ferry - Gare Saint-Roch,7,1,8,2022,01-17,15:15
051 Pont de Lattes - Gare Saint-Roch,1,11,12,2022,01-17,15:15
053 Deux Ponts - Gare Saint-Roch,3,5,8,2022,01-17,15:15
054 Providence - Ovalie,3,5,8,2022,01-17,15:15
055 P�rols Etang de l'Or,23,45,68,2022,01-17,15:15
056 Albert 1er - Cath�drale,3,9,12,2022,01-17,15:15
057 Saint-Guilhem - Courreau,0,8,8,2022,01-17,15:15
059 Sud De France,0,8,8,2022,01-17,15:15
001 Rue Jules Ferry - Gare Saint-Roch,8,4,12,2022,01-17,15:25
002 Com�die,13,11,24,2022,01-17,15:25
003 Esplanade,11,21,32,2022,01-17,15:25
004 H�tel de Ville,14,2,16,2022,01-17,15:25
005 Corum,7,5,12,2022,01-17,15:25
006 Place Albert 1er - St Charles,12,19,31,2022,01-17,15:25
007 Foch,1,7,8,2022,01-17,15:25
008 Halles Castellane,6,6,12,2022,01-17,15:25
009 Observatoire,8,0,8,2022,01-17,15:25
010 Rondelet,2,14,16,2022,01-17,15:25
011 Plan Cabanes,3,9,12,2022,01-17,15:25
012 Boutonnet,6,6,12,2022,01-17,15:25
013 Emile Combes,7,1,8,2022,01-17,15:25
014 Beaux-Arts,5,3,8,2022,01-17,15:25
015 Les Aubes,5,2,8,2022,01-17,15:25
016 Antigone centre,9,7,16,2022,01-17,15:25
017 M�diath�que Emile Zola,6,10,16,2022,01-17,15:25
018 Nombre d'Or,10,6,16,2022,01-17,15:25
019 Louis Blanc,4,12,16,2022,01-17,15:25
020 Gambetta,5,3,8,2022,01-17,15:25
021 Port Marianne,1,15,16,2022,01-17,15:25
022 Clemenceau,1,11,12,2022,01-17,15:25
023 Les Arceaux,0,16,16,2022,01-17,15:25
024 Cit� Mion,2,6,8,2022,01-17,15:25
025 Nouveau Saint-Roch,5,3,8,2022,01-17,15:25
026 Renouvier,0,8,8,2022,01-17,15:25
027 Odysseum,6,2,8,2022,01-17,15:25
028 Saint-Denis,3,5,8,2022,01-17,15:25
029 Richter,9,7,16,2022,01-17,15:25
030 Charles Flahault,3,5,8,2022,01-17,15:25
031 Voltaire,3,5,8,2022,01-17,15:25
032 Pr�s d'Ar�nes,6,2,8,2022,01-17,15:25
033 Garcia Lorca,5,3,8,2022,01-17,15:25
034 Vert Bois,0,16,16,2022,01-17,15:25
035 Malbosc,1,7,8,2022,01-17,15:25
036 Occitanie,5,27,32,2022,01-17,15:25
037 FacdesSciences,13,11,24,2022,01-17,15:25
038 Fac de Lettres,9,7,16,2022,01-17,15:25
039 Aiguelongue,3,5,8,2022,01-17,15:25
040 Jeu de Mail des Abb�s,8,0,8,2022,01-17,15:25
041 Eurom�decine,4,4,8,2022,01-17,15:25
042 Marie Caizergues,0,8,8,2022,01-17,15:25
043 Sabines,0,8,8,2022,01-17,15:25
044 Celleneuve,1,7,8,2022,01-17,15:25
045 Jardin de la Lironde,7,1,8,2022,01-17,15:25
046 P�re Soulas,4,4,8,2022,01-17,15:25
047 Place Viala,1,7,8,2022,01-17,15:25
048 H�tel du D�partement,0,8,8,2022,01-17,15:25
049 Tonnelles,5,3,8,2022,01-17,15:25
050 Parvis Jules Ferry - Gare Saint-Roch,6,2,8,2022,01-17,15:25
051 Pont de Lattes - Gare Saint-Roch,1,11,12,2022,01-17,15:25
053 Deux Ponts - Gare Saint-Roch,3,5,8,2022,01-17,15:25
054 Providence - Ovalie,3,5,8,2022,01-17,15:25
055 P�rols Etang de l'Or,23,45,68,2022,01-17,15:25
056 Albert 1er - Cath�drale,2,10,12,2022,01-17,15:25
057 Saint-Guilhem - Courreau,0,8,8,2022,01-17,15:25
059 Sud De France,0,8,8,2022,01-17,15:25
001 Rue Jules Ferry - Gare Saint-Roch,9,3,12,2022,01-17,15:35
002 Com�die,13,11,24,2022,01-17,15:35
003 Esplanade,11,21,32,2022,01-17,15:35
004 H�tel de Ville,14,2,16,2022,01-17,15:35
005 Corum,7,5,12,2022,01-17,15:35
006 Place Albert 1er - St Charles,10,21,31,2022,01-17,15:35
007 Foch,1,7,8,2022,01-17,15:35
008 Halles Castellane,6,6,12,2022,01-17,15:35
009 Observatoire,8,0,8,2022,01-17,15:35
010 Rondelet,2,14,16,2022,01-17,15:35
011 Plan Cabanes,3,9,12,2022,01-17,15:35
012 Boutonnet,6,6,12,2022,01-17,15:35
013 Emile Combes,7,1,8,2022,01-17,15:35
014 Beaux-Arts,5,3,8,2022,01-17,15:35
015 Les Aubes,5,2,8,2022,01-17,15:35
016 Antigone centre,9,7,16,2022,01-17,15:35
017 M�diath�que Emile Zola,6,10,16,2022,01-17,15:35
018 Nombre d'Or,10,6,16,2022,01-17,15:35
019 Louis Blanc,4,12,16,2022,01-17,15:35
020 Gambetta,5,3,8,2022,01-17,15:35
021 Port Marianne,2,14,16,2022,01-17,15:35
022 Clemenceau,1,11,12,2022,01-17,15:35
023 Les Arceaux,0,16,16,2022,01-17,15:35
024 Cit� Mion,2,6,8,2022,01-17,15:35
025 Nouveau Saint-Roch,5,3,8,2022,01-17,15:35
026 Renouvier,0,8,8,2022,01-17,15:35
027 Odysseum,6,2,8,2022,01-17,15:35
028 Saint-Denis,3,5,8,2022,01-17,15:35
029 Richter,9,7,16,2022,01-17,15:35
030 Charles Flahault,4,4,8,2022,01-17,15:35
031 Voltaire,3,5,8,2022,01-17,15:35
032 Pr�s d'Ar�nes,6,2,8,2022,01-17,15:35
033 Garcia Lorca,5,3,8,2022,01-17,15:35
034 Vert Bois,0,16,16,2022,01-17,15:35
035 Malbosc,2,6,8,2022,01-17,15:35
036 Occitanie,5,27,32,2022,01-17,15:35
037 FacdesSciences,13,11,24,2022,01-17,15:35
038 Fac de Lettres,9,7,16,2022,01-17,15:35
039 Aiguelongue,3,5,8,2022,01-17,15:35
040 Jeu de Mail des Abb�s,8,0,8,2022,01-17,15:35
041 Eurom�decine,3,5,8,2022,01-17,15:35
042 Marie Caizergues,0,8,8,2022,01-17,15:35
043 Sabines,0,8,8,2022,01-17,15:35
044 Celleneuve,1,7,8,2022,01-17,15:35
045 Jardin de la Lironde,7,1,8,2022,01-17,15:35
046 P�re Soulas,4,4,8,2022,01-17,15:35
047 Place Viala,1,7,8,2022,01-17,15:35
048 H�tel du D�partement,0,8,8,2022,01-17,15:35
049 Tonnelles,5,3,8,2022,01-17,15:35
050 Parvis Jules Ferry - Gare Saint-Roch,6,2,8,2022,01-17,15:35
051 Pont de Lattes - Gare Saint-Roch,1,11,12,2022,01-17,15:35
053 Deux Ponts - Gare Saint-Roch,3,5,8,2022,01-17,15:35
054 Providence - Ovalie,3,5,8,2022,01-17,15:35
055 P�rols Etang de l'Or,23,45,68,2022,01-17,15:35
056 Albert 1er - Cath�drale,2,10,12,2022,01-17,15:35
057 Saint-Guilhem - Courreau,0,8,8,2022,01-17,15:35
059 Sud De France,0,8,8,2022,01-17,15:35
001 Rue Jules Ferry - Gare Saint-Roch,9,3,12,2022,01-17,15:45
002 Com�die,12,12,24,2022,01-17,15:45
003 Esplanade,11,21,32,2022,01-17,15:45
004 H�tel de Ville,14,2,16,2022,01-17,15:45
005 Corum,8,4,12,2022,01-17,15:45
006 Place Albert 1er - St Charles,10,21,31,2022,01-17,15:45
007 Foch,1,7,8,2022,01-17,15:45
008 Halles Castellane,6,6,12,2022,01-17,15:45
009 Observatoire,8,0,8,2022,01-17,15:45
010 Rondelet,2,14,16,2022,01-17,15:45
011 Plan Cabanes,3,9,12,2022,01-17,15:45
012 Boutonnet,6,6,12,2022,01-17,15:45
013 Emile Combes,7,1,8,2022,01-17,15:45
014 Beaux-Arts,5,3,8,2022,01-17,15:45
015 Les Aubes,5,2,8,2022,01-17,15:45
016 Antigone centre,9,7,16,2022,01-17,15:45
017 M�diath�que Emile Zola,5,11,16,2022,01-17,15:45
018 Nombre d'Or,11,5,16,2022,01-17,15:45
019 Louis Blanc,3,13,16,2022,01-17,15:45
020 Gambetta,5,3,8,2022,01-17,15:45
021 Port Marianne,1,15,16,2022,01-17,15:45
022 Clemenceau,2,10,12,2022,01-17,15:45
023 Les Arceaux,0,16,16,2022,01-17,15:45
024 Cit� Mion,2,6,8,2022,01-17,15:45
025 Nouveau Saint-Roch,5,3,8,2022,01-17,15:45
026 Renouvier,0,8,8,2022,01-17,15:45
027 Odysseum,6,2,8,2022,01-17,15:45
028 Saint-Denis,3,5,8,2022,01-17,15:45
029 Richter,10,6,16,2022,01-17,15:45
030 Charles Flahault,4,4,8,2022,01-17,15:45
031 Voltaire,3,5,8,2022,01-17,15:45
032 Pr�s d'Ar�nes,6,2,8,2022,01-17,15:45
033 Garcia Lorca,5,3,8,2022,01-17,15:45
034 Vert Bois,0,16,16,2022,01-17,15:45
035 Malbosc,2,6,8,2022,01-17,15:45
036 Occitanie,6,26,32,2022,01-17,15:45
037 FacdesSciences,13,11,24,2022,01-17,15:45
038 Fac de Lettres,8,8,16,2022,01-17,15:45
039 Aiguelongue,3,5,8,2022,01-17,15:45
040 Jeu de Mail des Abb�s,8,0,8,2022,01-17,15:45
041 Eurom�decine,3,5,8,2022,01-17,15:45
042 Marie Caizergues,0,8,8,2022,01-17,15:45
043 Sabines,0,8,8,2022,01-17,15:45
044 Celleneuve,1,7,8,2022,01-17,15:45
045 Jardin de la Lironde,6,2,8,2022,01-17,15:45
046 P�re Soulas,4,4,8,2022,01-17,15:45
047 Place Viala,1,7,8,2022,01-17,15:45
048 H�tel du D�partement,0,8,8,2022,01-17,15:45
049 Tonnelles,5,3,8,2022,01-17,15:45
050 Parvis Jules Ferry - Gare Saint-Roch,7,1,8,2022,01-17,15:45
051 Pont de Lattes - Gare Saint-Roch,1,11,12,2022,01-17,15:45
053 Deux Ponts - Gare Saint-Roch,3,5,8,2022,01-17,15:45
054 Providence - Ovalie,3,5,8,2022,01-17,15:45
055 P�rols Etang de l'Or,23,45,68,2022,01-17,15:45
056 Albert 1er - Cath�drale,2,10,12,2022,01-17,15:45
057 Saint-Guilhem - Courreau,0,8,8,2022,01-17,15:45
059 Sud De France,0,8,8,2022,01-17,15:45
001 Rue Jules Ferry - Gare Saint-Roch,8,4,12,2022,01-17,15:55
002 Com�die,12,12,24,2022,01-17,15:55
003 Esplanade,10,22,32,2022,01-17,15:55
004 H�tel de Ville,14,2,16,2022,01-17,15:55
005 Corum,8,4,12,2022,01-17,15:55
006 Place Albert 1er - St Charles,10,21,31,2022,01-17,15:55
007 Foch,1,7,8,2022,01-17,15:55
008 Halles Castellane,6,6,12,2022,01-17,15:55
009 Observatoire,8,0,8,2022,01-17,15:55
010 Rondelet,3,13,16,2022,01-17,15:55
011 Plan Cabanes,2,10,12,2022,01-17,15:55
012 Boutonnet,6,6,12,2022,01-17,15:55
013 Emile Combes,7,1,8,2022,01-17,15:55
014 Beaux-Arts,5,3,8,2022,01-17,15:55
015 Les Aubes,5,2,8,2022,01-17,15:55
016 Antigone centre,9,7,16,2022,01-17,15:55
017 M�diath�que Emile Zola,5,11,16,2022,01-17,15:55
018 Nombre d'Or,11,5,16,2022,01-17,15:55
019 Louis Blanc,3,13,16,2022,01-17,15:55
020 Gambetta,5,3,8,2022,01-17,15:55
021 Port Marianne,1,15,16,2022,01-17,15:55
022 Clemenceau,2,10,12,2022,01-17,15:55
023 Les Arceaux,0,16,16,2022,01-17,15:55
024 Cit� Mion,2,6,8,2022,01-17,15:55
025 Nouveau Saint-Roch,6,2,8,2022,01-17,15:55
026 Renouvier,0,8,8,2022,01-17,15:55
027 Odysseum,6,2,8,2022,01-17,15:55
028 Saint-Denis,3,5,8,2022,01-17,15:55
029 Richter,10,6,16,2022,01-17,15:55
030 Charles Flahault,4,4,8,2022,01-17,15:55
031 Voltaire,3,5,8,2022,01-17,15:55
032 Pr�s d'Ar�nes,6,2,8,2022,01-17,15:55
033 Garcia Lorca,5,3,8,2022,01-17,15:55
034 Vert Bois,0,16,16,2022,01-17,15:55
035 Malbosc,2,6,8,2022,01-17,15:55
036 Occitanie,6,26,32,2022,01-17,15:55
037 FacdesSciences,13,11,24,2022,01-17,15:55
038 Fac de Lettres,8,8,16,2022,01-17,15:55
039 Aiguelongue,3,5,8,2022,01-17,15:55
040 Jeu de Mail des Abb�s,8,0,8,2022,01-17,15:55
041 Eurom�decine,4,4,8,2022,01-17,15:55
042 Marie Caizergues,0,8,8,2022,01-17,15:55
043 Sabines,0,8,8,2022,01-17,15:55
044 Celleneuve,1,7,8,2022,01-17,15:55
045 Jardin de la Lironde,6,2,8,2022,01-17,15:55
046 P�re Soulas,4,4,8,2022,01-17,15:55
047 Place Viala,2,6,8,2022,01-17,15:55
048 H�tel du D�partement,0,8,8,2022,01-17,15:55
049 Tonnelles,5,3,8,2022,01-17,15:55
050 Parvis Jules Ferry - Gare Saint-Roch,7,1,8,2022,01-17,15:55
051 Pont de Lattes - Gare Saint-Roch,1,11,12,2022,01-17,15:55
053 Deux Ponts - Gare Saint-Roch,3,5,8,2022,01-17,15:55
054 Providence - Ovalie,3,5,8,2022,01-17,15:55
055 P�rols Etang de l'Or,23,45,68,2022,01-17,15:55
056 Albert 1er - Cath�drale,2,10,12,2022,01-17,15:55
057 Saint-Guilhem - Courreau,0,8,8,2022,01-17,15:55
059 Sud De France,0,8,8,2022,01-17,15:55
001 Rue Jules Ferry - Gare Saint-Roch,8,4,12,2022,01-17,16:06
002 Com�die,12,12,24,2022,01-17,16:06
003 Esplanade,10,22,32,2022,01-17,16:06
004 H�tel de Ville,14,2,16,2022,01-17,16:06
005 Corum,9,3,12,2022,01-17,16:06
006 Place Albert 1er - St Charles,10,21,31,2022,01-17,16:06
007 Foch,1,7,8,2022,01-17,16:06
008 Halles Castellane,4,8,12,2022,01-17,16:06
009 Observatoire,8,0,8,2022,01-17,16:06
010 Rondelet,3,13,16,2022,01-17,16:06
011 Plan Cabanes,2,10,12,2022,01-17,16:06
012 Boutonnet,6,6,12,2022,01-17,16:06
013 Emile Combes,7,1,8,2022,01-17,16:06
014 Beaux-Arts,5,3,8,2022,01-17,16:06
015 Les Aubes,5,2,8,2022,01-17,16:06
016 Antigone centre,9,7,16,2022,01-17,16:06
017 M�diath�que Emile Zola,5,11,16,2022,01-17,16:06
018 Nombre d'Or,12,4,16,2022,01-17,16:06
019 Louis Blanc,3,13,16,2022,01-17,16:06
020 Gambetta,5,3,8,2022,01-17,16:06
021 Port Marianne,1,15,16,2022,01-17,16:06
022 Clemenceau,3,9,12,2022,01-17,16:06
023 Les Arceaux,0,16,16,2022,01-17,16:06
024 Cit� Mion,2,6,8,2022,01-17,16:06
025 Nouveau Saint-Roch,6,2,8,2022,01-17,16:06
026 Renouvier,0,8,8,2022,01-17,16:06
027 Odysseum,6,2,8,2022,01-17,16:06
028 Saint-Denis,3,5,8,2022,01-17,16:06
029 Richter,9,7,16,2022,01-17,16:06
030 Charles Flahault,4,4,8,2022,01-17,16:06
031 Voltaire,4,4,8,2022,01-17,16:06
032 Pr�s d'Ar�nes,6,2,8,2022,01-17,16:06
033 Garcia Lorca,5,3,8,2022,01-17,16:06
034 Vert Bois,0,16,16,2022,01-17,16:06
035 Malbosc,3,5,8,2022,01-17,16:06
036 Occitanie,6,26,32,2022,01-17,16:06
037 FacdesSciences,13,11,24,2022,01-17,16:06
038 Fac de Lettres,8,8,16,2022,01-17,16:06
039 Aiguelongue,3,5,8,2022,01-17,16:06
040 Jeu de Mail des Abb�s,8,0,8,2022,01-17,16:06
041 Eurom�decine,4,4,8,2022,01-17,16:06
042 Marie Caizergues,0,8,8,2022,01-17,16:06
043 Sabines,0,8,8,2022,01-17,16:06
044 Celleneuve,1,7,8,2022,01-17,16:06
045 Jardin de la Lironde,6,2,8,2022,01-17,16:06
046 P�re Soulas,4,4,8,2022,01-17,16:06
047 Place Viala,2,6,8,2022,01-17,16:06
048 H�tel du D�partement,0,8,8,2022,01-17,16:06
049 Tonnelles,5,3,8,2022,01-17,16:06
050 Parvis Jules Ferry - Gare Saint-Roch,7,1,8,2022,01-17,16:06
051 Pont de Lattes - Gare Saint-Roch,1,11,12,2022,01-17,16:06
053 Deux Ponts - Gare Saint-Roch,3,5,8,2022,01-17,16:06
054 Providence - Ovalie,3,5,8,2022,01-17,16:06
055 P�rols Etang de l'Or,24,44,68,2022,01-17,16:06
056 Albert 1er - Cath�drale,2,10,12,2022,01-17,16:06
057 Saint-Guilhem - Courreau,0,8,8,2022,01-17,16:06
059 Sud De France,0,8,8,2022,01-17,16:06
001 Rue Jules Ferry - Gare Saint-Roch,8,4,12,2022,01-17,16:16
002 Com�die,12,12,24,2022,01-17,16:16
003 Esplanade,9,23,32,2022,01-17,16:16
004 H�tel de Ville,12,4,16,2022,01-17,16:16
005 Corum,9,3,12,2022,01-17,16:16
006 Place Albert 1er - St Charles,9,22,31,2022,01-17,16:16
007 Foch,1,7,8,2022,01-17,16:16
008 Halles Castellane,4,8,12,2022,01-17,16:16
009 Observatoire,8,0,8,2022,01-17,16:16
010 Rondelet,3,13,16,2022,01-17,16:16
011 Plan Cabanes,3,9,12,2022,01-17,16:16
012 Boutonnet,6,6,12,2022,01-17,16:16
013 Emile Combes,7,1,8,2022,01-17,16:16
014 Beaux-Arts,5,3,8,2022,01-17,16:16
015 Les Aubes,5,2,8,2022,01-17,16:16
016 Antigone centre,10,6,16,2022,01-17,16:16
017 M�diath�que Emile Zola,5,11,16,2022,01-17,16:16
018 Nombre d'Or,14,2,16,2022,01-17,16:16
019 Louis Blanc,3,13,16,2022,01-17,16:16
020 Gambetta,5,3,8,2022,01-17,16:16
021 Port Marianne,1,15,16,2022,01-17,16:16
022 Clemenceau,3,9,12,2022,01-17,16:16
023 Les Arceaux,0,16,16,2022,01-17,16:16
024 Cit� Mion,2,6,8,2022,01-17,16:16
025 Nouveau Saint-Roch,6,2,8,2022,01-17,16:16
026 Renouvier,0,8,8,2022,01-17,16:16
027 Odysseum,6,2,8,2022,01-17,16:16
028 Saint-Denis,3,5,8,2022,01-17,16:16
029 Richter,9,7,16,2022,01-17,16:16
030 Charles Flahault,4,4,8,2022,01-17,16:16
031 Voltaire,3,5,8,2022,01-17,16:16
032 Pr�s d'Ar�nes,6,2,8,2022,01-17,16:16
033 Garcia Lorca,6,2,8,2022,01-17,16:16
034 Vert Bois,0,16,16,2022,01-17,16:16
035 Malbosc,3,5,8,2022,01-17,16:16
036 Occitanie,4,28,32,2022,01-17,16:16
037 FacdesSciences,13,11,24,2022,01-17,16:16
038 Fac de Lettres,6,10,16,2022,01-17,16:16
039 Aiguelongue,3,5,8,2022,01-17,16:16
040 Jeu de Mail des Abb�s,8,0,8,2022,01-17,16:16
041 Eurom�decine,4,4,8,2022,01-17,16:16
042 Marie Caizergues,0,8,8,2022,01-17,16:16
043 Sabines,0,8,8,2022,01-17,16:16
044 Celleneuve,1,7,8,2022,01-17,16:16
045 Jardin de la Lironde,6,2,8,2022,01-17,16:16
046 P�re Soulas,4,4,8,2022,01-17,16:16
047 Place Viala,1,7,8,2022,01-17,16:16
048 H�tel du D�partement,0,8,8,2022,01-17,16:16
049 Tonnelles,5,3,8,2022,01-17,16:16
050 Parvis Jules Ferry - Gare Saint-Roch,7,1,8,2022,01-17,16:16
051 Pont de Lattes - Gare Saint-Roch,1,11,12,2022,01-17,16:16
053 Deux Ponts - Gare Saint-Roch,3,5,8,2022,01-17,16:16
054 Providence - Ovalie,3,5,8,2022,01-17,16:16
055 P�rols Etang de l'Or,24,44,68,2022,01-17,16:16
056 Albert 1er - Cath�drale,2,10,12,2022,01-17,16:16
057 Saint-Guilhem - Courreau,0,8,8,2022,01-17,16:16
059 Sud De France,0,8,8,2022,01-17,16:16
001 Rue Jules Ferry - Gare Saint-Roch,8,4,12,2022,01-17,16:26
002 Com�die,13,11,24,2022,01-17,16:26
003 Esplanade,9,23,32,2022,01-17,16:26
004 H�tel de Ville,12,4,16,2022,01-17,16:26
005 Corum,9,3,12,2022,01-17,16:26
006 Place Albert 1er - St Charles,9,22,31,2022,01-17,16:26
007 Foch,1,7,8,2022,01-17,16:26
008 Halles Castellane,3,9,12,2022,01-17,16:26
009 Observatoire,8,0,8,2022,01-17,16:26
010 Rondelet,3,13,16,2022,01-17,16:26
011 Plan Cabanes,1,11,12,2022,01-17,16:26
012 Boutonnet,6,6,12,2022,01-17,16:26
013 Emile Combes,7,1,8,2022,01-17,16:26
014 Beaux-Arts,5,3,8,2022,01-17,16:26
015 Les Aubes,5,2,8,2022,01-17,16:26
016 Antigone centre,11,5,16,2022,01-17,16:26
017 M�diath�que Emile Zola,5,11,16,2022,01-17,16:26
018 Nombre d'Or,14,2,16,2022,01-17,16:26
019 Louis Blanc,3,13,16,2022,01-17,16:26
020 Gambetta,5,3,8,2022,01-17,16:26
021 Port Marianne,2,14,16,2022,01-17,16:26
022 Clemenceau,4,8,12,2022,01-17,16:26
023 Les Arceaux,0,16,16,2022,01-17,16:26
024 Cit� Mion,2,6,8,2022,01-17,16:26
025 Nouveau Saint-Roch,6,2,8,2022,01-17,16:26
026 Renouvier,0,8,8,2022,01-17,16:26
027 Odysseum,6,2,8,2022,01-17,16:26
028 Saint-Denis,3,5,8,2022,01-17,16:26
029 Richter,9,7,16,2022,01-17,16:26
030 Charles Flahault,4,4,8,2022,01-17,16:26
031 Voltaire,3,5,8,2022,01-17,16:26
032 Pr�s d'Ar�nes,6,2,8,2022,01-17,16:26
033 Garcia Lorca,8,0,8,2022,01-17,16:26
034 Vert Bois,0,16,16,2022,01-17,16:26
035 Malbosc,3,5,8,2022,01-17,16:26
036 Occitanie,4,28,32,2022,01-17,16:26
037 FacdesSciences,12,12,24,2022,01-17,16:26
038 Fac de Lettres,6,10,16,2022,01-17,16:26
039 Aiguelongue,3,5,8,2022,01-17,16:26
040 Jeu de Mail des Abb�s,8,0,8,2022,01-17,16:26
041 Eurom�decine,4,4,8,2022,01-17,16:26
042 Marie Caizergues,0,8,8,2022,01-17,16:26
043 Sabines,0,8,8,2022,01-17,16:26
044 Celleneuve,1,7,8,2022,01-17,16:26
045 Jardin de la Lironde,6,2,8,2022,01-17,16:26
046 P�re Soulas,4,4,8,2022,01-17,16:26
047 Place Viala,2,6,8,2022,01-17,16:26
048 H�tel du D�partement,0,8,8,2022,01-17,16:26
049 Tonnelles,5,3,8,2022,01-17,16:26
050 Parvis Jules Ferry - Gare Saint-Roch,8,0,8,2022,01-17,16:26
051 Pont de Lattes - Gare Saint-Roch,1,11,12,2022,01-17,16:26
053 Deux Ponts - Gare Saint-Roch,3,5,8,2022,01-17,16:26
054 Providence - Ovalie,3,5,8,2022,01-17,16:26
055 P�rols Etang de l'Or,24,44,68,2022,01-17,16:26
056 Albert 1er - Cath�drale,2,10,12,2022,01-17,16:26
057 Saint-Guilhem - Courreau,0,8,8,2022,01-17,16:26
059 Sud De France,0,8,8,2022,01-17,16:26
001 Rue Jules Ferry - Gare Saint-Roch,8,4,12,2022,01-17,16:36
002 Com�die,12,12,24,2022,01-17,16:36
003 Esplanade,8,24,32,2022,01-17,16:36
004 H�tel de Ville,12,4,16,2022,01-17,16:36
005 Corum,8,4,12,2022,01-17,16:36
006 Place Albert 1er - St Charles,10,21,31,2022,01-17,16:36
007 Foch,1,7,8,2022,01-17,16:36
008 Halles Castellane,3,9,12,2022,01-17,16:36
009 Observatoire,8,0,8,2022,01-17,16:36
010 Rondelet,3,13,16,2022,01-17,16:36
011 Plan Cabanes,1,11,12,2022,01-17,16:36
012 Boutonnet,6,6,12,2022,01-17,16:36
013 Emile Combes,7,1,8,2022,01-17,16:36
014 Beaux-Arts,5,3,8,2022,01-17,16:36
015 Les Aubes,5,2,8,2022,01-17,16:36
016 Antigone centre,11,5,16,2022,01-17,16:36
017 M�diath�que Emile Zola,6,10,16,2022,01-17,16:36
018 Nombre d'Or,14,2,16,2022,01-17,16:36
019 Louis Blanc,3,13,16,2022,01-17,16:36
020 Gambetta,5,3,8,2022,01-17,16:36
021 Port Marianne,3,13,16,2022,01-17,16:36
022 Clemenceau,4,8,12,2022,01-17,16:36
023 Les Arceaux,0,16,16,2022,01-17,16:36
024 Cit� Mion,2,6,8,2022,01-17,16:36
025 Nouveau Saint-Roch,6,2,8,2022,01-17,16:36
026 Renouvier,0,8,8,2022,01-17,16:36
027 Odysseum,6,2,8,2022,01-17,16:36
028 Saint-Denis,3,5,8,2022,01-17,16:36
029 Richter,8,8,16,2022,01-17,16:36
030 Charles Flahault,4,4,8,2022,01-17,16:36
031 Voltaire,3,5,8,2022,01-17,16:36
032 Pr�s d'Ar�nes,6,2,8,2022,01-17,16:36
033 Garcia Lorca,8,0,8,2022,01-17,16:36
034 Vert Bois,0,16,16,2022,01-17,16:36
035 Malbosc,3,5,8,2022,01-17,16:36
036 Occitanie,3,29,32,2022,01-17,16:36
037 FacdesSciences,13,11,24,2022,01-17,16:36
038 Fac de Lettres,6,10,16,2022,01-17,16:36
039 Aiguelongue,6,2,8,2022,01-17,16:36
040 Jeu de Mail des Abb�s,8,0,8,2022,01-17,16:36
041 Eurom�decine,4,4,8,2022,01-17,16:36
042 Marie Caizergues,0,8,8,2022,01-17,16:36
043 Sabines,0,8,8,2022,01-17,16:36
044 Celleneuve,1,7,8,2022,01-17,16:36
045 Jardin de la Lironde,6,2,8,2022,01-17,16:36
046 P�re Soulas,4,4,8,2022,01-17,16:36
047 Place Viala,3,5,8,2022,01-17,16:36
048 H�tel du D�partement,0,8,8,2022,01-17,16:36
049 Tonnelles,5,3,8,2022,01-17,16:36
050 Parvis Jules Ferry - Gare Saint-Roch,8,0,8,2022,01-17,16:36
051 Pont de Lattes - Gare Saint-Roch,1,11,12,2022,01-17,16:36
053 Deux Ponts - Gare Saint-Roch,3,5,8,2022,01-17,16:36
054 Providence - Ovalie,3,5,8,2022,01-17,16:36
055 P�rols Etang de l'Or,23,45,68,2022,01-17,16:36
056 Albert 1er - Cath�drale,2,10,12,2022,01-17,16:36
057 Saint-Guilhem - Courreau,0,8,8,2022,01-17,16:36
059 Sud De France,0,8,8,2022,01-17,16:36
001 Rue Jules Ferry - Gare Saint-Roch,8,4,12,2022,01-17,16:46
002 Com�die,12,12,24,2022,01-17,16:46
003 Esplanade,7,25,32,2022,01-17,16:46
004 H�tel de Ville,12,4,16,2022,01-17,16:46
005 Corum,7,5,12,2022,01-17,16:46
006 Place Albert 1er - St Charles,12,19,31,2022,01-17,16:46
007 Foch,1,7,8,2022,01-17,16:46
008 Halles Castellane,2,10,12,2022,01-17,16:46
009 Observatoire,8,0,8,2022,01-17,16:46
010 Rondelet,3,13,16,2022,01-17,16:46
011 Plan Cabanes,1,11,12,2022,01-17,16:46
012 Boutonnet,6,6,12,2022,01-17,16:46
013 Emile Combes,7,1,8,2022,01-17,16:46
014 Beaux-Arts,5,3,8,2022,01-17,16:46
015 Les Aubes,5,2,8,2022,01-17,16:46
016 Antigone centre,11,5,16,2022,01-17,16:46
017 M�diath�que Emile Zola,6,10,16,2022,01-17,16:46
018 Nombre d'Or,14,2,16,2022,01-17,16:46
019 Louis Blanc,3,13,16,2022,01-17,16:46
020 Gambetta,5,3,8,2022,01-17,16:46
021 Port Marianne,3,13,16,2022,01-17,16:46
022 Clemenceau,4,8,12,2022,01-17,16:46
023 Les Arceaux,0,16,16,2022,01-17,16:46
024 Cit� Mion,2,6,8,2022,01-17,16:46
025 Nouveau Saint-Roch,6,2,8,2022,01-17,16:46
026 Renouvier,0,8,8,2022,01-17,16:46
027 Odysseum,5,3,8,2022,01-17,16:46
028 Saint-Denis,3,5,8,2022,01-17,16:46
029 Richter,8,8,16,2022,01-17,16:46
030 Charles Flahault,4,4,8,2022,01-17,16:46
031 Voltaire,3,5,8,2022,01-17,16:46
032 Pr�s d'Ar�nes,6,2,8,2022,01-17,16:46
033 Garcia Lorca,8,0,8,2022,01-17,16:46
034 Vert Bois,0,16,16,2022,01-17,16:46
035 Malbosc,3,5,8,2022,01-17,16:46
036 Occitanie,3,29,32,2022,01-17,16:46
037 FacdesSciences,10,14,24,2022,01-17,16:46
038 Fac de Lettres,6,10,16,2022,01-17,16:46
039 Aiguelongue,6,2,8,2022,01-17,16:46
040 Jeu de Mail des Abb�s,8,0,8,2022,01-17,16:46
041 Eurom�decine,4,4,8,2022,01-17,16:46
042 Marie Caizergues,0,8,8,2022,01-17,16:46
043 Sabines,0,8,8,2022,01-17,16:46
044 Celleneuve,1,7,8,2022,01-17,16:46
045 Jardin de la Lironde,6,2,8,2022,01-17,16:46
046 P�re Soulas,4,4,8,2022,01-17,16:46
047 Place Viala,3,5,8,2022,01-17,16:46
048 H�tel du D�partement,0,8,8,2022,01-17,16:46
049 Tonnelles,5,3,8,2022,01-17,16:46
050 Parvis Jules Ferry - Gare Saint-Roch,8,0,8,2022,01-17,16:46
051 Pont de Lattes - Gare Saint-Roch,1,11,12,2022,01-17,16:46
053 Deux Ponts - Gare Saint-Roch,3,5,8,2022,01-17,16:46
054 Providence - Ovalie,3,5,8,2022,01-17,16:46
055 P�rols Etang de l'Or,21,47,68,2022,01-17,16:46
056 Albert 1er - Cath�drale,1,11,12,2022,01-17,16:46
057 Saint-Guilhem - Courreau,0,8,8,2022,01-17,16:46
059 Sud De France,0,8,8,2022,01-17,16:46
001 Rue Jules Ferry - Gare Saint-Roch,8,4,12,2022,01-17,16:56
002 Com�die,12,12,24,2022,01-17,16:56
003 Esplanade,7,25,32,2022,01-17,16:56
004 H�tel de Ville,12,4,16,2022,01-17,16:56
005 Corum,6,6,12,2022,01-17,16:56
006 Place Albert 1er - St Charles,12,19,31,2022,01-17,16:56
007 Foch,1,7,8,2022,01-17,16:56
008 Halles Castellane,2,10,12,2022,01-17,16:56
009 Observatoire,8,0,8,2022,01-17,16:56
010 Rondelet,3,13,16,2022,01-17,16:56
011 Plan Cabanes,1,11,12,2022,01-17,16:56
012 Boutonnet,7,5,12,2022,01-17,16:56
013 Emile Combes,7,1,8,2022,01-17,16:56
014 Beaux-Arts,6,2,8,2022,01-17,16:56
015 Les Aubes,5,2,8,2022,01-17,16:56
016 Antigone centre,11,5,16,2022,01-17,16:56
017 M�diath�que Emile Zola,9,7,16,2022,01-17,16:56
018 Nombre d'Or,14,2,16,2022,01-17,16:56
019 Louis Blanc,3,13,16,2022,01-17,16:56
020 Gambetta,5,3,8,2022,01-17,16:56
021 Port Marianne,3,13,16,2022,01-17,16:56
022 Clemenceau,4,8,12,2022,01-17,16:56
023 Les Arceaux,0,16,16,2022,01-17,16:56
024 Cit� Mion,2,6,8,2022,01-17,16:56
025 Nouveau Saint-Roch,6,2,8,2022,01-17,16:56
026 Renouvier,0,8,8,2022,01-17,16:56
027 Odysseum,5,3,8,2022,01-17,16:56
028 Saint-Denis,3,5,8,2022,01-17,16:56
029 Richter,8,8,16,2022,01-17,16:56
030 Charles Flahault,4,4,8,2022,01-17,16:56
031 Voltaire,3,5,8,2022,01-17,16:56
032 Pr�s d'Ar�nes,6,2,8,2022,01-17,16:56
033 Garcia Lorca,8,0,8,2022,01-17,16:56
034 Vert Bois,0,16,16,2022,01-17,16:56
035 Malbosc,3,5,8,2022,01-17,16:56
036 Occitanie,3,29,32,2022,01-17,16:56
037 FacdesSciences,8,16,24,2022,01-17,16:56
038 Fac de Lettres,6,10,16,2022,01-17,16:56
039 Aiguelongue,6,2,8,2022,01-17,16:56
040 Jeu de Mail des Abb�s,8,0,8,2022,01-17,16:56
041 Eurom�decine,4,4,8,2022,01-17,16:56
042 Marie Caizergues,1,7,8,2022,01-17,16:56
043 Sabines,0,8,8,2022,01-17,16:56
044 Celleneuve,1,7,8,2022,01-17,16:56
045 Jardin de la Lironde,6,2,8,2022,01-17,16:56
046 P�re Soulas,4,4,8,2022,01-17,16:56
047 Place Viala,3,5,8,2022,01-17,16:56
048 H�tel du D�partement,0,8,8,2022,01-17,16:56
049 Tonnelles,5,3,8,2022,01-17,16:56
050 Parvis Jules Ferry - Gare Saint-Roch,8,0,8,2022,01-17,16:56
051 Pont de Lattes - Gare Saint-Roch,1,11,12,2022,01-17,16:56
053 Deux Ponts - Gare Saint-Roch,3,5,8,2022,01-17,16:56
054 Providence - Ovalie,3,5,8,2022,01-17,16:56
055 P�rols Etang de l'Or,21,47,68,2022,01-17,16:56
056 Albert 1er - Cath�drale,1,11,12,2022,01-17,16:56
057 Saint-Guilhem - Courreau,0,8,8,2022,01-17,16:56
059 Sud De France,0,8,8,2022,01-17,16:56
001 Rue Jules Ferry - Gare Saint-Roch,8,4,12,2022,01-17,17:07
002 Com�die,12,12,24,2022,01-17,17:07
003 Esplanade,7,25,32,2022,01-17,17:07
004 H�tel de Ville,12,4,16,2022,01-17,17:07
005 Corum,5,7,12,2022,01-17,17:07
006 Place Albert 1er - St Charles,13,18,31,2022,01-17,17:07
007 Foch,2,6,8,2022,01-17,17:07
008 Halles Castellane,2,10,12,2022,01-17,17:07
009 Observatoire,8,0,8,2022,01-17,17:07
010 Rondelet,3,13,16,2022,01-17,17:07
011 Plan Cabanes,1,11,12,2022,01-17,17:07
012 Boutonnet,5,7,12,2022,01-17,17:07
013 Emile Combes,7,1,8,2022,01-17,17:07
014 Beaux-Arts,6,2,8,2022,01-17,17:07
015 Les Aubes,6,1,8,2022,01-17,17:07
016 Antigone centre,11,5,16,2022,01-17,17:07
017 M�diath�que Emile Zola,10,6,16,2022,01-17,17:07
018 Nombre d'Or,15,1,16,2022,01-17,17:07
019 Louis Blanc,3,13,16,2022,01-17,17:07
020 Gambetta,5,3,8,2022,01-17,17:07
021 Port Marianne,3,13,16,2022,01-17,17:07
022 Clemenceau,4,8,12,2022,01-17,17:07
023 Les Arceaux,0,16,16,2022,01-17,17:07
024 Cit� Mion,2,6,8,2022,01-17,17:07
025 Nouveau Saint-Roch,7,1,8,2022,01-17,17:07
026 Renouvier,0,8,8,2022,01-17,17:07
027 Odysseum,5,3,8,2022,01-17,17:07
028 Saint-Denis,3,5,8,2022,01-17,17:07
029 Richter,8,8,16,2022,01-17,17:07
030 Charles Flahault,4,4,8,2022,01-17,17:07
031 Voltaire,3,5,8,2022,01-17,17:07
032 Pr�s d'Ar�nes,6,2,8,2022,01-17,17:07
033 Garcia Lorca,8,0,8,2022,01-17,17:07
034 Vert Bois,0,16,16,2022,01-17,17:07
035 Malbosc,1,7,8,2022,01-17,17:07
036 Occitanie,4,28,32,2022,01-17,17:07
037 FacdesSciences,7,17,24,2022,01-17,17:07
038 Fac de Lettres,5,11,16,2022,01-17,17:07
039 Aiguelongue,6,2,8,2022,01-17,17:07
040 Jeu de Mail des Abb�s,8,0,8,2022,01-17,17:07
041 Eurom�decine,4,4,8,2022,01-17,17:07
042 Marie Caizergues,1,7,8,2022,01-17,17:07
043 Sabines,0,8,8,2022,01-17,17:07
044 Celleneuve,1,7,8,2022,01-17,17:07
045 Jardin de la Lironde,6,2,8,2022,01-17,17:07
046 P�re Soulas,4,4,8,2022,01-17,17:07
047 Place Viala,3,5,8,2022,01-17,17:07
048 H�tel du D�partement,0,8,8,2022,01-17,17:07
049 Tonnelles,5,3,8,2022,01-17,17:07
050 Parvis Jules Ferry - Gare Saint-Roch,8,0,8,2022,01-17,17:07
051 Pont de Lattes - Gare Saint-Roch,1,11,12,2022,01-17,17:07
053 Deux Ponts - Gare Saint-Roch,3,5,8,2022,01-17,17:07
054 Providence - Ovalie,3,5,8,2022,01-17,17:07
055 P�rols Etang de l'Or,21,47,68,2022,01-17,17:07
056 Albert 1er - Cath�drale,1,11,12,2022,01-17,17:07
057 Saint-Guilhem - Courreau,0,8,8,2022,01-17,17:07
059 Sud De France,0,8,8,2022,01-17,17:07
001 Rue Jules Ferry - Gare Saint-Roch,8,4,12,2022,01-17,17:17
002 Com�die,13,11,24,2022,01-17,17:17
003 Esplanade,7,25,32,2022,01-17,17:17
004 H�tel de Ville,13,3,16,2022,01-17,17:17
005 Corum,6,6,12,2022,01-17,17:17
006 Place Albert 1er - St Charles,13,18,31,2022,01-17,17:17
007 Foch,2,6,8,2022,01-17,17:17
008 Halles Castellane,2,10,12,2022,01-17,17:17
009 Observatoire,8,0,8,2022,01-17,17:17
010 Rondelet,3,13,16,2022,01-17,17:17
011 Plan Cabanes,1,11,12,2022,01-17,17:17
012 Boutonnet,4,8,12,2022,01-17,17:17
013 Emile Combes,7,1,8,2022,01-17,17:17
014 Beaux-Arts,6,2,8,2022,01-17,17:17
015 Les Aubes,6,1,8,2022,01-17,17:17
016 Antigone centre,11,5,16,2022,01-17,17:17
017 M�diath�que Emile Zola,9,7,16,2022,01-17,17:17
018 Nombre d'Or,15,1,16,2022,01-17,17:17
019 Louis Blanc,3,13,16,2022,01-17,17:17
020 Gambetta,5,3,8,2022,01-17,17:17
021 Port Marianne,3,13,16,2022,01-17,17:17
022 Clemenceau,4,8,12,2022,01-17,17:17
023 Les Arceaux,0,16,16,2022,01-17,17:17
024 Cit� Mion,2,6,8,2022,01-17,17:17
025 Nouveau Saint-Roch,7,1,8,2022,01-17,17:17
026 Renouvier,0,8,8,2022,01-17,17:17
027 Odysseum,5,3,8,2022,01-17,17:17
028 Saint-Denis,3,5,8,2022,01-17,17:17
029 Richter,8,8,16,2022,01-17,17:17
030 Charles Flahault,4,4,8,2022,01-17,17:17
031 Voltaire,3,5,8,2022,01-17,17:17
032 Pr�s d'Ar�nes,5,3,8,2022,01-17,17:17
033 Garcia Lorca,8,0,8,2022,01-17,17:17
034 Vert Bois,0,16,16,2022,01-17,17:17
035 Malbosc,1,7,8,2022,01-17,17:17
036 Occitanie,4,28,32,2022,01-17,17:17
037 FacdesSciences,3,21,24,2022,01-17,17:17
038 Fac de Lettres,6,10,16,2022,01-17,17:17
039 Aiguelongue,6,2,8,2022,01-17,17:17
040 Jeu de Mail des Abb�s,8,0,8,2022,01-17,17:17
041 Eurom�decine,4,4,8,2022,01-17,17:17
042 Marie Caizergues,1,7,8,2022,01-17,17:17
043 Sabines,0,8,8,2022,01-17,17:17
044 Celleneuve,1,7,8,2022,01-17,17:17
045 Jardin de la Lironde,6,2,8,2022,01-17,17:17
046 P�re Soulas,5,3,8,2022,01-17,17:17
047 Place Viala,5,3,8,2022,01-17,17:17
048 H�tel du D�partement,0,8,8,2022,01-17,17:17
049 Tonnelles,5,3,8,2022,01-17,17:17
050 Parvis Jules Ferry - Gare Saint-Roch,7,1,8,2022,01-17,17:17
051 Pont de Lattes - Gare Saint-Roch,2,10,12,2022,01-17,17:17
053 Deux Ponts - Gare Saint-Roch,3,5,8,2022,01-17,17:17
054 Providence - Ovalie,3,5,8,2022,01-17,17:17
055 P�rols Etang de l'Or,21,47,68,2022,01-17,17:17
056 Albert 1er - Cath�drale,1,11,12,2022,01-17,17:17
057 Saint-Guilhem - Courreau,0,8,8,2022,01-17,17:17
059 Sud De France,0,8,8,2022,01-17,17:17
001 Rue Jules Ferry - Gare Saint-Roch,7,5,12,2022,01-17,17:27
002 Com�die,13,11,24,2022,01-17,17:27
003 Esplanade,6,26,32,2022,01-17,17:27
004 H�tel de Ville,13,3,16,2022,01-17,17:27
005 Corum,6,6,12,2022,01-17,17:27
006 Place Albert 1er - St Charles,13,18,31,2022,01-17,17:27
007 Foch,2,6,8,2022,01-17,17:27
008 Halles Castellane,2,10,12,2022,01-17,17:27
009 Observatoire,7,1,8,2022,01-17,17:27
010 Rondelet,3,13,16,2022,01-17,17:27
011 Plan Cabanes,1,11,12,2022,01-17,17:27
012 Boutonnet,4,8,12,2022,01-17,17:27
013 Emile Combes,7,1,8,2022,01-17,17:27
014 Beaux-Arts,7,1,8,2022,01-17,17:27
015 Les Aubes,6,1,8,2022,01-17,17:27
016 Antigone centre,11,5,16,2022,01-17,17:27
017 M�diath�que Emile Zola,8,8,16,2022,01-17,17:27
018 Nombre d'Or,15,1,16,2022,01-17,17:27
019 Louis Blanc,5,11,16,2022,01-17,17:27
020 Gambetta,5,3,8,2022,01-17,17:27
021 Port Marianne,5,11,16,2022,01-17,17:27
022 Clemenceau,4,8,12,2022,01-17,17:27
023 Les Arceaux,0,16,16,2022,01-17,17:27
024 Cit� Mion,2,6,8,2022,01-17,17:27
025 Nouveau Saint-Roch,7,1,8,2022,01-17,17:27
026 Renouvier,0,8,8,2022,01-17,17:27
027 Odysseum,8,0,8,2022,01-17,17:27
028 Saint-Denis,3,5,8,2022,01-17,17:27
029 Richter,8,8,16,2022,01-17,17:27
030 Charles Flahault,4,4,8,2022,01-17,17:27
031 Voltaire,3,5,8,2022,01-17,17:27
032 Pr�s d'Ar�nes,5,3,8,2022,01-17,17:27
033 Garcia Lorca,8,0,8,2022,01-17,17:27
034 Vert Bois,0,16,16,2022,01-17,17:27
035 Malbosc,1,7,8,2022,01-17,17:27
036 Occitanie,3,29,32,2022,01-17,17:27
037 FacdesSciences,3,21,24,2022,01-17,17:27
038 Fac de Lettres,5,11,16,2022,01-17,17:27
039 Aiguelongue,8,0,8,2022,01-17,17:27
040 Jeu de Mail des Abb�s,8,0,8,2022,01-17,17:27
041 Eurom�decine,4,4,8,2022,01-17,17:27
042 Marie Caizergues,1,7,8,2022,01-17,17:27
043 Sabines,0,8,8,2022,01-17,17:27
044 Celleneuve,1,7,8,2022,01-17,17:27
045 Jardin de la Lironde,6,2,8,2022,01-17,17:27
046 P�re Soulas,3,5,8,2022,01-17,17:27
047 Place Viala,4,4,8,2022,01-17,17:27
048 H�tel du D�partement,0,8,8,2022,01-17,17:27
049 Tonnelles,5,3,8,2022,01-17,17:27
050 Parvis Jules Ferry - Gare Saint-Roch,6,2,8,2022,01-17,17:27
051 Pont de Lattes - Gare Saint-Roch,2,10,12,2022,01-17,17:27
053 Deux Ponts - Gare Saint-Roch,3,5,8,2022,01-17,17:27
054 Providence - Ovalie,3,5,8,2022,01-17,17:27
055 P�rols Etang de l'Or,21,47,68,2022,01-17,17:27
056 Albert 1er - Cath�drale,0,12,12,2022,01-17,17:27
057 Saint-Guilhem - Courreau,0,8,8,2022,01-17,17:27
059 Sud De France,0,8,8,2022,01-17,17:27
001 Rue Jules Ferry - Gare Saint-Roch,7,5,12,2022,01-17,17:37
002 Com�die,13,11,24,2022,01-17,17:37
003 Esplanade,6,26,32,2022,01-17,17:37
004 H�tel de Ville,13,3,16,2022,01-17,17:37
005 Corum,7,5,12,2022,01-17,17:37
006 Place Albert 1er - St Charles,14,17,31,2022,01-17,17:37
007 Foch,2,6,8,2022,01-17,17:37
008 Halles Castellane,2,10,12,2022,01-17,17:37
009 Observatoire,7,1,8,2022,01-17,17:37
010 Rondelet,3,13,16,2022,01-17,17:37
011 Plan Cabanes,1,11,12,2022,01-17,17:37
012 Boutonnet,4,8,12,2022,01-17,17:37
013 Emile Combes,7,1,8,2022,01-17,17:37
014 Beaux-Arts,8,0,8,2022,01-17,17:37
015 Les Aubes,6,1,8,2022,01-17,17:37
016 Antigone centre,11,5,16,2022,01-17,17:37
017 M�diath�que Emile Zola,8,8,16,2022,01-17,17:37
018 Nombre d'Or,15,1,16,2022,01-17,17:37
019 Louis Blanc,7,9,16,2022,01-17,17:37
020 Gambetta,5,3,8,2022,01-17,17:37
021 Port Marianne,5,11,16,2022,01-17,17:37
022 Clemenceau,4,8,12,2022,01-17,17:37
023 Les Arceaux,0,16,16,2022,01-17,17:37
024 Cit� Mion,2,6,8,2022,01-17,17:37
025 Nouveau Saint-Roch,6,2,8,2022,01-17,17:37
026 Renouvier,0,8,8,2022,01-17,17:37
027 Odysseum,8,0,8,2022,01-17,17:37
028 Saint-Denis,4,4,8,2022,01-17,17:37
029 Richter,8,8,16,2022,01-17,17:37
030 Charles Flahault,4,4,8,2022,01-17,17:37
031 Voltaire,3,5,8,2022,01-17,17:37
032 Pr�s d'Ar�nes,5,3,8,2022,01-17,17:37
033 Garcia Lorca,8,0,8,2022,01-17,17:37
034 Vert Bois,0,16,16,2022,01-17,17:37
035 Malbosc,1,7,8,2022,01-17,17:37
036 Occitanie,2,30,32,2022,01-17,17:37
037 FacdesSciences,2,22,24,2022,01-17,17:37
038 Fac de Lettres,4,12,16,2022,01-17,17:37
039 Aiguelongue,6,2,8,2022,01-17,17:37
040 Jeu de Mail des Abb�s,8,0,8,2022,01-17,17:37
041 Eurom�decine,4,4,8,2022,01-17,17:37
042 Marie Caizergues,1,7,8,2022,01-17,17:37
043 Sabines,0,8,8,2022,01-17,17:37
044 Celleneuve,1,7,8,2022,01-17,17:37
045 Jardin de la Lironde,6,2,8,2022,01-17,17:37
046 P�re Soulas,3,5,8,2022,01-17,17:37
047 Place Viala,4,4,8,2022,01-17,17:37
048 H�tel du D�partement,0,8,8,2022,01-17,17:37
049 Tonnelles,5,3,8,2022,01-17,17:37
050 Parvis Jules Ferry - Gare Saint-Roch,6,2,8,2022,01-17,17:37
051 Pont de Lattes - Gare Saint-Roch,1,11,12,2022,01-17,17:37
053 Deux Ponts - Gare Saint-Roch,3,5,8,2022,01-17,17:37
054 Providence - Ovalie,3,5,8,2022,01-17,17:37
055 P�rols Etang de l'Or,24,44,68,2022,01-17,17:37
056 Albert 1er - Cath�drale,0,12,12,2022,01-17,17:37
057 Saint-Guilhem - Courreau,1,7,8,2022,01-17,17:37
059 Sud De France,0,8,8,2022,01-17,17:37
001 Rue Jules Ferry - Gare Saint-Roch,7,5,12,2022,01-17,17:47
002 Com�die,13,11,24,2022,01-17,17:47
003 Esplanade,6,26,32,2022,01-17,17:47
004 H�tel de Ville,13,3,16,2022,01-17,17:47
005 Corum,7,5,12,2022,01-17,17:47
006 Place Albert 1er - St Charles,15,16,31,2022,01-17,17:47
007 Foch,2,6,8,2022,01-17,17:47
008 Halles Castellane,2,10,12,2022,01-17,17:47
009 Observatoire,8,0,8,2022,01-17,17:47
010 Rondelet,3,13,16,2022,01-17,17:47
011 Plan Cabanes,1,11,12,2022,01-17,17:47
012 Boutonnet,4,8,12,2022,01-17,17:47
013 Emile Combes,7,1,8,2022,01-17,17:47
014 Beaux-Arts,8,0,8,2022,01-17,17:47
015 Les Aubes,6,1,8,2022,01-17,17:47
016 Antigone centre,10,6,16,2022,01-17,17:47
017 M�diath�que Emile Zola,7,9,16,2022,01-17,17:47
018 Nombre d'Or,15,1,16,2022,01-17,17:47
019 Louis Blanc,7,9,16,2022,01-17,17:47
020 Gambetta,5,3,8,2022,01-17,17:47
021 Port Marianne,5,11,16,2022,01-17,17:47
022 Clemenceau,3,9,12,2022,01-17,17:47
023 Les Arceaux,0,16,16,2022,01-17,17:47
024 Cit� Mion,2,6,8,2022,01-17,17:47
025 Nouveau Saint-Roch,5,3,8,2022,01-17,17:47
026 Renouvier,0,8,8,2022,01-17,17:47
027 Odysseum,7,1,8,2022,01-17,17:47
028 Saint-Denis,4,4,8,2022,01-17,17:47
029 Richter,8,8,16,2022,01-17,17:47
030 Charles Flahault,4,4,8,2022,01-17,17:47
031 Voltaire,3,5,8,2022,01-17,17:47
032 Pr�s d'Ar�nes,5,3,8,2022,01-17,17:47
033 Garcia Lorca,8,0,8,2022,01-17,17:47
034 Vert Bois,0,16,16,2022,01-17,17:47
035 Malbosc,1,7,8,2022,01-17,17:47
036 Occitanie,2,30,32,2022,01-17,17:47
037 FacdesSciences,4,20,24,2022,01-17,17:47
038 Fac de Lettres,3,13,16,2022,01-17,17:47
039 Aiguelongue,6,2,8,2022,01-17,17:47
040 Jeu de Mail des Abb�s,8,0,8,2022,01-17,17:47
041 Eurom�decine,4,4,8,2022,01-17,17:47
042 Marie Caizergues,1,7,8,2022,01-17,17:47
043 Sabines,0,8,8,2022,01-17,17:47
044 Celleneuve,1,7,8,2022,01-17,17:47
045 Jardin de la Lironde,6,2,8,2022,01-17,17:47
046 P�re Soulas,3,5,8,2022,01-17,17:47
047 Place Viala,4,4,8,2022,01-17,17:47
048 H�tel du D�partement,0,8,8,2022,01-17,17:47
049 Tonnelles,5,3,8,2022,01-17,17:47
050 Parvis Jules Ferry - Gare Saint-Roch,7,1,8,2022,01-17,17:47
051 Pont de Lattes - Gare Saint-Roch,1,11,12,2022,01-17,17:47
053 Deux Ponts - Gare Saint-Roch,3,5,8,2022,01-17,17:47
054 Providence - Ovalie,3,5,8,2022,01-17,17:47
055 P�rols Etang de l'Or,24,44,68,2022,01-17,17:47
056 Albert 1er - Cath�drale,0,12,12,2022,01-17,17:47
057 Saint-Guilhem - Courreau,1,7,8,2022,01-17,17:47
059 Sud De France,0,8,8,2022,01-17,17:47
001 Rue Jules Ferry - Gare Saint-Roch,7,5,12,2022,01-17,17:57
002 Com�die,13,11,24,2022,01-17,17:57
003 Esplanade,6,26,32,2022,01-17,17:57
004 H�tel de Ville,13,3,16,2022,01-17,17:57
005 Corum,7,5,12,2022,01-17,17:57
006 Place Albert 1er - St Charles,15,16,31,2022,01-17,17:57
007 Foch,2,6,8,2022,01-17,17:57
008 Halles Castellane,2,10,12,2022,01-17,17:57
009 Observatoire,7,1,8,2022,01-17,17:57
010 Rondelet,3,13,16,2022,01-17,17:57
011 Plan Cabanes,1,11,12,2022,01-17,17:57
012 Boutonnet,4,8,12,2022,01-17,17:57
013 Emile Combes,7,1,8,2022,01-17,17:57
014 Beaux-Arts,8,0,8,2022,01-17,17:57
015 Les Aubes,6,1,8,2022,01-17,17:57
016 Antigone centre,10,6,16,2022,01-17,17:57
017 M�diath�que Emile Zola,8,8,16,2022,01-17,17:57
018 Nombre d'Or,15,1,16,2022,01-17,17:57
019 Louis Blanc,8,8,16,2022,01-17,17:57
020 Gambetta,5,3,8,2022,01-17,17:57
021 Port Marianne,5,11,16,2022,01-17,17:57
022 Clemenceau,4,8,12,2022,01-17,17:57
023 Les Arceaux,0,16,16,2022,01-17,17:57
024 Cit� Mion,2,6,8,2022,01-17,17:57
025 Nouveau Saint-Roch,4,4,8,2022,01-17,17:57
026 Renouvier,0,8,8,2022,01-17,17:57
027 Odysseum,7,1,8,2022,01-17,17:57
028 Saint-Denis,4,4,8,2022,01-17,17:57
029 Richter,8,8,16,2022,01-17,17:57
030 Charles Flahault,5,3,8,2022,01-17,17:57
031 Voltaire,3,5,8,2022,01-17,17:57
032 Pr�s d'Ar�nes,5,3,8,2022,01-17,17:57
033 Garcia Lorca,8,0,8,2022,01-17,17:57
034 Vert Bois,0,16,16,2022,01-17,17:57
035 Malbosc,1,7,8,2022,01-17,17:57
036 Occitanie,2,30,32,2022,01-17,17:57
037 FacdesSciences,3,21,24,2022,01-17,17:57
038 Fac de Lettres,3,13,16,2022,01-17,17:57
039 Aiguelongue,5,3,8,2022,01-17,17:57
040 Jeu de Mail des Abb�s,8,0,8,2022,01-17,17:57
041 Eurom�decine,4,4,8,2022,01-17,17:57
042 Marie Caizergues,1,7,8,2022,01-17,17:57
043 Sabines,0,8,8,2022,01-17,17:57
044 Celleneuve,1,7,8,2022,01-17,17:57
045 Jardin de la Lironde,7,1,8,2022,01-17,17:57
046 P�re Soulas,3,5,8,2022,01-17,17:57
047 Place Viala,4,4,8,2022,01-17,17:57
048 H�tel du D�partement,0,8,8,2022,01-17,17:57
049 Tonnelles,5,3,8,2022,01-17,17:57
050 Parvis Jules Ferry - Gare Saint-Roch,6,2,8,2022,01-17,17:57
051 Pont de Lattes - Gare Saint-Roch,1,11,12,2022,01-17,17:57
053 Deux Ponts - Gare Saint-Roch,3,5,8,2022,01-17,17:57
054 Providence - Ovalie,3,5,8,2022,01-17,17:57
055 P�rols Etang de l'Or,24,44,68,2022,01-17,17:57
056 Albert 1er - Cath�drale,0,12,12,2022,01-17,17:57
057 Saint-Guilhem - Courreau,1,7,8,2022,01-17,17:57
059 Sud De France,0,8,8,2022,01-17,17:57
001 Rue Jules Ferry - Gare Saint-Roch,7,5,12,2022,01-17,18:08
002 Com�die,13,11,24,2022,01-17,18:08
003 Esplanade,6,26,32,2022,01-17,18:08
004 H�tel de Ville,13,3,16,2022,01-17,18:08
005 Corum,8,4,12,2022,01-17,18:08
006 Place Albert 1er - St Charles,15,16,31,2022,01-17,18:08
007 Foch,2,6,8,2022,01-17,18:08
008 Halles Castellane,2,10,12,2022,01-17,18:08
009 Observatoire,7,1,8,2022,01-17,18:08
010 Rondelet,4,12,16,2022,01-17,18:08
011 Plan Cabanes,2,10,12,2022,01-17,18:08
012 Boutonnet,4,8,12,2022,01-17,18:08
013 Emile Combes,6,2,8,2022,01-17,18:08
014 Beaux-Arts,8,0,8,2022,01-17,18:08
015 Les Aubes,6,1,8,2022,01-17,18:08
016 Antigone centre,10,6,16,2022,01-17,18:08
017 M�diath�que Emile Zola,9,7,16,2022,01-17,18:08
018 Nombre d'Or,15,1,16,2022,01-17,18:08
019 Louis Blanc,9,7,16,2022,01-17,18:08
020 Gambetta,5,3,8,2022,01-17,18:08
021 Port Marianne,6,10,16,2022,01-17,18:08
022 Clemenceau,5,7,12,2022,01-17,18:08
023 Les Arceaux,0,16,16,2022,01-17,18:08
024 Cit� Mion,2,6,8,2022,01-17,18:08
025 Nouveau Saint-Roch,4,4,8,2022,01-17,18:08
026 Renouvier,0,8,8,2022,01-17,18:08
027 Odysseum,7,1,8,2022,01-17,18:08
028 Saint-Denis,4,4,8,2022,01-17,18:08
029 Richter,8,8,16,2022,01-17,18:08
030 Charles Flahault,5,3,8,2022,01-17,18:08
031 Voltaire,3,5,8,2022,01-17,18:08
032 Pr�s d'Ar�nes,5,3,8,2022,01-17,18:08
033 Garcia Lorca,8,0,8,2022,01-17,18:08
034 Vert Bois,0,16,16,2022,01-17,18:08
035 Malbosc,1,7,8,2022,01-17,18:08
036 Occitanie,3,29,32,2022,01-17,18:08
037 FacdesSciences,3,21,24,2022,01-17,18:08
038 Fac de Lettres,3,13,16,2022,01-17,18:08
039 Aiguelongue,5,3,8,2022,01-17,18:08
040 Jeu de Mail des Abb�s,8,0,8,2022,01-17,18:08
041 Eurom�decine,4,4,8,2022,01-17,18:08
042 Marie Caizergues,1,7,8,2022,01-17,18:08
043 Sabines,1,7,8,2022,01-17,18:08
044 Celleneuve,1,7,8,2022,01-17,18:08
045 Jardin de la Lironde,7,1,8,2022,01-17,18:08
046 P�re Soulas,3,5,8,2022,01-17,18:08
047 Place Viala,4,4,8,2022,01-17,18:08
048 H�tel du D�partement,0,8,8,2022,01-17,18:08
049 Tonnelles,5,3,8,2022,01-17,18:08
050 Parvis Jules Ferry - Gare Saint-Roch,6,2,8,2022,01-17,18:08
051 Pont de Lattes - Gare Saint-Roch,2,10,12,2022,01-17,18:08
053 Deux Ponts - Gare Saint-Roch,3,5,8,2022,01-17,18:08
054 Providence - Ovalie,3,5,8,2022,01-17,18:08
055 P�rols Etang de l'Or,24,44,68,2022,01-17,18:08
056 Albert 1er - Cath�drale,0,12,12,2022,01-17,18:08
057 Saint-Guilhem - Courreau,1,7,8,2022,01-17,18:08
059 Sud De France,0,8,8,2022,01-17,18:08
001 Rue Jules Ferry - Gare Saint-Roch,7,5,12,2022,01-17,18:18
002 Com�die,13,11,24,2022,01-17,18:18
003 Esplanade,6,26,32,2022,01-17,18:18
004 H�tel de Ville,13,3,16,2022,01-17,18:18
005 Corum,7,5,12,2022,01-17,18:18
006 Place Albert 1er - St Charles,14,17,31,2022,01-17,18:18
007 Foch,2,6,8,2022,01-17,18:18
008 Halles Castellane,1,11,12,2022,01-17,18:18
009 Observatoire,7,1,8,2022,01-17,18:18
010 Rondelet,5,11,16,2022,01-17,18:18
011 Plan Cabanes,3,9,12,2022,01-17,18:18
012 Boutonnet,3,9,12,2022,01-17,18:18
013 Emile Combes,6,2,8,2022,01-17,18:18
014 Beaux-Arts,8,0,8,2022,01-17,18:18
015 Les Aubes,6,1,8,2022,01-17,18:18
016 Antigone centre,12,4,16,2022,01-17,18:18
017 M�diath�que Emile Zola,9,7,16,2022,01-17,18:18
018 Nombre d'Or,15,1,16,2022,01-17,18:18
019 Louis Blanc,9,7,16,2022,01-17,18:18
020 Gambetta,5,3,8,2022,01-17,18:18
021 Port Marianne,6,10,16,2022,01-17,18:18
022 Clemenceau,5,7,12,2022,01-17,18:18
023 Les Arceaux,0,16,16,2022,01-17,18:18
024 Cit� Mion,3,5,8,2022,01-17,18:18
025 Nouveau Saint-Roch,5,3,8,2022,01-17,18:18
026 Renouvier,0,8,8,2022,01-17,18:18
027 Odysseum,7,1,8,2022,01-17,18:18
028 Saint-Denis,4,4,8,2022,01-17,18:18
029 Richter,8,8,16,2022,01-17,18:18
030 Charles Flahault,5,3,8,2022,01-17,18:18
031 Voltaire,3,5,8,2022,01-17,18:18
032 Pr�s d'Ar�nes,5,3,8,2022,01-17,18:18
033 Garcia Lorca,8,0,8,2022,01-17,18:18
034 Vert Bois,0,16,16,2022,01-17,18:18
035 Malbosc,1,7,8,2022,01-17,18:18
036 Occitanie,3,29,32,2022,01-17,18:18
037 FacdesSciences,3,21,24,2022,01-17,18:18
038 Fac de Lettres,3,13,16,2022,01-17,18:18
039 Aiguelongue,6,2,8,2022,01-17,18:18
040 Jeu de Mail des Abb�s,8,0,8,2022,01-17,18:18
041 Eurom�decine,4,4,8,2022,01-17,18:18
042 Marie Caizergues,1,7,8,2022,01-17,18:18
043 Sabines,1,7,8,2022,01-17,18:18
044 Celleneuve,0,8,8,2022,01-17,18:18
045 Jardin de la Lironde,7,1,8,2022,01-17,18:18
046 P�re Soulas,3,5,8,2022,01-17,18:18
047 Place Viala,4,4,8,2022,01-17,18:18
048 H�tel du D�partement,0,8,8,2022,01-17,18:18
049 Tonnelles,5,3,8,2022,01-17,18:18
050 Parvis Jules Ferry - Gare Saint-Roch,6,2,8,2022,01-17,18:18
051 Pont de Lattes - Gare Saint-Roch,2,10,12,2022,01-17,18:18
053 Deux Ponts - Gare Saint-Roch,3,5,8,2022,01-17,18:18
054 Providence - Ovalie,3,5,8,2022,01-17,18:18
055 P�rols Etang de l'Or,24,44,68,2022,01-17,18:18
056 Albert 1er - Cath�drale,0,12,12,2022,01-17,18:18
057 Saint-Guilhem - Courreau,1,7,8,2022,01-17,18:18
059 Sud De France,0,8,8,2022,01-17,18:18
001 Rue Jules Ferry - Gare Saint-Roch,7,5,12,2022,01-17,18:28
002 Com�die,13,11,24,2022,01-17,18:28
003 Esplanade,5,27,32,2022,01-17,18:28
004 H�tel de Ville,13,3,16,2022,01-17,18:28
005 Corum,6,6,12,2022,01-17,18:28
006 Place Albert 1er - St Charles,14,17,31,2022,01-17,18:28
007 Foch,2,6,8,2022,01-17,18:28
008 Halles Castellane,1,11,12,2022,01-17,18:28
009 Observatoire,7,1,8,2022,01-17,18:28
010 Rondelet,5,11,16,2022,01-17,18:28
011 Plan Cabanes,2,10,12,2022,01-17,18:28
012 Boutonnet,1,11,12,2022,01-17,18:28
013 Emile Combes,6,2,8,2022,01-17,18:28
014 Beaux-Arts,8,0,8,2022,01-17,18:28
015 Les Aubes,6,1,8,2022,01-17,18:28
016 Antigone centre,12,4,16,2022,01-17,18:28
017 M�diath�que Emile Zola,10,6,16,2022,01-17,18:28
018 Nombre d'Or,15,1,16,2022,01-17,18:28
019 Louis Blanc,10,6,16,2022,01-17,18:28
020 Gambetta,5,3,8,2022,01-17,18:28
021 Port Marianne,6,10,16,2022,01-17,18:28
022 Clemenceau,5,7,12,2022,01-17,18:28
023 Les Arceaux,0,16,16,2022,01-17,18:28
024 Cit� Mion,3,5,8,2022,01-17,18:28
025 Nouveau Saint-Roch,5,3,8,2022,01-17,18:28
026 Renouvier,0,8,8,2022,01-17,18:28
027 Odysseum,7,1,8,2022,01-17,18:28
028 Saint-Denis,4,4,8,2022,01-17,18:28
029 Richter,8,8,16,2022,01-17,18:28
030 Charles Flahault,6,2,8,2022,01-17,18:28
031 Voltaire,3,5,8,2022,01-17,18:28
032 Pr�s d'Ar�nes,5,3,8,2022,01-17,18:28
033 Garcia Lorca,8,0,8,2022,01-17,18:28
034 Vert Bois,0,16,16,2022,01-17,18:28
035 Malbosc,1,7,8,2022,01-17,18:28
036 Occitanie,3,29,32,2022,01-17,18:28
037 FacdesSciences,2,22,24,2022,01-17,18:28
038 Fac de Lettres,3,13,16,2022,01-17,18:28
039 Aiguelongue,6,2,8,2022,01-17,18:28
040 Jeu de Mail des Abb�s,8,0,8,2022,01-17,18:28
041 Eurom�decine,4,4,8,2022,01-17,18:28
042 Marie Caizergues,1,7,8,2022,01-17,18:28
043 Sabines,1,7,8,2022,01-17,18:28
044 Celleneuve,0,8,8,2022,01-17,18:28
045 Jardin de la Lironde,7,1,8,2022,01-17,18:28
046 P�re Soulas,2,6,8,2022,01-17,18:28
047 Place Viala,4,4,8,2022,01-17,18:28
048 H�tel du D�partement,0,8,8,2022,01-17,18:28
049 Tonnelles,4,4,8,2022,01-17,18:28
050 Parvis Jules Ferry - Gare Saint-Roch,6,2,8,2022,01-17,18:28
051 Pont de Lattes - Gare Saint-Roch,2,10,12,2022,01-17,18:28
053 Deux Ponts - Gare Saint-Roch,3,5,8,2022,01-17,18:28
054 Providence - Ovalie,3,5,8,2022,01-17,18:28
055 P�rols Etang de l'Or,24,44,68,2022,01-17,18:28
056 Albert 1er - Cath�drale,0,12,12,2022,01-17,18:28
057 Saint-Guilhem - Courreau,0,8,8,2022,01-17,18:28
059 Sud De France,0,8,8,2022,01-17,18:28
001 Rue Jules Ferry - Gare Saint-Roch,7,5,12,2022,01-17,18:38
002 Com�die,11,13,24,2022,01-17,18:38
003 Esplanade,5,27,32,2022,01-17,18:38
004 H�tel de Ville,13,3,16,2022,01-17,18:38
005 Corum,6,6,12,2022,01-17,18:38
006 Place Albert 1er - St Charles,14,17,31,2022,01-17,18:38
007 Foch,2,6,8,2022,01-17,18:38
008 Halles Castellane,1,11,12,2022,01-17,18:38
009 Observatoire,7,1,8,2022,01-17,18:38
010 Rondelet,5,11,16,2022,01-17,18:38
011 Plan Cabanes,2,10,12,2022,01-17,18:38
012 Boutonnet,2,10,12,2022,01-17,18:38
013 Emile Combes,7,1,8,2022,01-17,18:38
014 Beaux-Arts,8,0,8,2022,01-17,18:38
015 Les Aubes,6,1,8,2022,01-17,18:38
016 Antigone centre,12,4,16,2022,01-17,18:38
017 M�diath�que Emile Zola,9,7,16,2022,01-17,18:38
018 Nombre d'Or,15,1,16,2022,01-17,18:38
019 Louis Blanc,10,6,16,2022,01-17,18:38
020 Gambetta,5,3,8,2022,01-17,18:38
021 Port Marianne,6,10,16,2022,01-17,18:38
022 Clemenceau,4,8,12,2022,01-17,18:38
023 Les Arceaux,1,15,16,2022,01-17,18:38
024 Cit� Mion,3,5,8,2022,01-17,18:38
025 Nouveau Saint-Roch,4,4,8,2022,01-17,18:38
026 Renouvier,0,8,8,2022,01-17,18:38
027 Odysseum,7,1,8,2022,01-17,18:38
028 Saint-Denis,4,4,8,2022,01-17,18:38
029 Richter,8,8,16,2022,01-17,18:38
030 Charles Flahault,6,2,8,2022,01-17,18:38
031 Voltaire,4,4,8,2022,01-17,18:38
032 Pr�s d'Ar�nes,5,3,8,2022,01-17,18:38
033 Garcia Lorca,8,0,8,2022,01-17,18:38
034 Vert Bois,0,16,16,2022,01-17,18:38
035 Malbosc,1,7,8,2022,01-17,18:38
036 Occitanie,3,29,32,2022,01-17,18:38
037 FacdesSciences,0,24,24,2022,01-17,18:38
038 Fac de Lettres,3,13,16,2022,01-17,18:38
039 Aiguelongue,7,1,8,2022,01-17,18:38
040 Jeu de Mail des Abb�s,8,0,8,2022,01-17,18:38
041 Eurom�decine,4,4,8,2022,01-17,18:38
042 Marie Caizergues,1,7,8,2022,01-17,18:38
043 Sabines,1,7,8,2022,01-17,18:38
044 Celleneuve,0,8,8,2022,01-17,18:38
045 Jardin de la Lironde,7,1,8,2022,01-17,18:38
046 P�re Soulas,1,7,8,2022,01-17,18:38
047 Place Viala,3,5,8,2022,01-17,18:38
048 H�tel du D�partement,0,8,8,2022,01-17,18:38
049 Tonnelles,4,4,8,2022,01-17,18:38
050 Parvis Jules Ferry - Gare Saint-Roch,6,2,8,2022,01-17,18:38
051 Pont de Lattes - Gare Saint-Roch,2,10,12,2022,01-17,18:38
053 Deux Ponts - Gare Saint-Roch,3,5,8,2022,01-17,18:38
054 Providence - Ovalie,3,5,8,2022,01-17,18:38
055 P�rols Etang de l'Or,24,44,68,2022,01-17,18:38
056 Albert 1er - Cath�drale,0,12,12,2022,01-17,18:38
057 Saint-Guilhem - Courreau,0,8,8,2022,01-17,18:38
059 Sud De France,0,8,8,2022,01-17,18:38
001 Rue Jules Ferry - Gare Saint-Roch,7,5,12,2022,01-17,18:48
002 Com�die,11,13,24,2022,01-17,18:48
003 Esplanade,5,27,32,2022,01-17,18:48
004 H�tel de Ville,14,2,16,2022,01-17,18:48
005 Corum,4,8,12,2022,01-17,18:48
006 Place Albert 1er - St Charles,15,16,31,2022,01-17,18:48
007 Foch,2,6,8,2022,01-17,18:48
008 Halles Castellane,2,10,12,2022,01-17,18:48
009 Observatoire,7,1,8,2022,01-17,18:48
010 Rondelet,5,11,16,2022,01-17,18:48
011 Plan Cabanes,4,8,12,2022,01-17,18:48
012 Boutonnet,2,10,12,2022,01-17,18:48
013 Emile Combes,8,0,8,2022,01-17,18:48
014 Beaux-Arts,8,0,8,2022,01-17,18:48
015 Les Aubes,6,1,8,2022,01-17,18:48
016 Antigone centre,12,4,16,2022,01-17,18:48
017 M�diath�que Emile Zola,9,7,16,2022,01-17,18:48
018 Nombre d'Or,15,1,16,2022,01-17,18:48
019 Louis Blanc,10,6,16,2022,01-17,18:48
020 Gambetta,4,4,8,2022,01-17,18:48
021 Port Marianne,6,10,16,2022,01-17,18:48
022 Clemenceau,5,7,12,2022,01-17,18:48
023 Les Arceaux,1,15,16,2022,01-17,18:48
024 Cit� Mion,2,6,8,2022,01-17,18:48
025 Nouveau Saint-Roch,4,4,8,2022,01-17,18:48
026 Renouvier,0,8,8,2022,01-17,18:48
027 Odysseum,7,1,8,2022,01-17,18:48
028 Saint-Denis,4,4,8,2022,01-17,18:48
029 Richter,8,8,16,2022,01-17,18:48
030 Charles Flahault,6,2,8,2022,01-17,18:48
031 Voltaire,4,4,8,2022,01-17,18:48
032 Pr�s d'Ar�nes,5,3,8,2022,01-17,18:48
033 Garcia Lorca,8,0,8,2022,01-17,18:48
034 Vert Bois,0,16,16,2022,01-17,18:48
035 Malbosc,2,6,8,2022,01-17,18:48
036 Occitanie,2,30,32,2022,01-17,18:48
037 FacdesSciences,0,24,24,2022,01-17,18:48
038 Fac de Lettres,3,13,16,2022,01-17,18:48
039 Aiguelongue,7,1,8,2022,01-17,18:48
040 Jeu de Mail des Abb�s,8,0,8,2022,01-17,18:48
041 Eurom�decine,4,4,8,2022,01-17,18:48
042 Marie Caizergues,1,7,8,2022,01-17,18:48
043 Sabines,1,7,8,2022,01-17,18:48
044 Celleneuve,0,8,8,2022,01-17,18:48
045 Jardin de la Lironde,7,1,8,2022,01-17,18:48
046 P�re Soulas,2,6,8,2022,01-17,18:48
047 Place Viala,2,6,8,2022,01-17,18:48
048 H�tel du D�partement,0,8,8,2022,01-17,18:48
049 Tonnelles,4,4,8,2022,01-17,18:48
050 Parvis Jules Ferry - Gare Saint-Roch,6,2,8,2022,01-17,18:48
051 Pont de Lattes - Gare Saint-Roch,3,9,12,2022,01-17,18:48
053 Deux Ponts - Gare Saint-Roch,3,5,8,2022,01-17,18:48
054 Providence - Ovalie,3,5,8,2022,01-17,18:48
055 P�rols Etang de l'Or,24,44,68,2022,01-17,18:48
056 Albert 1er - Cath�drale,0,12,12,2022,01-17,18:48
057 Saint-Guilhem - Courreau,0,8,8,2022,01-17,18:48
059 Sud De France,0,8,8,2022,01-17,18:48
001 Rue Jules Ferry - Gare Saint-Roch,7,5,12,2022,01-17,18:58
002 Com�die,11,13,24,2022,01-17,18:58
003 Esplanade,5,27,32,2022,01-17,18:58
004 H�tel de Ville,14,2,16,2022,01-17,18:58
005 Corum,4,8,12,2022,01-17,18:58
006 Place Albert 1er - St Charles,14,17,31,2022,01-17,18:58
007 Foch,2,6,8,2022,01-17,18:58
008 Halles Castellane,2,10,12,2022,01-17,18:58
009 Observatoire,7,1,8,2022,01-17,18:58
010 Rondelet,5,11,16,2022,01-17,18:58
011 Plan Cabanes,5,7,12,2022,01-17,18:58
012 Boutonnet,1,11,12,2022,01-17,18:58
013 Emile Combes,8,0,8,2022,01-17,18:58
014 Beaux-Arts,8,0,8,2022,01-17,18:58
015 Les Aubes,6,1,8,2022,01-17,18:58
016 Antigone centre,12,4,16,2022,01-17,18:58
017 M�diath�que Emile Zola,9,7,16,2022,01-17,18:58
018 Nombre d'Or,16,0,16,2022,01-17,18:58
019 Louis Blanc,9,7,16,2022,01-17,18:58
020 Gambetta,4,4,8,2022,01-17,18:58
021 Port Marianne,6,10,16,2022,01-17,18:58
022 Clemenceau,5,7,12,2022,01-17,18:58
023 Les Arceaux,1,15,16,2022,01-17,18:58
024 Cit� Mion,2,6,8,2022,01-17,18:58
025 Nouveau Saint-Roch,3,5,8,2022,01-17,18:58
026 Renouvier,1,7,8,2022,01-17,18:58
027 Odysseum,7,1,8,2022,01-17,18:58
028 Saint-Denis,4,4,8,2022,01-17,18:58
029 Richter,8,8,16,2022,01-17,18:58
030 Charles Flahault,6,2,8,2022,01-17,18:58
031 Voltaire,4,4,8,2022,01-17,18:58
032 Pr�s d'Ar�nes,5,3,8,2022,01-17,18:58
033 Garcia Lorca,8,0,8,2022,01-17,18:58
034 Vert Bois,0,16,16,2022,01-17,18:58
035 Malbosc,2,6,8,2022,01-17,18:58
036 Occitanie,3,29,32,2022,01-17,18:58
037 FacdesSciences,2,22,24,2022,01-17,18:58
038 Fac de Lettres,4,12,16,2022,01-17,18:58
039 Aiguelongue,7,1,8,2022,01-17,18:58
040 Jeu de Mail des Abb�s,8,0,8,2022,01-17,18:58
041 Eurom�decine,2,6,8,2022,01-17,18:58
042 Marie Caizergues,1,7,8,2022,01-17,18:58
043 Sabines,2,6,8,2022,01-17,18:58
044 Celleneuve,0,8,8,2022,01-17,18:58
045 Jardin de la Lironde,8,0,8,2022,01-17,18:58
046 P�re Soulas,2,6,8,2022,01-17,18:58
047 Place Viala,1,7,8,2022,01-17,18:58
048 H�tel du D�partement,0,8,8,2022,01-17,18:58
049 Tonnelles,4,4,8,2022,01-17,18:58
050 Parvis Jules Ferry - Gare Saint-Roch,6,2,8,2022,01-17,18:58
051 Pont de Lattes - Gare Saint-Roch,3,9,12,2022,01-17,18:58
053 Deux Ponts - Gare Saint-Roch,3,5,8,2022,01-17,18:58
054 Providence - Ovalie,3,5,8,2022,01-17,18:58
055 P�rols Etang de l'Or,24,44,68,2022,01-17,18:58
056 Albert 1er - Cath�drale,0,12,12,2022,01-17,18:58
057 Saint-Guilhem - Courreau,0,8,8,2022,01-17,18:58
059 Sud De France,0,8,8,2022,01-17,18:58
001 Rue Jules Ferry - Gare Saint-Roch,7,5,12,2022,01-17,19:09
002 Com�die,11,13,24,2022,01-17,19:09
003 Esplanade,5,27,32,2022,01-17,19:09
004 H�tel de Ville,14,2,16,2022,01-17,19:09
005 Corum,4,8,12,2022,01-17,19:09
006 Place Albert 1er - St Charles,14,17,31,2022,01-17,19:09
007 Foch,2,6,8,2022,01-17,19:09
008 Halles Castellane,3,9,12,2022,01-17,19:09
009 Observatoire,7,1,8,2022,01-17,19:09
010 Rondelet,5,11,16,2022,01-17,19:09
011 Plan Cabanes,4,8,12,2022,01-17,19:09
012 Boutonnet,2,10,12,2022,01-17,19:09
013 Emile Combes,8,0,8,2022,01-17,19:09
014 Beaux-Arts,8,0,8,2022,01-17,19:09
015 Les Aubes,6,1,8,2022,01-17,19:09
016 Antigone centre,11,5,16,2022,01-17,19:09
017 M�diath�que Emile Zola,9,7,16,2022,01-17,19:09
018 Nombre d'Or,16,0,16,2022,01-17,19:09
019 Louis Blanc,9,7,16,2022,01-17,19:09
020 Gambetta,4,4,8,2022,01-17,19:09
021 Port Marianne,6,10,16,2022,01-17,19:09
022 Clemenceau,5,7,12,2022,01-17,19:09
023 Les Arceaux,2,14,16,2022,01-17,19:09
024 Cit� Mion,2,6,8,2022,01-17,19:09
025 Nouveau Saint-Roch,1,7,8,2022,01-17,19:09
026 Renouvier,1,7,8,2022,01-17,19:09
027 Odysseum,6,2,8,2022,01-17,19:09
028 Saint-Denis,4,4,8,2022,01-17,19:09
029 Richter,8,8,16,2022,01-17,19:09
030 Charles Flahault,6,2,8,2022,01-17,19:09
031 Voltaire,4,4,8,2022,01-17,19:09
032 Pr�s d'Ar�nes,5,3,8,2022,01-17,19:09
033 Garcia Lorca,8,0,8,2022,01-17,19:09
034 Vert Bois,0,16,16,2022,01-17,19:09
035 Malbosc,2,6,8,2022,01-17,19:09
036 Occitanie,3,29,32,2022,01-17,19:09
037 FacdesSciences,3,21,24,2022,01-17,19:09
038 Fac de Lettres,4,12,16,2022,01-17,19:09
039 Aiguelongue,7,1,8,2022,01-17,19:09
040 Jeu de Mail des Abb�s,8,0,8,2022,01-17,19:09
041 Eurom�decine,2,6,8,2022,01-17,19:09
042 Marie Caizergues,1,7,8,2022,01-17,19:09
043 Sabines,2,6,8,2022,01-17,19:09
044 Celleneuve,0,8,8,2022,01-17,19:09
045 Jardin de la Lironde,8,0,8,2022,01-17,19:09
046 P�re Soulas,2,6,8,2022,01-17,19:09
047 Place Viala,0,8,8,2022,01-17,19:09
048 H�tel du D�partement,0,8,8,2022,01-17,19:09
049 Tonnelles,4,4,8,2022,01-17,19:09
050 Parvis Jules Ferry - Gare Saint-Roch,6,2,8,2022,01-17,19:09
051 Pont de Lattes - Gare Saint-Roch,3,9,12,2022,01-17,19:09
053 Deux Ponts - Gare Saint-Roch,3,5,8,2022,01-17,19:09
054 Providence - Ovalie,3,5,8,2022,01-17,19:09
055 P�rols Etang de l'Or,24,44,68,2022,01-17,19:09
056 Albert 1er - Cath�drale,0,12,12,2022,01-17,19:09
057 Saint-Guilhem - Courreau,1,7,8,2022,01-17,19:09
059 Sud De France,1,7,8,2022,01-17,19:09
001 Rue Jules Ferry - Gare Saint-Roch,7,5,12,2022,01-17,19:19
002 Com�die,11,13,24,2022,01-17,19:19
003 Esplanade,5,27,32,2022,01-17,19:19
004 H�tel de Ville,14,2,16,2022,01-17,19:19
005 Corum,4,8,12,2022,01-17,19:19
006 Place Albert 1er - St Charles,14,17,31,2022,01-17,19:19
007 Foch,2,6,8,2022,01-17,19:19
008 Halles Castellane,3,9,12,2022,01-17,19:19
009 Observatoire,7,1,8,2022,01-17,19:19
010 Rondelet,5,11,16,2022,01-17,19:19
011 Plan Cabanes,4,8,12,2022,01-17,19:19
012 Boutonnet,2,10,12,2022,01-17,19:19
013 Emile Combes,8,0,8,2022,01-17,19:19
014 Beaux-Arts,8,0,8,2022,01-17,19:19
015 Les Aubes,6,1,8,2022,01-17,19:19
016 Antigone centre,11,5,16,2022,01-17,19:19
017 M�diath�que Emile Zola,9,7,16,2022,01-17,19:19
018 Nombre d'Or,16,0,16,2022,01-17,19:19
019 Louis Blanc,9,7,16,2022,01-17,19:19
020 Gambetta,4,4,8,2022,01-17,19:19
021 Port Marianne,6,10,16,2022,01-17,19:19
022 Clemenceau,5,7,12,2022,01-17,19:19
023 Les Arceaux,2,14,16,2022,01-17,19:19
024 Cit� Mion,2,6,8,2022,01-17,19:19
025 Nouveau Saint-Roch,1,7,8,2022,01-17,19:19
026 Renouvier,1,7,8,2022,01-17,19:19
027 Odysseum,6,2,8,2022,01-17,19:19
028 Saint-Denis,4,4,8,2022,01-17,19:19
029 Richter,7,9,16,2022,01-17,19:19
030 Charles Flahault,6,2,8,2022,01-17,19:19
031 Voltaire,4,4,8,2022,01-17,19:19
032 Pr�s d'Ar�nes,5,3,8,2022,01-17,19:19
033 Garcia Lorca,8,0,8,2022,01-17,19:19
034 Vert Bois,0,16,16,2022,01-17,19:19
035 Malbosc,2,6,8,2022,01-17,19:19
036 Occitanie,5,27,32,2022,01-17,19:19
037 FacdesSciences,2,22,24,2022,01-17,19:19
038 Fac de Lettres,4,12,16,2022,01-17,19:19
039 Aiguelongue,7,1,8,2022,01-17,19:19
040 Jeu de Mail des Abb�s,8,0,8,2022,01-17,19:19
041 Eurom�decine,2,6,8,2022,01-17,19:19
042 Marie Caizergues,1,7,8,2022,01-17,19:19
043 Sabines,2,6,8,2022,01-17,19:19
044 Celleneuve,0,8,8,2022,01-17,19:19
045 Jardin de la Lironde,8,0,8,2022,01-17,19:19
046 P�re Soulas,2,6,8,2022,01-17,19:19
047 Place Viala,0,8,8,2022,01-17,19:19
048 H�tel du D�partement,0,8,8,2022,01-17,19:19
049 Tonnelles,4,4,8,2022,01-17,19:19
050 Parvis Jules Ferry - Gare Saint-Roch,6,2,8,2022,01-17,19:19
051 Pont de Lattes - Gare Saint-Roch,3,9,12,2022,01-17,19:19
053 Deux Ponts - Gare Saint-Roch,3,5,8,2022,01-17,19:19
054 Providence - Ovalie,3,5,8,2022,01-17,19:19
055 P�rols Etang de l'Or,24,44,68,2022,01-17,19:19
056 Albert 1er - Cath�drale,0,12,12,2022,01-17,19:19
057 Saint-Guilhem - Courreau,1,7,8,2022,01-17,19:19
059 Sud De France,1,7,8,2022,01-17,19:19
001 Rue Jules Ferry - Gare Saint-Roch,8,4,12,2022,01-17,19:29
002 Com�die,11,13,24,2022,01-17,19:29
003 Esplanade,6,26,32,2022,01-17,19:29
004 H�tel de Ville,14,2,16,2022,01-17,19:29
005 Corum,4,8,12,2022,01-17,19:29
006 Place Albert 1er - St Charles,14,17,31,2022,01-17,19:29
007 Foch,2,6,8,2022,01-17,19:29
008 Halles Castellane,3,9,12,2022,01-17,19:29
009 Observatoire,7,1,8,2022,01-17,19:29
010 Rondelet,5,11,16,2022,01-17,19:29
011 Plan Cabanes,4,8,12,2022,01-17,19:29
012 Boutonnet,2,10,12,2022,01-17,19:29
013 Emile Combes,8,0,8,2022,01-17,19:29
014 Beaux-Arts,8,0,8,2022,01-17,19:29
015 Les Aubes,6,1,8,2022,01-17,19:29
016 Antigone centre,12,4,16,2022,01-17,19:29
017 M�diath�que Emile Zola,10,6,16,2022,01-17,19:29
018 Nombre d'Or,16,0,16,2022,01-17,19:29
019 Louis Blanc,9,7,16,2022,01-17,19:29
020 Gambetta,4,4,8,2022,01-17,19:29
021 Port Marianne,6,10,16,2022,01-17,19:29
022 Clemenceau,5,7,12,2022,01-17,19:29
023 Les Arceaux,2,14,16,2022,01-17,19:29
024 Cit� Mion,2,6,8,2022,01-17,19:29
025 Nouveau Saint-Roch,1,7,8,2022,01-17,19:29
026 Renouvier,1,7,8,2022,01-17,19:29
027 Odysseum,6,2,8,2022,01-17,19:29
028 Saint-Denis,4,4,8,2022,01-17,19:29
029 Richter,7,9,16,2022,01-17,19:29
030 Charles Flahault,6,2,8,2022,01-17,19:29
031 Voltaire,4,4,8,2022,01-17,19:29
032 Pr�s d'Ar�nes,5,3,8,2022,01-17,19:29
033 Garcia Lorca,8,0,8,2022,01-17,19:29
034 Vert Bois,0,16,16,2022,01-17,19:29
035 Malbosc,2,6,8,2022,01-17,19:29
036 Occitanie,5,27,32,2022,01-17,19:29
037 FacdesSciences,2,22,24,2022,01-17,19:29
038 Fac de Lettres,4,12,16,2022,01-17,19:29
039 Aiguelongue,7,1,8,2022,01-17,19:29
040 Jeu de Mail des Abb�s,8,0,8,2022,01-17,19:29
041 Eurom�decine,2,6,8,2022,01-17,19:29
042 Marie Caizergues,1,7,8,2022,01-17,19:29
043 Sabines,2,6,8,2022,01-17,19:29
044 Celleneuve,0,8,8,2022,01-17,19:29
045 Jardin de la Lironde,8,0,8,2022,01-17,19:29
046 P�re Soulas,2,6,8,2022,01-17,19:29
047 Place Viala,0,8,8,2022,01-17,19:29
048 H�tel du D�partement,0,8,8,2022,01-17,19:29
049 Tonnelles,4,4,8,2022,01-17,19:29
050 Parvis Jules Ferry - Gare Saint-Roch,6,2,8,2022,01-17,19:29
051 Pont de Lattes - Gare Saint-Roch,3,9,12,2022,01-17,19:29
053 Deux Ponts - Gare Saint-Roch,3,5,8,2022,01-17,19:29
054 Providence - Ovalie,3,5,8,2022,01-17,19:29
055 P�rols Etang de l'Or,24,44,68,2022,01-17,19:29
056 Albert 1er - Cath�drale,0,12,12,2022,01-17,19:29
057 Saint-Guilhem - Courreau,1,7,8,2022,01-17,19:29
059 Sud De France,1,7,8,2022,01-17,19:29
001 Rue Jules Ferry - Gare Saint-Roch,7,5,12,2022,01-17,19:39
002 Com�die,11,13,24,2022,01-17,19:39
003 Esplanade,8,24,32,2022,01-17,19:39
004 H�tel de Ville,14,2,16,2022,01-17,19:39
005 Corum,6,6,12,2022,01-17,19:39
006 Place Albert 1er - St Charles,15,16,31,2022,01-17,19:39
007 Foch,2,6,8,2022,01-17,19:39
008 Halles Castellane,3,9,12,2022,01-17,19:39
009 Observatoire,6,2,8,2022,01-17,19:39
010 Rondelet,5,11,16,2022,01-17,19:39
011 Plan Cabanes,4,8,12,2022,01-17,19:39
012 Boutonnet,2,10,12,2022,01-17,19:39
013 Emile Combes,8,0,8,2022,01-17,19:39
014 Beaux-Arts,8,0,8,2022,01-17,19:39
015 Les Aubes,6,1,8,2022,01-17,19:39
016 Antigone centre,12,4,16,2022,01-17,19:39
017 M�diath�que Emile Zola,10,6,16,2022,01-17,19:39
018 Nombre d'Or,16,0,16,2022,01-17,19:39
019 Louis Blanc,9,7,16,2022,01-17,19:39
020 Gambetta,4,4,8,2022,01-17,19:39
021 Port Marianne,6,10,16,2022,01-17,19:39
022 Clemenceau,5,7,12,2022,01-17,19:39
023 Les Arceaux,2,14,16,2022,01-17,19:39
024 Cit� Mion,2,6,8,2022,01-17,19:39
025 Nouveau Saint-Roch,3,5,8,2022,01-17,19:39
026 Renouvier,1,7,8,2022,01-17,19:39
027 Odysseum,6,2,8,2022,01-17,19:39
028 Saint-Denis,4,4,8,2022,01-17,19:39
029 Richter,7,9,16,2022,01-17,19:39
030 Charles Flahault,6,2,8,2022,01-17,19:39
031 Voltaire,4,4,8,2022,01-17,19:39
032 Pr�s d'Ar�nes,4,4,8,2022,01-17,19:39
033 Garcia Lorca,8,0,8,2022,01-17,19:39
034 Vert Bois,0,16,16,2022,01-17,19:39
035 Malbosc,2,6,8,2022,01-17,19:39
036 Occitanie,5,27,32,2022,01-17,19:39
037 FacdesSciences,2,22,24,2022,01-17,19:39
038 Fac de Lettres,4,12,16,2022,01-17,19:39
039 Aiguelongue,7,1,8,2022,01-17,19:39
040 Jeu de Mail des Abb�s,8,0,8,2022,01-17,19:39
041 Eurom�decine,2,6,8,2022,01-17,19:39
042 Marie Caizergues,1,7,8,2022,01-17,19:39
043 Sabines,2,6,8,2022,01-17,19:39
044 Celleneuve,0,8,8,2022,01-17,19:39
045 Jardin de la Lironde,8,0,8,2022,01-17,19:39
046 P�re Soulas,3,5,8,2022,01-17,19:39
047 Place Viala,0,8,8,2022,01-17,19:39
048 H�tel du D�partement,0,8,8,2022,01-17,19:39
049 Tonnelles,4,4,8,2022,01-17,19:39
050 Parvis Jules Ferry - Gare Saint-Roch,6,2,8,2022,01-17,19:39
051 Pont de Lattes - Gare Saint-Roch,3,9,12,2022,01-17,19:39
053 Deux Ponts - Gare Saint-Roch,3,5,8,2022,01-17,19:39
054 Providence - Ovalie,3,5,8,2022,01-17,19:39
055 P�rols Etang de l'Or,24,44,68,2022,01-17,19:39
056 Albert 1er - Cath�drale,0,12,12,2022,01-17,19:39
057 Saint-Guilhem - Courreau,1,7,8,2022,01-17,19:39
059 Sud De France,1,7,8,2022,01-17,19:39
001 Rue Jules Ferry - Gare Saint-Roch,7,5,12,2022,01-17,19:49
002 Com�die,11,13,24,2022,01-17,19:49
003 Esplanade,8,24,32,2022,01-17,19:49
004 H�tel de Ville,14,2,16,2022,01-17,19:49
005 Corum,5,7,12,2022,01-17,19:49
006 Place Albert 1er - St Charles,15,16,31,2022,01-17,19:49
007 Foch,1,7,8,2022,01-17,19:49
008 Halles Castellane,3,9,12,2022,01-17,19:49
009 Observatoire,6,2,8,2022,01-17,19:49
010 Rondelet,5,11,16,2022,01-17,19:49
011 Plan Cabanes,4,8,12,2022,01-17,19:49
012 Boutonnet,2,10,12,2022,01-17,19:49
013 Emile Combes,8,0,8,2022,01-17,19:49
014 Beaux-Arts,8,0,8,2022,01-17,19:49
015 Les Aubes,6,1,8,2022,01-17,19:49
016 Antigone centre,12,4,16,2022,01-17,19:49
017 M�diath�que Emile Zola,10,6,16,2022,01-17,19:49
018 Nombre d'Or,16,0,16,2022,01-17,19:49
019 Louis Blanc,9,7,16,2022,01-17,19:49
020 Gambetta,4,4,8,2022,01-17,19:49
021 Port Marianne,5,11,16,2022,01-17,19:49
022 Clemenceau,5,7,12,2022,01-17,19:49
023 Les Arceaux,2,14,16,2022,01-17,19:49
024 Cit� Mion,2,6,8,2022,01-17,19:49
025 Nouveau Saint-Roch,3,5,8,2022,01-17,19:49
026 Renouvier,1,7,8,2022,01-17,19:49
027 Odysseum,6,2,8,2022,01-17,19:49
028 Saint-Denis,4,4,8,2022,01-17,19:49
029 Richter,7,9,16,2022,01-17,19:49
030 Charles Flahault,6,2,8,2022,01-17,19:49
031 Voltaire,4,4,8,2022,01-17,19:49
032 Pr�s d'Ar�nes,4,4,8,2022,01-17,19:49
033 Garcia Lorca,8,0,8,2022,01-17,19:49
034 Vert Bois,0,16,16,2022,01-17,19:49
035 Malbosc,2,6,8,2022,01-17,19:49
036 Occitanie,4,28,32,2022,01-17,19:49
037 FacdesSciences,1,23,24,2022,01-17,19:49
038 Fac de Lettres,4,12,16,2022,01-17,19:49
039 Aiguelongue,7,1,8,2022,01-17,19:49
040 Jeu de Mail des Abb�s,8,0,8,2022,01-17,19:49
041 Eurom�decine,2,6,8,2022,01-17,19:49
042 Marie Caizergues,1,7,8,2022,01-17,19:49
043 Sabines,2,6,8,2022,01-17,19:49
044 Celleneuve,0,8,8,2022,01-17,19:49
045 Jardin de la Lironde,8,0,8,2022,01-17,19:49
046 P�re Soulas,3,5,8,2022,01-17,19:49
047 Place Viala,0,8,8,2022,01-17,19:49
048 H�tel du D�partement,0,8,8,2022,01-17,19:49
049 Tonnelles,4,4,8,2022,01-17,19:49
050 Parvis Jules Ferry - Gare Saint-Roch,6,2,8,2022,01-17,19:49
051 Pont de Lattes - Gare Saint-Roch,3,9,12,2022,01-17,19:49
053 Deux Ponts - Gare Saint-Roch,3,5,8,2022,01-17,19:49
054 Providence - Ovalie,3,5,8,2022,01-17,19:49
055 P�rols Etang de l'Or,24,44,68,2022,01-17,19:49
056 Albert 1er - Cath�drale,0,12,12,2022,01-17,19:49
057 Saint-Guilhem - Courreau,1,7,8,2022,01-17,19:49
059 Sud De France,1,7,8,2022,01-17,19:49
001 Rue Jules Ferry - Gare Saint-Roch,7,5,12,2022,01-17,20:00
002 Com�die,6,18,24,2022,01-17,20:00
003 Esplanade,8,24,32,2022,01-17,20:00
004 H�tel de Ville,15,1,16,2022,01-17,20:00
005 Corum,5,7,12,2022,01-17,20:00
006 Place Albert 1er - St Charles,16,15,31,2022,01-17,20:00
007 Foch,1,7,8,2022,01-17,20:00
008 Halles Castellane,3,9,12,2022,01-17,20:00
009 Observatoire,6,2,8,2022,01-17,20:00
010 Rondelet,5,11,16,2022,01-17,20:00
011 Plan Cabanes,4,8,12,2022,01-17,20:00
012 Boutonnet,2,10,12,2022,01-17,20:00
013 Emile Combes,8,0,8,2022,01-17,20:00
014 Beaux-Arts,8,0,8,2022,01-17,20:00
015 Les Aubes,6,1,8,2022,01-17,20:00
016 Antigone centre,12,4,16,2022,01-17,20:00
017 M�diath�que Emile Zola,10,6,16,2022,01-17,20:00
018 Nombre d'Or,16,0,16,2022,01-17,20:00
019 Louis Blanc,9,7,16,2022,01-17,20:00
020 Gambetta,4,4,8,2022,01-17,20:00
021 Port Marianne,5,11,16,2022,01-17,20:00
022 Clemenceau,5,7,12,2022,01-17,20:00
023 Les Arceaux,2,14,16,2022,01-17,20:00
024 Cit� Mion,2,6,8,2022,01-17,20:00
025 Nouveau Saint-Roch,3,5,8,2022,01-17,20:00
026 Renouvier,1,7,8,2022,01-17,20:00
027 Odysseum,6,2,8,2022,01-17,20:00
028 Saint-Denis,4,4,8,2022,01-17,20:00
029 Richter,7,9,16,2022,01-17,20:00
030 Charles Flahault,6,2,8,2022,01-17,20:00
031 Voltaire,4,4,8,2022,01-17,20:00
032 Pr�s d'Ar�nes,4,4,8,2022,01-17,20:00
033 Garcia Lorca,8,0,8,2022,01-17,20:00
034 Vert Bois,0,16,16,2022,01-17,20:00
035 Malbosc,2,6,8,2022,01-17,20:00
036 Occitanie,4,28,32,2022,01-17,20:00
037 FacdesSciences,2,22,24,2022,01-17,20:00
038 Fac de Lettres,4,12,16,2022,01-17,20:00
039 Aiguelongue,7,1,8,2022,01-17,20:00
040 Jeu de Mail des Abb�s,8,0,8,2022,01-17,20:00
041 Eurom�decine,1,7,8,2022,01-17,20:00
042 Marie Caizergues,1,7,8,2022,01-17,20:00
043 Sabines,2,6,8,2022,01-17,20:00
044 Celleneuve,0,8,8,2022,01-17,20:00
045 Jardin de la Lironde,8,0,8,2022,01-17,20:00
046 P�re Soulas,3,5,8,2022,01-17,20:00
047 Place Viala,0,8,8,2022,01-17,20:00
048 H�tel du D�partement,0,8,8,2022,01-17,20:00
049 Tonnelles,4,4,8,2022,01-17,20:00
050 Parvis Jules Ferry - Gare Saint-Roch,6,2,8,2022,01-17,20:00
051 Pont de Lattes - Gare Saint-Roch,3,9,12,2022,01-17,20:00
053 Deux Ponts - Gare Saint-Roch,3,5,8,2022,01-17,20:00
054 Providence - Ovalie,3,5,8,2022,01-17,20:00
055 P�rols Etang de l'Or,24,44,68,2022,01-17,20:00
056 Albert 1er - Cath�drale,0,12,12,2022,01-17,20:00
057 Saint-Guilhem - Courreau,0,8,8,2022,01-17,20:00
059 Sud De France,1,7,8,2022,01-17,20:00
001 Rue Jules Ferry - Gare Saint-Roch,7,5,12,2022,01-17,20:10
002 Com�die,7,17,24,2022,01-17,20:10
003 Esplanade,8,24,32,2022,01-17,20:10
004 H�tel de Ville,15,1,16,2022,01-17,20:10
005 Corum,5,7,12,2022,01-17,20:10
006 Place Albert 1er - St Charles,16,15,31,2022,01-17,20:10
007 Foch,2,6,8,2022,01-17,20:10
008 Halles Castellane,3,9,12,2022,01-17,20:10
009 Observatoire,6,2,8,2022,01-17,20:10
010 Rondelet,5,11,16,2022,01-17,20:10
011 Plan Cabanes,4,8,12,2022,01-17,20:10
012 Boutonnet,2,10,12,2022,01-17,20:10
013 Emile Combes,8,0,8,2022,01-17,20:10
014 Beaux-Arts,8,0,8,2022,01-17,20:10
015 Les Aubes,6,1,8,2022,01-17,20:10
016 Antigone centre,12,4,16,2022,01-17,20:10
017 M�diath�que Emile Zola,10,6,16,2022,01-17,20:10
018 Nombre d'Or,15,1,16,2022,01-17,20:10
019 Louis Blanc,9,7,16,2022,01-17,20:10
020 Gambetta,4,4,8,2022,01-17,20:10
021 Port Marianne,6,10,16,2022,01-17,20:10
022 Clemenceau,4,8,12,2022,01-17,20:10
023 Les Arceaux,2,14,16,2022,01-17,20:10
024 Cit� Mion,2,6,8,2022,01-17,20:10
025 Nouveau Saint-Roch,3,5,8,2022,01-17,20:10
026 Renouvier,1,7,8,2022,01-17,20:10
027 Odysseum,6,2,8,2022,01-17,20:10
028 Saint-Denis,4,4,8,2022,01-17,20:10
029 Richter,7,9,16,2022,01-17,20:10
030 Charles Flahault,6,2,8,2022,01-17,20:10
031 Voltaire,4,4,8,2022,01-17,20:10
032 Pr�s d'Ar�nes,4,4,8,2022,01-17,20:10
033 Garcia Lorca,8,0,8,2022,01-17,20:10
034 Vert Bois,0,16,16,2022,01-17,20:10
035 Malbosc,2,6,8,2022,01-17,20:10
036 Occitanie,4,28,32,2022,01-17,20:10
037 FacdesSciences,2,22,24,2022,01-17,20:10
038 Fac de Lettres,4,12,16,2022,01-17,20:10
039 Aiguelongue,7,1,8,2022,01-17,20:10
040 Jeu de Mail des Abb�s,8,0,8,2022,01-17,20:10
041 Eurom�decine,1,7,8,2022,01-17,20:10
042 Marie Caizergues,1,7,8,2022,01-17,20:10
043 Sabines,2,6,8,2022,01-17,20:10
044 Celleneuve,0,8,8,2022,01-17,20:10
045 Jardin de la Lironde,8,0,8,2022,01-17,20:10
046 P�re Soulas,3,5,8,2022,01-17,20:10
047 Place Viala,0,8,8,2022,01-17,20:10
048 H�tel du D�partement,0,8,8,2022,01-17,20:10
049 Tonnelles,4,4,8,2022,01-17,20:10
050 Parvis Jules Ferry - Gare Saint-Roch,6,2,8,2022,01-17,20:10
051 Pont de Lattes - Gare Saint-Roch,3,9,12,2022,01-17,20:10
053 Deux Ponts - Gare Saint-Roch,3,5,8,2022,01-17,20:10
054 Providence - Ovalie,3,5,8,2022,01-17,20:10
055 P�rols Etang de l'Or,24,44,68,2022,01-17,20:10
056 Albert 1er - Cath�drale,0,12,12,2022,01-17,20:10
057 Saint-Guilhem - Courreau,0,8,8,2022,01-17,20:10
059 Sud De France,1,7,8,2022,01-17,20:10
001 Rue Jules Ferry - Gare Saint-Roch,7,5,12,2022,01-17,20:20
002 Com�die,6,18,24,2022,01-17,20:20
003 Esplanade,8,24,32,2022,01-17,20:20
004 H�tel de Ville,15,1,16,2022,01-17,20:20
005 Corum,5,7,12,2022,01-17,20:20
006 Place Albert 1er - St Charles,16,15,31,2022,01-17,20:20
007 Foch,2,6,8,2022,01-17,20:20
008 Halles Castellane,3,9,12,2022,01-17,20:20
009 Observatoire,6,2,8,2022,01-17,20:20
010 Rondelet,4,12,16,2022,01-17,20:20
011 Plan Cabanes,3,9,12,2022,01-17,20:20
012 Boutonnet,2,10,12,2022,01-17,20:20
013 Emile Combes,8,0,8,2022,01-17,20:20
014 Beaux-Arts,8,0,8,2022,01-17,20:20
015 Les Aubes,6,1,8,2022,01-17,20:20
016 Antigone centre,12,4,16,2022,01-17,20:20
017 M�diath�que Emile Zola,10,6,16,2022,01-17,20:20
018 Nombre d'Or,15,1,16,2022,01-17,20:20
019 Louis Blanc,9,7,16,2022,01-17,20:20
020 Gambetta,4,4,8,2022,01-17,20:20
021 Port Marianne,11,5,16,2022,01-17,20:20
022 Clemenceau,5,7,12,2022,01-17,20:20
023 Les Arceaux,0,16,16,2022,01-17,20:20
024 Cit� Mion,2,6,8,2022,01-17,20:20
025 Nouveau Saint-Roch,3,5,8,2022,01-17,20:20
026 Renouvier,1,7,8,2022,01-17,20:20
027 Odysseum,6,2,8,2022,01-17,20:20
028 Saint-Denis,6,2,8,2022,01-17,20:20
029 Richter,7,9,16,2022,01-17,20:20
030 Charles Flahault,6,2,8,2022,01-17,20:20
031 Voltaire,4,4,8,2022,01-17,20:20
032 Pr�s d'Ar�nes,4,4,8,2022,01-17,20:20
033 Garcia Lorca,8,0,8,2022,01-17,20:20
034 Vert Bois,0,16,16,2022,01-17,20:20
035 Malbosc,2,6,8,2022,01-17,20:20
036 Occitanie,4,28,32,2022,01-17,20:20
037 FacdesSciences,2,22,24,2022,01-17,20:20
038 Fac de Lettres,4,12,16,2022,01-17,20:20
039 Aiguelongue,7,1,8,2022,01-17,20:20
040 Jeu de Mail des Abb�s,8,0,8,2022,01-17,20:20
041 Eurom�decine,1,7,8,2022,01-17,20:20
042 Marie Caizergues,1,7,8,2022,01-17,20:20
043 Sabines,1,7,8,2022,01-17,20:20
044 Celleneuve,0,8,8,2022,01-17,20:20
045 Jardin de la Lironde,8,0,8,2022,01-17,20:20
046 P�re Soulas,3,5,8,2022,01-17,20:20
047 Place Viala,0,8,8,2022,01-17,20:20
048 H�tel du D�partement,0,8,8,2022,01-17,20:20
049 Tonnelles,4,4,8,2022,01-17,20:20
050 Parvis Jules Ferry - Gare Saint-Roch,6,2,8,2022,01-17,20:20
051 Pont de Lattes - Gare Saint-Roch,3,9,12,2022,01-17,20:20
053 Deux Ponts - Gare Saint-Roch,3,5,8,2022,01-17,20:20
054 Providence - Ovalie,3,5,8,2022,01-17,20:20
055 P�rols Etang de l'Or,24,44,68,2022,01-17,20:20
056 Albert 1er - Cath�drale,0,12,12,2022,01-17,20:20
057 Saint-Guilhem - Courreau,0,8,8,2022,01-17,20:20
059 Sud De France,1,7,8,2022,01-17,20:20
001 Rue Jules Ferry - Gare Saint-Roch,7,5,12,2022,01-17,20:30
002 Com�die,5,19,24,2022,01-17,20:30
003 Esplanade,8,24,32,2022,01-17,20:30
004 H�tel de Ville,15,1,16,2022,01-17,20:30
005 Corum,5,7,12,2022,01-17,20:30
006 Place Albert 1er - St Charles,16,15,31,2022,01-17,20:30
007 Foch,2,6,8,2022,01-17,20:30
008 Halles Castellane,3,9,12,2022,01-17,20:30
009 Observatoire,6,2,8,2022,01-17,20:30
010 Rondelet,5,11,16,2022,01-17,20:30
011 Plan Cabanes,3,9,12,2022,01-17,20:30
012 Boutonnet,2,10,12,2022,01-17,20:30
013 Emile Combes,8,0,8,2022,01-17,20:30
014 Beaux-Arts,8,0,8,2022,01-17,20:30
015 Les Aubes,6,1,8,2022,01-17,20:30
016 Antigone centre,12,4,16,2022,01-17,20:30
017 M�diath�que Emile Zola,10,6,16,2022,01-17,20:30
018 Nombre d'Or,14,2,16,2022,01-17,20:30
019 Louis Blanc,9,7,16,2022,01-17,20:30
020 Gambetta,4,4,8,2022,01-17,20:30
021 Port Marianne,11,5,16,2022,01-17,20:30
022 Clemenceau,5,7,12,2022,01-17,20:30
023 Les Arceaux,0,16,16,2022,01-17,20:30
024 Cit� Mion,2,6,8,2022,01-17,20:30
025 Nouveau Saint-Roch,3,5,8,2022,01-17,20:30
026 Renouvier,1,7,8,2022,01-17,20:30
027 Odysseum,6,2,8,2022,01-17,20:30
028 Saint-Denis,6,2,8,2022,01-17,20:30
029 Richter,7,9,16,2022,01-17,20:30
030 Charles Flahault,6,2,8,2022,01-17,20:30
031 Voltaire,4,4,8,2022,01-17,20:30
032 Pr�s d'Ar�nes,4,4,8,2022,01-17,20:30
033 Garcia Lorca,8,0,8,2022,01-17,20:30
034 Vert Bois,0,16,16,2022,01-17,20:30
035 Malbosc,2,6,8,2022,01-17,20:30
036 Occitanie,3,29,32,2022,01-17,20:30
037 FacdesSciences,2,22,24,2022,01-17,20:30
038 Fac de Lettres,4,12,16,2022,01-17,20:30
039 Aiguelongue,7,1,8,2022,01-17,20:30
040 Jeu de Mail des Abb�s,8,0,8,2022,01-17,20:30
041 Eurom�decine,1,7,8,2022,01-17,20:30
042 Marie Caizergues,1,7,8,2022,01-17,20:30
043 Sabines,1,7,8,2022,01-17,20:30
044 Celleneuve,0,8,8,2022,01-17,20:30
045 Jardin de la Lironde,8,0,8,2022,01-17,20:30
046 P�re Soulas,3,5,8,2022,01-17,20:30
047 Place Viala,0,8,8,2022,01-17,20:30
048 H�tel du D�partement,0,8,8,2022,01-17,20:30
049 Tonnelles,4,4,8,2022,01-17,20:30
050 Parvis Jules Ferry - Gare Saint-Roch,5,3,8,2022,01-17,20:30
051 Pont de Lattes - Gare Saint-Roch,3,9,12,2022,01-17,20:30
053 Deux Ponts - Gare Saint-Roch,3,5,8,2022,01-17,20:30
054 Providence - Ovalie,3,5,8,2022,01-17,20:30
055 P�rols Etang de l'Or,24,44,68,2022,01-17,20:30
056 Albert 1er - Cath�drale,0,12,12,2022,01-17,20:30
057 Saint-Guilhem - Courreau,0,8,8,2022,01-17,20:30
059 Sud De France,1,7,8,2022,01-17,20:30
001 Rue Jules Ferry - Gare Saint-Roch,7,5,12,2022,01-17,20:40
002 Com�die,5,19,24,2022,01-17,20:40
003 Esplanade,8,24,32,2022,01-17,20:40
004 H�tel de Ville,14,2,16,2022,01-17,20:40
005 Corum,5,7,12,2022,01-17,20:40
006 Place Albert 1er - St Charles,16,15,31,2022,01-17,20:40
007 Foch,2,6,8,2022,01-17,20:40
008 Halles Castellane,3,9,12,2022,01-17,20:40
009 Observatoire,5,3,8,2022,01-17,20:40
010 Rondelet,5,11,16,2022,01-17,20:40
011 Plan Cabanes,3,9,12,2022,01-17,20:40
012 Boutonnet,3,9,12,2022,01-17,20:40
013 Emile Combes,8,0,8,2022,01-17,20:40
014 Beaux-Arts,8,0,8,2022,01-17,20:40
015 Les Aubes,6,1,8,2022,01-17,20:40
016 Antigone centre,12,4,16,2022,01-17,20:40
017 M�diath�que Emile Zola,10,6,16,2022,01-17,20:40
018 Nombre d'Or,14,2,16,2022,01-17,20:40
019 Louis Blanc,10,6,16,2022,01-17,20:40
020 Gambetta,4,4,8,2022,01-17,20:40
021 Port Marianne,12,4,16,2022,01-17,20:40
022 Clemenceau,6,6,12,2022,01-17,20:40
023 Les Arceaux,0,16,16,2022,01-17,20:40
024 Cit� Mion,2,6,8,2022,01-17,20:40
025 Nouveau Saint-Roch,4,4,8,2022,01-17,20:40
026 Renouvier,1,7,8,2022,01-17,20:40
027 Odysseum,6,2,8,2022,01-17,20:40
028 Saint-Denis,6,2,8,2022,01-17,20:40
029 Richter,7,9,16,2022,01-17,20:40
030 Charles Flahault,7,1,8,2022,01-17,20:40
031 Voltaire,4,4,8,2022,01-17,20:40
032 Pr�s d'Ar�nes,4,4,8,2022,01-17,20:40
033 Garcia Lorca,8,0,8,2022,01-17,20:40
034 Vert Bois,0,16,16,2022,01-17,20:40
035 Malbosc,2,6,8,2022,01-17,20:40
036 Occitanie,3,29,32,2022,01-17,20:40
037 FacdesSciences,2,22,24,2022,01-17,20:40
038 Fac de Lettres,4,12,16,2022,01-17,20:40
039 Aiguelongue,7,1,8,2022,01-17,20:40
040 Jeu de Mail des Abb�s,8,0,8,2022,01-17,20:40
041 Eurom�decine,1,7,8,2022,01-17,20:40
042 Marie Caizergues,1,7,8,2022,01-17,20:40
043 Sabines,1,7,8,2022,01-17,20:40
044 Celleneuve,0,8,8,2022,01-17,20:40
045 Jardin de la Lironde,8,0,8,2022,01-17,20:40
046 P�re Soulas,3,5,8,2022,01-17,20:40
047 Place Viala,0,8,8,2022,01-17,20:40
048 H�tel du D�partement,0,8,8,2022,01-17,20:40
049 Tonnelles,4,4,8,2022,01-17,20:40
050 Parvis Jules Ferry - Gare Saint-Roch,5,3,8,2022,01-17,20:40
051 Pont de Lattes - Gare Saint-Roch,3,9,12,2022,01-17,20:40
053 Deux Ponts - Gare Saint-Roch,3,5,8,2022,01-17,20:40
054 Providence - Ovalie,3,5,8,2022,01-17,20:40
055 P�rols Etang de l'Or,24,44,68,2022,01-17,20:40
056 Albert 1er - Cath�drale,0,12,12,2022,01-17,20:40
057 Saint-Guilhem - Courreau,0,8,8,2022,01-17,20:40
059 Sud De France,1,7,8,2022,01-17,20:40
001 Rue Jules Ferry - Gare Saint-Roch,7,5,12,2022,01-17,20:50
002 Com�die,5,19,24,2022,01-17,20:50
003 Esplanade,8,24,32,2022,01-17,20:50
004 H�tel de Ville,14,2,16,2022,01-17,20:50
005 Corum,5,7,12,2022,01-17,20:50
006 Place Albert 1er - St Charles,16,15,31,2022,01-17,20:50
007 Foch,2,6,8,2022,01-17,20:50
008 Halles Castellane,3,9,12,2022,01-17,20:50
009 Observatoire,5,3,8,2022,01-17,20:50
010 Rondelet,5,11,16,2022,01-17,20:50
011 Plan Cabanes,3,9,12,2022,01-17,20:50
012 Boutonnet,2,10,12,2022,01-17,20:50
013 Emile Combes,8,0,8,2022,01-17,20:50
014 Beaux-Arts,8,0,8,2022,01-17,20:50
015 Les Aubes,6,1,8,2022,01-17,20:50
016 Antigone centre,12,4,16,2022,01-17,20:50
017 M�diath�que Emile Zola,11,5,16,2022,01-17,20:50
018 Nombre d'Or,14,2,16,2022,01-17,20:50
019 Louis Blanc,10,6,16,2022,01-17,20:50
020 Gambetta,4,4,8,2022,01-17,20:50
021 Port Marianne,12,4,16,2022,01-17,20:50
022 Clemenceau,6,6,12,2022,01-17,20:50
023 Les Arceaux,0,16,16,2022,01-17,20:50
024 Cit� Mion,2,6,8,2022,01-17,20:50
025 Nouveau Saint-Roch,4,4,8,2022,01-17,20:50
026 Renouvier,1,7,8,2022,01-17,20:50
027 Odysseum,6,2,8,2022,01-17,20:50
028 Saint-Denis,6,2,8,2022,01-17,20:50
029 Richter,7,9,16,2022,01-17,20:50
030 Charles Flahault,7,1,8,2022,01-17,20:50
031 Voltaire,4,4,8,2022,01-17,20:50
032 Pr�s d'Ar�nes,4,4,8,2022,01-17,20:50
033 Garcia Lorca,8,0,8,2022,01-17,20:50
034 Vert Bois,0,16,16,2022,01-17,20:50
035 Malbosc,2,6,8,2022,01-17,20:50
036 Occitanie,3,29,32,2022,01-17,20:50
037 FacdesSciences,2,22,24,2022,01-17,20:50
038 Fac de Lettres,4,12,16,2022,01-17,20:50
039 Aiguelongue,7,1,8,2022,01-17,20:50
040 Jeu de Mail des Abb�s,8,0,8,2022,01-17,20:50
041 Eurom�decine,1,7,8,2022,01-17,20:50
042 Marie Caizergues,1,7,8,2022,01-17,20:50
043 Sabines,1,7,8,2022,01-17,20:50
044 Celleneuve,0,8,8,2022,01-17,20:50
045 Jardin de la Lironde,8,0,8,2022,01-17,20:50
046 P�re Soulas,3,5,8,2022,01-17,20:50
047 Place Viala,0,8,8,2022,01-17,20:50
048 H�tel du D�partement,0,8,8,2022,01-17,20:50
049 Tonnelles,4,4,8,2022,01-17,20:50
050 Parvis Jules Ferry - Gare Saint-Roch,5,3,8,2022,01-17,20:50
051 Pont de Lattes - Gare Saint-Roch,3,9,12,2022,01-17,20:50
053 Deux Ponts - Gare Saint-Roch,3,5,8,2022,01-17,20:50
054 Providence - Ovalie,3,5,8,2022,01-17,20:50
055 P�rols Etang de l'Or,24,44,68,2022,01-17,20:50
056 Albert 1er - Cath�drale,0,12,12,2022,01-17,20:50
057 Saint-Guilhem - Courreau,0,8,8,2022,01-17,20:50
059 Sud De France,1,7,8,2022,01-17,20:50
001 Rue Jules Ferry - Gare Saint-Roch,7,5,12,2022,01-17,21:01
002 Com�die,5,19,24,2022,01-17,21:01
003 Esplanade,8,24,32,2022,01-17,21:01
004 H�tel de Ville,14,2,16,2022,01-17,21:01
005 Corum,5,7,12,2022,01-17,21:01
006 Place Albert 1er - St Charles,18,13,31,2022,01-17,21:01
007 Foch,2,6,8,2022,01-17,21:01
008 Halles Castellane,1,11,12,2022,01-17,21:01
009 Observatoire,5,3,8,2022,01-17,21:01
010 Rondelet,5,11,16,2022,01-17,21:01
011 Plan Cabanes,5,7,12,2022,01-17,21:01
012 Boutonnet,2,10,12,2022,01-17,21:01
013 Emile Combes,8,0,8,2022,01-17,21:01
014 Beaux-Arts,8,0,8,2022,01-17,21:01
015 Les Aubes,6,1,8,2022,01-17,21:01
016 Antigone centre,12,4,16,2022,01-17,21:01
017 M�diath�que Emile Zola,10,6,16,2022,01-17,21:01
018 Nombre d'Or,14,2,16,2022,01-17,21:01
019 Louis Blanc,10,6,16,2022,01-17,21:01
020 Gambetta,4,4,8,2022,01-17,21:01
021 Port Marianne,12,4,16,2022,01-17,21:01
022 Clemenceau,6,6,12,2022,01-17,21:01
023 Les Arceaux,0,16,16,2022,01-17,21:01
024 Cit� Mion,2,6,8,2022,01-17,21:01
025 Nouveau Saint-Roch,5,3,8,2022,01-17,21:01
026 Renouvier,1,7,8,2022,01-17,21:01
027 Odysseum,6,2,8,2022,01-17,21:01
028 Saint-Denis,6,2,8,2022,01-17,21:01
029 Richter,7,9,16,2022,01-17,21:01
030 Charles Flahault,7,1,8,2022,01-17,21:01
031 Voltaire,4,4,8,2022,01-17,21:01
032 Pr�s d'Ar�nes,4,4,8,2022,01-17,21:01
033 Garcia Lorca,8,0,8,2022,01-17,21:01
034 Vert Bois,0,16,16,2022,01-17,21:01
035 Malbosc,2,6,8,2022,01-17,21:01
036 Occitanie,3,29,32,2022,01-17,21:01
037 FacdesSciences,2,22,24,2022,01-17,21:01
038 Fac de Lettres,4,12,16,2022,01-17,21:01
039 Aiguelongue,7,1,8,2022,01-17,21:01
040 Jeu de Mail des Abb�s,8,0,8,2022,01-17,21:01
041 Eurom�decine,1,7,8,2022,01-17,21:01
042 Marie Caizergues,2,6,8,2022,01-17,21:01
043 Sabines,1,7,8,2022,01-17,21:01
044 Celleneuve,0,8,8,2022,01-17,21:01
045 Jardin de la Lironde,8,0,8,2022,01-17,21:01
046 P�re Soulas,3,5,8,2022,01-17,21:01
047 Place Viala,0,8,8,2022,01-17,21:01
048 H�tel du D�partement,0,8,8,2022,01-17,21:01
049 Tonnelles,4,4,8,2022,01-17,21:01
050 Parvis Jules Ferry - Gare Saint-Roch,5,3,8,2022,01-17,21:01
051 Pont de Lattes - Gare Saint-Roch,3,9,12,2022,01-17,21:01
053 Deux Ponts - Gare Saint-Roch,3,5,8,2022,01-17,21:01
054 Providence - Ovalie,3,5,8,2022,01-17,21:01
055 P�rols Etang de l'Or,24,44,68,2022,01-17,21:01
056 Albert 1er - Cath�drale,0,12,12,2022,01-17,21:01
057 Saint-Guilhem - Courreau,0,8,8,2022,01-17,21:01
059 Sud De France,1,7,8,2022,01-17,21:01
001 Rue Jules Ferry - Gare Saint-Roch,6,6,12,2022,01-17,21:11
002 Com�die,5,19,24,2022,01-17,21:11
003 Esplanade,8,24,32,2022,01-17,21:11
004 H�tel de Ville,14,2,16,2022,01-17,21:11
005 Corum,5,7,12,2022,01-17,21:11
006 Place Albert 1er - St Charles,18,13,31,2022,01-17,21:11
007 Foch,2,6,8,2022,01-17,21:11
008 Halles Castellane,1,11,12,2022,01-17,21:11
009 Observatoire,5,3,8,2022,01-17,21:11
010 Rondelet,5,11,16,2022,01-17,21:11
011 Plan Cabanes,5,7,12,2022,01-17,21:11
012 Boutonnet,2,10,12,2022,01-17,21:11
013 Emile Combes,8,0,8,2022,01-17,21:11
014 Beaux-Arts,8,0,8,2022,01-17,21:11
015 Les Aubes,6,1,8,2022,01-17,21:11
016 Antigone centre,12,4,16,2022,01-17,21:11
017 M�diath�que Emile Zola,10,6,16,2022,01-17,21:11
018 Nombre d'Or,14,2,16,2022,01-17,21:11
019 Louis Blanc,10,6,16,2022,01-17,21:11
020 Gambetta,4,4,8,2022,01-17,21:11
021 Port Marianne,12,4,16,2022,01-17,21:11
022 Clemenceau,6,6,12,2022,01-17,21:11
023 Les Arceaux,0,16,16,2022,01-17,21:11
024 Cit� Mion,2,6,8,2022,01-17,21:11
025 Nouveau Saint-Roch,4,4,8,2022,01-17,21:11
026 Renouvier,1,7,8,2022,01-17,21:11
027 Odysseum,6,2,8,2022,01-17,21:11
028 Saint-Denis,6,2,8,2022,01-17,21:11
029 Richter,7,9,16,2022,01-17,21:11
030 Charles Flahault,7,1,8,2022,01-17,21:11
031 Voltaire,4,4,8,2022,01-17,21:11
032 Pr�s d'Ar�nes,4,4,8,2022,01-17,21:11
033 Garcia Lorca,8,0,8,2022,01-17,21:11
034 Vert Bois,0,16,16,2022,01-17,21:11
035 Malbosc,2,6,8,2022,01-17,21:11
036 Occitanie,3,29,32,2022,01-17,21:11
037 FacdesSciences,0,24,24,2022,01-17,21:11
038 Fac de Lettres,4,12,16,2022,01-17,21:11
039 Aiguelongue,6,2,8,2022,01-17,21:11
040 Jeu de Mail des Abb�s,8,0,8,2022,01-17,21:11
041 Eurom�decine,1,7,8,2022,01-17,21:11
042 Marie Caizergues,2,6,8,2022,01-17,21:11
043 Sabines,1,7,8,2022,01-17,21:11
044 Celleneuve,0,8,8,2022,01-17,21:11
045 Jardin de la Lironde,8,0,8,2022,01-17,21:11
046 P�re Soulas,3,5,8,2022,01-17,21:11
047 Place Viala,0,8,8,2022,01-17,21:11
048 H�tel du D�partement,0,8,8,2022,01-17,21:11
049 Tonnelles,4,4,8,2022,01-17,21:11
050 Parvis Jules Ferry - Gare Saint-Roch,5,3,8,2022,01-17,21:11
051 Pont de Lattes - Gare Saint-Roch,3,9,12,2022,01-17,21:11
053 Deux Ponts - Gare Saint-Roch,3,5,8,2022,01-17,21:11
054 Providence - Ovalie,3,5,8,2022,01-17,21:11
055 P�rols Etang de l'Or,24,44,68,2022,01-17,21:11
056 Albert 1er - Cath�drale,0,12,12,2022,01-17,21:11
057 Saint-Guilhem - Courreau,0,8,8,2022,01-17,21:11
059 Sud De France,1,7,8,2022,01-17,21:11
001 Rue Jules Ferry - Gare Saint-Roch,6,6,12,2022,01-17,21:31
002 Com�die,5,19,24,2022,01-17,21:31
003 Esplanade,8,24,32,2022,01-17,21:31
004 H�tel de Ville,14,2,16,2022,01-17,21:31
005 Corum,5,7,12,2022,01-17,21:31
006 Place Albert 1er - St Charles,18,13,31,2022,01-17,21:31
007 Foch,2,6,8,2022,01-17,21:31
008 Halles Castellane,1,11,12,2022,01-17,21:31
009 Observatoire,3,5,8,2022,01-17,21:31
010 Rondelet,5,11,16,2022,01-17,21:31
011 Plan Cabanes,5,7,12,2022,01-17,21:31
012 Boutonnet,2,10,12,2022,01-17,21:31
013 Emile Combes,8,0,8,2022,01-17,21:31
014 Beaux-Arts,8,0,8,2022,01-17,21:31
015 Les Aubes,6,1,8,2022,01-17,21:31
016 Antigone centre,12,4,16,2022,01-17,21:31
017 M�diath�que Emile Zola,10,6,16,2022,01-17,21:31
018 Nombre d'Or,14,2,16,2022,01-17,21:31
019 Louis Blanc,10,6,16,2022,01-17,21:31
020 Gambetta,4,4,8,2022,01-17,21:31
021 Port Marianne,12,4,16,2022,01-17,21:31
022 Clemenceau,6,6,12,2022,01-17,21:31
023 Les Arceaux,0,16,16,2022,01-17,21:31
024 Cit� Mion,2,6,8,2022,01-17,21:31
025 Nouveau Saint-Roch,4,4,8,2022,01-17,21:31
026 Renouvier,1,7,8,2022,01-17,21:31
027 Odysseum,6,2,8,2022,01-17,21:31
028 Saint-Denis,6,2,8,2022,01-17,21:31
029 Richter,7,9,16,2022,01-17,21:31
030 Charles Flahault,7,1,8,2022,01-17,21:31
031 Voltaire,4,4,8,2022,01-17,21:31
032 Pr�s d'Ar�nes,5,3,8,2022,01-17,21:31
033 Garcia Lorca,8,0,8,2022,01-17,21:31
034 Vert Bois,0,16,16,2022,01-17,21:31
035 Malbosc,1,7,8,2022,01-17,21:31
036 Occitanie,3,29,32,2022,01-17,21:31
037 FacdesSciences,0,24,24,2022,01-17,21:31
038 Fac de Lettres,5,11,16,2022,01-17,21:31
039 Aiguelongue,6,2,8,2022,01-17,21:31
040 Jeu de Mail des Abb�s,8,0,8,2022,01-17,21:31
041 Eurom�decine,1,7,8,2022,01-17,21:31
042 Marie Caizergues,3,5,8,2022,01-17,21:31
043 Sabines,0,8,8,2022,01-17,21:31
044 Celleneuve,0,8,8,2022,01-17,21:31
045 Jardin de la Lironde,8,0,8,2022,01-17,21:31
046 P�re Soulas,3,5,8,2022,01-17,21:31
047 Place Viala,1,7,8,2022,01-17,21:31
048 H�tel du D�partement,0,8,8,2022,01-17,21:31
049 Tonnelles,4,4,8,2022,01-17,21:31
050 Parvis Jules Ferry - Gare Saint-Roch,5,3,8,2022,01-17,21:31
051 Pont de Lattes - Gare Saint-Roch,3,9,12,2022,01-17,21:31
053 Deux Ponts - Gare Saint-Roch,3,5,8,2022,01-17,21:31
054 Providence - Ovalie,3,5,8,2022,01-17,21:31
055 P�rols Etang de l'Or,24,44,68,2022,01-17,21:31
056 Albert 1er - Cath�drale,0,12,12,2022,01-17,21:31
057 Saint-Guilhem - Courreau,0,8,8,2022,01-17,21:31
059 Sud De France,1,7,8,2022,01-17,21:31
001 Rue Jules Ferry - Gare Saint-Roch,6,6,12,2022,01-17,21:42
002 Com�die,5,19,24,2022,01-17,21:42
003 Esplanade,8,24,32,2022,01-17,21:42
004 H�tel de Ville,14,2,16,2022,01-17,21:42
005 Corum,5,7,12,2022,01-17,21:42
006 Place Albert 1er - St Charles,20,11,31,2022,01-17,21:42
007 Foch,1,7,8,2022,01-17,21:42
008 Halles Castellane,1,11,12,2022,01-17,21:42
009 Observatoire,3,5,8,2022,01-17,21:42
010 Rondelet,5,11,16,2022,01-17,21:42
011 Plan Cabanes,5,7,12,2022,01-17,21:42
012 Boutonnet,2,10,12,2022,01-17,21:42
013 Emile Combes,8,0,8,2022,01-17,21:42
014 Beaux-Arts,8,0,8,2022,01-17,21:42
015 Les Aubes,6,1,8,2022,01-17,21:42
016 Antigone centre,12,4,16,2022,01-17,21:42
017 M�diath�que Emile Zola,10,6,16,2022,01-17,21:42
018 Nombre d'Or,14,2,16,2022,01-17,21:42
019 Louis Blanc,10,6,16,2022,01-17,21:42
020 Gambetta,4,4,8,2022,01-17,21:42
021 Port Marianne,12,4,16,2022,01-17,21:42
022 Clemenceau,7,5,12,2022,01-17,21:42
023 Les Arceaux,0,16,16,2022,01-17,21:42
024 Cit� Mion,3,5,8,2022,01-17,21:42
025 Nouveau Saint-Roch,4,4,8,2022,01-17,21:42
026 Renouvier,1,7,8,2022,01-17,21:42
027 Odysseum,6,2,8,2022,01-17,21:42
028 Saint-Denis,6,2,8,2022,01-17,21:42
029 Richter,7,9,16,2022,01-17,21:42
030 Charles Flahault,7,1,8,2022,01-17,21:42
031 Voltaire,4,4,8,2022,01-17,21:42
032 Pr�s d'Ar�nes,7,1,8,2022,01-17,21:42
033 Garcia Lorca,8,0,8,2022,01-17,21:42
034 Vert Bois,0,16,16,2022,01-17,21:42
035 Malbosc,1,7,8,2022,01-17,21:42
036 Occitanie,3,29,32,2022,01-17,21:42
037 FacdesSciences,1,23,24,2022,01-17,21:42
038 Fac de Lettres,5,11,16,2022,01-17,21:42
039 Aiguelongue,6,2,8,2022,01-17,21:42
040 Jeu de Mail des Abb�s,8,0,8,2022,01-17,21:42
041 Eurom�decine,1,7,8,2022,01-17,21:42
042 Marie Caizergues,3,5,8,2022,01-17,21:42
043 Sabines,0,8,8,2022,01-17,21:42
044 Celleneuve,0,8,8,2022,01-17,21:42
045 Jardin de la Lironde,8,0,8,2022,01-17,21:42
046 P�re Soulas,3,5,8,2022,01-17,21:42
047 Place Viala,0,8,8,2022,01-17,21:42
048 H�tel du D�partement,0,8,8,2022,01-17,21:42
049 Tonnelles,4,4,8,2022,01-17,21:42
050 Parvis Jules Ferry - Gare Saint-Roch,5,3,8,2022,01-17,21:42
051 Pont de Lattes - Gare Saint-Roch,2,10,12,2022,01-17,21:42
053 Deux Ponts - Gare Saint-Roch,3,5,8,2022,01-17,21:42
054 Providence - Ovalie,3,5,8,2022,01-17,21:42
055 P�rols Etang de l'Or,24,44,68,2022,01-17,21:42
056 Albert 1er - Cath�drale,0,12,12,2022,01-17,21:42
057 Saint-Guilhem - Courreau,2,6,8,2022,01-17,21:42
059 Sud De France,1,7,8,2022,01-17,21:42
001 Rue Jules Ferry - Gare Saint-Roch,6,6,12,2022,01-17,21:52
002 Com�die,5,19,24,2022,01-17,21:52
003 Esplanade,6,26,32,2022,01-17,21:52
004 H�tel de Ville,14,2,16,2022,01-17,21:52
005 Corum,5,7,12,2022,01-17,21:52
006 Place Albert 1er - St Charles,20,11,31,2022,01-17,21:52
007 Foch,1,7,8,2022,01-17,21:52
008 Halles Castellane,1,11,12,2022,01-17,21:52
009 Observatoire,3,5,8,2022,01-17,21:52
010 Rondelet,5,11,16,2022,01-17,21:52
011 Plan Cabanes,6,6,12,2022,01-17,21:52
012 Boutonnet,2,10,12,2022,01-17,21:52
013 Emile Combes,8,0,8,2022,01-17,21:52
014 Beaux-Arts,8,0,8,2022,01-17,21:52
015 Les Aubes,6,1,8,2022,01-17,21:52
016 Antigone centre,12,4,16,2022,01-17,21:52
017 M�diath�que Emile Zola,10,6,16,2022,01-17,21:52
018 Nombre d'Or,14,2,16,2022,01-17,21:52
019 Louis Blanc,10,6,16,2022,01-17,21:52
020 Gambetta,4,4,8,2022,01-17,21:52
021 Port Marianne,12,4,16,2022,01-17,21:52
022 Clemenceau,7,5,12,2022,01-17,21:52
023 Les Arceaux,0,16,16,2022,01-17,21:52
024 Cit� Mion,3,5,8,2022,01-17,21:52
025 Nouveau Saint-Roch,4,4,8,2022,01-17,21:52
026 Renouvier,1,7,8,2022,01-17,21:52
027 Odysseum,6,2,8,2022,01-17,21:52
028 Saint-Denis,7,1,8,2022,01-17,21:52
029 Richter,7,9,16,2022,01-17,21:52
030 Charles Flahault,7,1,8,2022,01-17,21:52
031 Voltaire,4,4,8,2022,01-17,21:52
032 Pr�s d'Ar�nes,7,1,8,2022,01-17,21:52
033 Garcia Lorca,8,0,8,2022,01-17,21:52
034 Vert Bois,0,16,16,2022,01-17,21:52
035 Malbosc,1,7,8,2022,01-17,21:52
036 Occitanie,3,29,32,2022,01-17,21:52
037 FacdesSciences,1,23,24,2022,01-17,21:52
038 Fac de Lettres,5,11,16,2022,01-17,21:52
039 Aiguelongue,6,2,8,2022,01-17,21:52
040 Jeu de Mail des Abb�s,8,0,8,2022,01-17,21:52
041 Eurom�decine,1,7,8,2022,01-17,21:52
042 Marie Caizergues,3,5,8,2022,01-17,21:52
043 Sabines,0,8,8,2022,01-17,21:52
044 Celleneuve,0,8,8,2022,01-17,21:52
045 Jardin de la Lironde,8,0,8,2022,01-17,21:52
046 P�re Soulas,3,5,8,2022,01-17,21:52
047 Place Viala,0,8,8,2022,01-17,21:52
048 H�tel du D�partement,0,8,8,2022,01-17,21:52
049 Tonnelles,4,4,8,2022,01-17,21:52
050 Parvis Jules Ferry - Gare Saint-Roch,5,3,8,2022,01-17,21:52
051 Pont de Lattes - Gare Saint-Roch,2,10,12,2022,01-17,21:52
053 Deux Ponts - Gare Saint-Roch,3,5,8,2022,01-17,21:52
054 Providence - Ovalie,3,5,8,2022,01-17,21:52
055 P�rols Etang de l'Or,24,44,68,2022,01-17,21:52
056 Albert 1er - Cath�drale,0,12,12,2022,01-17,21:52
057 Saint-Guilhem - Courreau,2,6,8,2022,01-17,21:52
059 Sud De France,1,7,8,2022,01-17,21:52
001 Rue Jules Ferry - Gare Saint-Roch,6,6,12,2022,01-17,22:02
002 Com�die,5,19,24,2022,01-17,22:02
003 Esplanade,5,27,32,2022,01-17,22:02
004 H�tel de Ville,14,2,16,2022,01-17,22:02
005 Corum,5,7,12,2022,01-17,22:02
006 Place Albert 1er - St Charles,20,11,31,2022,01-17,22:02
007 Foch,1,7,8,2022,01-17,22:02
008 Halles Castellane,1,11,12,2022,01-17,22:02
009 Observatoire,3,5,8,2022,01-17,22:02
010 Rondelet,5,11,16,2022,01-17,22:02
011 Plan Cabanes,6,6,12,2022,01-17,22:02
012 Boutonnet,1,11,12,2022,01-17,22:02
013 Emile Combes,8,0,8,2022,01-17,22:02
014 Beaux-Arts,8,0,8,2022,01-17,22:02
015 Les Aubes,6,1,8,2022,01-17,22:02
016 Antigone centre,13,3,16,2022,01-17,22:02
017 M�diath�que Emile Zola,10,6,16,2022,01-17,22:02
018 Nombre d'Or,14,2,16,2022,01-17,22:02
019 Louis Blanc,10,6,16,2022,01-17,22:02
020 Gambetta,4,4,8,2022,01-17,22:02
021 Port Marianne,12,4,16,2022,01-17,22:02
022 Clemenceau,7,5,12,2022,01-17,22:02
023 Les Arceaux,0,16,16,2022,01-17,22:02
024 Cit� Mion,3,5,8,2022,01-17,22:02
025 Nouveau Saint-Roch,4,4,8,2022,01-17,22:02
026 Renouvier,1,7,8,2022,01-17,22:02
027 Odysseum,6,2,8,2022,01-17,22:02
028 Saint-Denis,7,1,8,2022,01-17,22:02
029 Richter,7,9,16,2022,01-17,22:02
030 Charles Flahault,7,1,8,2022,01-17,22:02
031 Voltaire,4,4,8,2022,01-17,22:02
032 Pr�s d'Ar�nes,7,1,8,2022,01-17,22:02
033 Garcia Lorca,7,1,8,2022,01-17,22:02
034 Vert Bois,0,16,16,2022,01-17,22:02
035 Malbosc,1,7,8,2022,01-17,22:02
036 Occitanie,3,29,32,2022,01-17,22:02
037 FacdesSciences,1,23,24,2022,01-17,22:02
038 Fac de Lettres,5,11,16,2022,01-17,22:02
039 Aiguelongue,6,2,8,2022,01-17,22:02
040 Jeu de Mail des Abb�s,8,0,8,2022,01-17,22:02
041 Eurom�decine,1,7,8,2022,01-17,22:02
042 Marie Caizergues,3,5,8,2022,01-17,22:02
043 Sabines,0,8,8,2022,01-17,22:02
044 Celleneuve,0,8,8,2022,01-17,22:02
045 Jardin de la Lironde,8,0,8,2022,01-17,22:02
046 P�re Soulas,3,5,8,2022,01-17,22:02
047 Place Viala,0,8,8,2022,01-17,22:02
048 H�tel du D�partement,0,8,8,2022,01-17,22:02
049 Tonnelles,3,5,8,2022,01-17,22:02
050 Parvis Jules Ferry - Gare Saint-Roch,5,3,8,2022,01-17,22:02
051 Pont de Lattes - Gare Saint-Roch,2,10,12,2022,01-17,22:02
053 Deux Ponts - Gare Saint-Roch,3,5,8,2022,01-17,22:02
054 Providence - Ovalie,3,5,8,2022,01-17,22:02
055 P�rols Etang de l'Or,24,44,68,2022,01-17,22:02
056 Albert 1er - Cath�drale,0,12,12,2022,01-17,22:02
057 Saint-Guilhem - Courreau,2,6,8,2022,01-17,22:02
059 Sud De France,1,7,8,2022,01-17,22:02
001 Rue Jules Ferry - Gare Saint-Roch,6,6,12,2022,01-17,22:12
002 Com�die,5,19,24,2022,01-17,22:12
003 Esplanade,5,27,32,2022,01-17,22:12
004 H�tel de Ville,14,2,16,2022,01-17,22:12
005 Corum,5,7,12,2022,01-17,22:12
006 Place Albert 1er - St Charles,20,11,31,2022,01-17,22:12
007 Foch,1,7,8,2022,01-17,22:12
008 Halles Castellane,0,12,12,2022,01-17,22:12
009 Observatoire,3,5,8,2022,01-17,22:12
010 Rondelet,5,11,16,2022,01-17,22:12
011 Plan Cabanes,7,5,12,2022,01-17,22:12
012 Boutonnet,1,11,12,2022,01-17,22:12
013 Emile Combes,8,0,8,2022,01-17,22:12
014 Beaux-Arts,8,0,8,2022,01-17,22:12
015 Les Aubes,6,1,8,2022,01-17,22:12
016 Antigone centre,13,3,16,2022,01-17,22:12
017 M�diath�que Emile Zola,10,6,16,2022,01-17,22:12
018 Nombre d'Or,14,2,16,2022,01-17,22:12
019 Louis Blanc,12,4,16,2022,01-17,22:12
020 Gambetta,4,4,8,2022,01-17,22:12
021 Port Marianne,12,4,16,2022,01-17,22:12
022 Clemenceau,7,5,12,2022,01-17,22:12
023 Les Arceaux,0,16,16,2022,01-17,22:12
024 Cit� Mion,3,5,8,2022,01-17,22:12
025 Nouveau Saint-Roch,4,4,8,2022,01-17,22:12
026 Renouvier,1,7,8,2022,01-17,22:12
027 Odysseum,6,2,8,2022,01-17,22:12
028 Saint-Denis,7,1,8,2022,01-17,22:12
029 Richter,7,9,16,2022,01-17,22:12
030 Charles Flahault,7,1,8,2022,01-17,22:12
031 Voltaire,4,4,8,2022,01-17,22:12
032 Pr�s d'Ar�nes,7,1,8,2022,01-17,22:12
033 Garcia Lorca,7,1,8,2022,01-17,22:12
034 Vert Bois,0,16,16,2022,01-17,22:12
035 Malbosc,1,7,8,2022,01-17,22:12
036 Occitanie,2,30,32,2022,01-17,22:12
037 FacdesSciences,0,24,24,2022,01-17,22:12
038 Fac de Lettres,5,11,16,2022,01-17,22:12
039 Aiguelongue,8,0,8,2022,01-17,22:12
040 Jeu de Mail des Abb�s,8,0,8,2022,01-17,22:12
041 Eurom�decine,1,7,8,2022,01-17,22:12
042 Marie Caizergues,3,5,8,2022,01-17,22:12
043 Sabines,0,8,8,2022,01-17,22:12
044 Celleneuve,0,8,8,2022,01-17,22:12
045 Jardin de la Lironde,8,0,8,2022,01-17,22:12
046 P�re Soulas,3,5,8,2022,01-17,22:12
047 Place Viala,0,8,8,2022,01-17,22:12
048 H�tel du D�partement,0,8,8,2022,01-17,22:12
049 Tonnelles,3,5,8,2022,01-17,22:12
050 Parvis Jules Ferry - Gare Saint-Roch,5,3,8,2022,01-17,22:12
051 Pont de Lattes - Gare Saint-Roch,1,11,12,2022,01-17,22:12
053 Deux Ponts - Gare Saint-Roch,3,5,8,2022,01-17,22:12
054 Providence - Ovalie,3,5,8,2022,01-17,22:12
055 P�rols Etang de l'Or,24,44,68,2022,01-17,22:12
056 Albert 1er - Cath�drale,0,12,12,2022,01-17,22:12
057 Saint-Guilhem - Courreau,2,6,8,2022,01-17,22:12
059 Sud De France,1,7,8,2022,01-17,22:12
001 Rue Jules Ferry - Gare Saint-Roch,6,6,12,2022,01-17,22:22
002 Com�die,5,19,24,2022,01-17,22:22
003 Esplanade,5,27,32,2022,01-17,22:22
004 H�tel de Ville,14,2,16,2022,01-17,22:22
005 Corum,5,7,12,2022,01-17,22:22
006 Place Albert 1er - St Charles,19,12,31,2022,01-17,22:22
007 Foch,1,7,8,2022,01-17,22:22
008 Halles Castellane,0,12,12,2022,01-17,22:22
009 Observatoire,3,5,8,2022,01-17,22:22
010 Rondelet,5,11,16,2022,01-17,22:22
011 Plan Cabanes,7,5,12,2022,01-17,22:22
012 Boutonnet,1,11,12,2022,01-17,22:22
013 Emile Combes,8,0,8,2022,01-17,22:22
014 Beaux-Arts,8,0,8,2022,01-17,22:22
015 Les Aubes,6,1,8,2022,01-17,22:22
016 Antigone centre,13,3,16,2022,01-17,22:22
017 M�diath�que Emile Zola,10,6,16,2022,01-17,22:22
018 Nombre d'Or,14,2,16,2022,01-17,22:22
019 Louis Blanc,12,4,16,2022,01-17,22:22
020 Gambetta,4,4,8,2022,01-17,22:22
021 Port Marianne,12,4,16,2022,01-17,22:22
022 Clemenceau,7,5,12,2022,01-17,22:22
023 Les Arceaux,0,16,16,2022,01-17,22:22
024 Cit� Mion,3,5,8,2022,01-17,22:22
025 Nouveau Saint-Roch,4,4,8,2022,01-17,22:22
026 Renouvier,1,7,8,2022,01-17,22:22
027 Odysseum,6,2,8,2022,01-17,22:22
028 Saint-Denis,7,1,8,2022,01-17,22:22
029 Richter,7,9,16,2022,01-17,22:22
030 Charles Flahault,7,1,8,2022,01-17,22:22
031 Voltaire,4,4,8,2022,01-17,22:22
032 Pr�s d'Ar�nes,7,1,8,2022,01-17,22:22
033 Garcia Lorca,7,1,8,2022,01-17,22:22
034 Vert Bois,0,16,16,2022,01-17,22:22
035 Malbosc,1,7,8,2022,01-17,22:22
036 Occitanie,3,29,32,2022,01-17,22:22
037 FacdesSciences,0,24,24,2022,01-17,22:22
038 Fac de Lettres,5,11,16,2022,01-17,22:22
039 Aiguelongue,8,0,8,2022,01-17,22:22
040 Jeu de Mail des Abb�s,8,0,8,2022,01-17,22:22
041 Eurom�decine,1,7,8,2022,01-17,22:22
042 Marie Caizergues,3,5,8,2022,01-17,22:22
043 Sabines,0,8,8,2022,01-17,22:22
044 Celleneuve,0,8,8,2022,01-17,22:22
045 Jardin de la Lironde,8,0,8,2022,01-17,22:22
046 P�re Soulas,3,5,8,2022,01-17,22:22
047 Place Viala,0,8,8,2022,01-17,22:22
048 H�tel du D�partement,0,8,8,2022,01-17,22:22
049 Tonnelles,3,5,8,2022,01-17,22:22
050 Parvis Jules Ferry - Gare Saint-Roch,5,3,8,2022,01-17,22:22
051 Pont de Lattes - Gare Saint-Roch,1,11,12,2022,01-17,22:22
053 Deux Ponts - Gare Saint-Roch,3,5,8,2022,01-17,22:22
054 Providence - Ovalie,3,5,8,2022,01-17,22:22
055 P�rols Etang de l'Or,24,44,68,2022,01-17,22:22
056 Albert 1er - Cath�drale,0,12,12,2022,01-17,22:22
057 Saint-Guilhem - Courreau,2,6,8,2022,01-17,22:22
059 Sud De France,1,7,8,2022,01-17,22:22
001 Rue Jules Ferry - Gare Saint-Roch,7,5,12,2022,01-17,22:32
002 Com�die,5,19,24,2022,01-17,22:32
003 Esplanade,5,27,32,2022,01-17,22:32
004 H�tel de Ville,14,2,16,2022,01-17,22:32
005 Corum,5,7,12,2022,01-17,22:32
006 Place Albert 1er - St Charles,19,12,31,2022,01-17,22:32
007 Foch,1,7,8,2022,01-17,22:32
008 Halles Castellane,0,12,12,2022,01-17,22:32
009 Observatoire,3,5,8,2022,01-17,22:32
010 Rondelet,5,11,16,2022,01-17,22:32
011 Plan Cabanes,7,5,12,2022,01-17,22:32
012 Boutonnet,1,11,12,2022,01-17,22:32
013 Emile Combes,8,0,8,2022,01-17,22:32
014 Beaux-Arts,8,0,8,2022,01-17,22:32
015 Les Aubes,6,1,8,2022,01-17,22:32
016 Antigone centre,13,3,16,2022,01-17,22:32
017 M�diath�que Emile Zola,10,6,16,2022,01-17,22:32
018 Nombre d'Or,14,2,16,2022,01-17,22:32
019 Louis Blanc,12,4,16,2022,01-17,22:32
020 Gambetta,4,4,8,2022,01-17,22:32
021 Port Marianne,11,5,16,2022,01-17,22:32
022 Clemenceau,7,5,12,2022,01-17,22:32
023 Les Arceaux,0,16,16,2022,01-17,22:32
024 Cit� Mion,3,5,8,2022,01-17,22:32
025 Nouveau Saint-Roch,4,4,8,2022,01-17,22:32
026 Renouvier,1,7,8,2022,01-17,22:32
027 Odysseum,5,3,8,2022,01-17,22:32
028 Saint-Denis,7,1,8,2022,01-17,22:32
029 Richter,7,9,16,2022,01-17,22:32
030 Charles Flahault,7,1,8,2022,01-17,22:32
031 Voltaire,4,4,8,2022,01-17,22:32
032 Pr�s d'Ar�nes,7,1,8,2022,01-17,22:32
033 Garcia Lorca,8,0,8,2022,01-17,22:32
034 Vert Bois,0,16,16,2022,01-17,22:32
035 Malbosc,1,7,8,2022,01-17,22:32
036 Occitanie,2,30,32,2022,01-17,22:32
037 FacdesSciences,0,24,24,2022,01-17,22:32
038 Fac de Lettres,5,11,16,2022,01-17,22:32
039 Aiguelongue,8,0,8,2022,01-17,22:32
040 Jeu de Mail des Abb�s,8,0,8,2022,01-17,22:32
041 Eurom�decine,1,7,8,2022,01-17,22:32
042 Marie Caizergues,3,5,8,2022,01-17,22:32
043 Sabines,0,8,8,2022,01-17,22:32
044 Celleneuve,0,8,8,2022,01-17,22:32
045 Jardin de la Lironde,8,0,8,2022,01-17,22:32
046 P�re Soulas,3,5,8,2022,01-17,22:32
047 Place Viala,1,7,8,2022,01-17,22:32
048 H�tel du D�partement,0,8,8,2022,01-17,22:32
049 Tonnelles,3,5,8,2022,01-17,22:32
050 Parvis Jules Ferry - Gare Saint-Roch,5,3,8,2022,01-17,22:32
051 Pont de Lattes - Gare Saint-Roch,1,11,12,2022,01-17,22:32
053 Deux Ponts - Gare Saint-Roch,3,5,8,2022,01-17,22:32
054 Providence - Ovalie,3,5,8,2022,01-17,22:32
055 P�rols Etang de l'Or,24,44,68,2022,01-17,22:32
056 Albert 1er - Cath�drale,0,12,12,2022,01-17,22:32
057 Saint-Guilhem - Courreau,2,6,8,2022,01-17,22:32
059 Sud De France,1,7,8,2022,01-17,22:32
001 Rue Jules Ferry - Gare Saint-Roch,7,5,12,2022,01-17,22:43
002 Com�die,5,19,24,2022,01-17,22:43
003 Esplanade,5,27,32,2022,01-17,22:43
004 H�tel de Ville,14,2,16,2022,01-17,22:43
005 Corum,5,7,12,2022,01-17,22:43
006 Place Albert 1er - St Charles,19,12,31,2022,01-17,22:43
007 Foch,1,7,8,2022,01-17,22:43
008 Halles Castellane,0,12,12,2022,01-17,22:43
009 Observatoire,2,6,8,2022,01-17,22:43
010 Rondelet,5,11,16,2022,01-17,22:43
011 Plan Cabanes,7,5,12,2022,01-17,22:43
012 Boutonnet,1,11,12,2022,01-17,22:43
013 Emile Combes,8,0,8,2022,01-17,22:43
014 Beaux-Arts,8,0,8,2022,01-17,22:43
015 Les Aubes,6,1,8,2022,01-17,22:43
016 Antigone centre,13,3,16,2022,01-17,22:43
017 M�diath�que Emile Zola,10,6,16,2022,01-17,22:43
018 Nombre d'Or,14,2,16,2022,01-17,22:43
019 Louis Blanc,11,5,16,2022,01-17,22:43
020 Gambetta,4,4,8,2022,01-17,22:43
021 Port Marianne,11,5,16,2022,01-17,22:43
022 Clemenceau,7,5,12,2022,01-17,22:43
023 Les Arceaux,0,16,16,2022,01-17,22:43
024 Cit� Mion,3,5,8,2022,01-17,22:43
025 Nouveau Saint-Roch,4,4,8,2022,01-17,22:43
026 Renouvier,1,7,8,2022,01-17,22:43
027 Odysseum,5,3,8,2022,01-17,22:43
028 Saint-Denis,7,1,8,2022,01-17,22:43
029 Richter,7,9,16,2022,01-17,22:43
030 Charles Flahault,7,1,8,2022,01-17,22:43
031 Voltaire,5,3,8,2022,01-17,22:43
032 Pr�s d'Ar�nes,7,1,8,2022,01-17,22:43
033 Garcia Lorca,8,0,8,2022,01-17,22:43
034 Vert Bois,0,16,16,2022,01-17,22:43
035 Malbosc,1,7,8,2022,01-17,22:43
036 Occitanie,2,30,32,2022,01-17,22:43
037 FacdesSciences,0,24,24,2022,01-17,22:43
038 Fac de Lettres,5,11,16,2022,01-17,22:43
039 Aiguelongue,8,0,8,2022,01-17,22:43
040 Jeu de Mail des Abb�s,8,0,8,2022,01-17,22:43
041 Eurom�decine,1,7,8,2022,01-17,22:43
042 Marie Caizergues,3,5,8,2022,01-17,22:43
043 Sabines,0,8,8,2022,01-17,22:43
044 Celleneuve,0,8,8,2022,01-17,22:43
045 Jardin de la Lironde,8,0,8,2022,01-17,22:43
046 P�re Soulas,3,5,8,2022,01-17,22:43
047 Place Viala,1,7,8,2022,01-17,22:43
048 H�tel du D�partement,0,8,8,2022,01-17,22:43
049 Tonnelles,3,5,8,2022,01-17,22:43
050 Parvis Jules Ferry - Gare Saint-Roch,5,3,8,2022,01-17,22:43
051 Pont de Lattes - Gare Saint-Roch,1,11,12,2022,01-17,22:43
053 Deux Ponts - Gare Saint-Roch,3,5,8,2022,01-17,22:43
054 Providence - Ovalie,3,5,8,2022,01-17,22:43
055 P�rols Etang de l'Or,24,44,68,2022,01-17,22:43
056 Albert 1er - Cath�drale,0,12,12,2022,01-17,22:43
057 Saint-Guilhem - Courreau,2,6,8,2022,01-17,22:43
059 Sud De France,1,7,8,2022,01-17,22:43
001 Rue Jules Ferry - Gare Saint-Roch,7,5,12,2022,01-17,22:53
002 Com�die,5,19,24,2022,01-17,22:53
003 Esplanade,5,27,32,2022,01-17,22:53
004 H�tel de Ville,14,2,16,2022,01-17,22:53
005 Corum,5,7,12,2022,01-17,22:53
006 Place Albert 1er - St Charles,15,16,31,2022,01-17,22:53
007 Foch,1,7,8,2022,01-17,22:53
008 Halles Castellane,0,12,12,2022,01-17,22:53
009 Observatoire,2,6,8,2022,01-17,22:53
010 Rondelet,5,11,16,2022,01-17,22:53
011 Plan Cabanes,7,5,12,2022,01-17,22:53
012 Boutonnet,1,11,12,2022,01-17,22:53
013 Emile Combes,8,0,8,2022,01-17,22:53
014 Beaux-Arts,8,0,8,2022,01-17,22:53
015 Les Aubes,6,1,8,2022,01-17,22:53
016 Antigone centre,13,3,16,2022,01-17,22:53
017 M�diath�que Emile Zola,10,6,16,2022,01-17,22:53
018 Nombre d'Or,14,2,16,2022,01-17,22:53
019 Louis Blanc,11,5,16,2022,01-17,22:53
020 Gambetta,4,4,8,2022,01-17,22:53
021 Port Marianne,11,5,16,2022,01-17,22:53
022 Clemenceau,7,5,12,2022,01-17,22:53
023 Les Arceaux,0,16,16,2022,01-17,22:53
024 Cit� Mion,3,5,8,2022,01-17,22:53
025 Nouveau Saint-Roch,4,4,8,2022,01-17,22:53
026 Renouvier,1,7,8,2022,01-17,22:53
027 Odysseum,5,3,8,2022,01-17,22:53
028 Saint-Denis,7,1,8,2022,01-17,22:53
029 Richter,7,9,16,2022,01-17,22:53
030 Charles Flahault,7,1,8,2022,01-17,22:53
031 Voltaire,5,3,8,2022,01-17,22:53
032 Pr�s d'Ar�nes,7,1,8,2022,01-17,22:53
033 Garcia Lorca,8,0,8,2022,01-17,22:53
034 Vert Bois,0,16,16,2022,01-17,22:53
035 Malbosc,1,7,8,2022,01-17,22:53
036 Occitanie,1,31,32,2022,01-17,22:53
037 FacdesSciences,0,24,24,2022,01-17,22:53
038 Fac de Lettres,5,11,16,2022,01-17,22:53
039 Aiguelongue,8,0,8,2022,01-17,22:53
040 Jeu de Mail des Abb�s,8,0,8,2022,01-17,22:53
041 Eurom�decine,1,7,8,2022,01-17,22:53
042 Marie Caizergues,3,5,8,2022,01-17,22:53
043 Sabines,0,8,8,2022,01-17,22:53
044 Celleneuve,0,8,8,2022,01-17,22:53
045 Jardin de la Lironde,8,0,8,2022,01-17,22:53
046 P�re Soulas,3,5,8,2022,01-17,22:53
047 Place Viala,1,7,8,2022,01-17,22:53
048 H�tel du D�partement,0,8,8,2022,01-17,22:53
049 Tonnelles,3,5,8,2022,01-17,22:53
050 Parvis Jules Ferry - Gare Saint-Roch,6,2,8,2022,01-17,22:53
051 Pont de Lattes - Gare Saint-Roch,1,11,12,2022,01-17,22:53
053 Deux Ponts - Gare Saint-Roch,3,5,8,2022,01-17,22:53
054 Providence - Ovalie,3,5,8,2022,01-17,22:53
055 P�rols Etang de l'Or,24,44,68,2022,01-17,22:53
056 Albert 1er - Cath�drale,0,12,12,2022,01-17,22:53
057 Saint-Guilhem - Courreau,3,5,8,2022,01-17,22:53
059 Sud De France,1,7,8,2022,01-17,22:53
001 Rue Jules Ferry - Gare Saint-Roch,7,5,12,2022,01-17,23:03
002 Com�die,3,21,24,2022,01-17,23:03
003 Esplanade,5,27,32,2022,01-17,23:03
004 H�tel de Ville,14,2,16,2022,01-17,23:03
005 Corum,5,7,12,2022,01-17,23:03
006 Place Albert 1er - St Charles,10,21,31,2022,01-17,23:03
007 Foch,1,7,8,2022,01-17,23:03
008 Halles Castellane,0,12,12,2022,01-17,23:03
009 Observatoire,2,6,8,2022,01-17,23:03
010 Rondelet,5,11,16,2022,01-17,23:03
011 Plan Cabanes,7,5,12,2022,01-17,23:03
012 Boutonnet,1,11,12,2022,01-17,23:03
013 Emile Combes,8,0,8,2022,01-17,23:03
014 Beaux-Arts,8,0,8,2022,01-17,23:03
015 Les Aubes,6,1,8,2022,01-17,23:03
016 Antigone centre,13,3,16,2022,01-17,23:03
017 M�diath�que Emile Zola,10,6,16,2022,01-17,23:03
018 Nombre d'Or,14,2,16,2022,01-17,23:03
019 Louis Blanc,11,5,16,2022,01-17,23:03
020 Gambetta,4,4,8,2022,01-17,23:03
021 Port Marianne,11,5,16,2022,01-17,23:03
022 Clemenceau,7,5,12,2022,01-17,23:03
023 Les Arceaux,0,16,16,2022,01-17,23:03
024 Cit� Mion,3,5,8,2022,01-17,23:03
025 Nouveau Saint-Roch,4,4,8,2022,01-17,23:03
026 Renouvier,1,7,8,2022,01-17,23:03
027 Odysseum,5,3,8,2022,01-17,23:03
028 Saint-Denis,7,1,8,2022,01-17,23:03
029 Richter,7,9,16,2022,01-17,23:03
030 Charles Flahault,7,1,8,2022,01-17,23:03
031 Voltaire,5,3,8,2022,01-17,23:03
032 Pr�s d'Ar�nes,7,1,8,2022,01-17,23:03
033 Garcia Lorca,8,0,8,2022,01-17,23:03
034 Vert Bois,0,16,16,2022,01-17,23:03
035 Malbosc,1,7,8,2022,01-17,23:03
036 Occitanie,1,31,32,2022,01-17,23:03
037 FacdesSciences,1,23,24,2022,01-17,23:03
038 Fac de Lettres,5,11,16,2022,01-17,23:03
039 Aiguelongue,8,0,8,2022,01-17,23:03
040 Jeu de Mail des Abb�s,8,0,8,2022,01-17,23:03
041 Eurom�decine,1,7,8,2022,01-17,23:03
042 Marie Caizergues,3,5,8,2022,01-17,23:03
043 Sabines,0,8,8,2022,01-17,23:03
044 Celleneuve,1,7,8,2022,01-17,23:03
045 Jardin de la Lironde,8,0,8,2022,01-17,23:03
046 P�re Soulas,3,5,8,2022,01-17,23:03
047 Place Viala,1,7,8,2022,01-17,23:03
048 H�tel du D�partement,0,8,8,2022,01-17,23:03
049 Tonnelles,3,5,8,2022,01-17,23:03
050 Parvis Jules Ferry - Gare Saint-Roch,6,2,8,2022,01-17,23:03
051 Pont de Lattes - Gare Saint-Roch,1,11,12,2022,01-17,23:03
053 Deux Ponts - Gare Saint-Roch,3,5,8,2022,01-17,23:03
054 Providence - Ovalie,3,5,8,2022,01-17,23:03
055 P�rols Etang de l'Or,24,44,68,2022,01-17,23:03
056 Albert 1er - Cath�drale,0,12,12,2022,01-17,23:03
057 Saint-Guilhem - Courreau,3,5,8,2022,01-17,23:03
059 Sud De France,1,7,8,2022,01-17,23:03
001 Rue Jules Ferry - Gare Saint-Roch,7,5,12,2022,01-17,23:13
002 Com�die,3,21,24,2022,01-17,23:13
003 Esplanade,5,27,32,2022,01-17,23:13
004 H�tel de Ville,14,2,16,2022,01-17,23:13
005 Corum,5,7,12,2022,01-17,23:13
006 Place Albert 1er - St Charles,10,21,31,2022,01-17,23:13
007 Foch,1,7,8,2022,01-17,23:13
008 Halles Castellane,0,12,12,2022,01-17,23:13
009 Observatoire,2,6,8,2022,01-17,23:13
010 Rondelet,5,11,16,2022,01-17,23:13
011 Plan Cabanes,7,5,12,2022,01-17,23:13
012 Boutonnet,3,9,12,2022,01-17,23:13
013 Emile Combes,8,0,8,2022,01-17,23:13
014 Beaux-Arts,8,0,8,2022,01-17,23:13
015 Les Aubes,6,1,8,2022,01-17,23:13
016 Antigone centre,13,3,16,2022,01-17,23:13
017 M�diath�que Emile Zola,10,6,16,2022,01-17,23:13
018 Nombre d'Or,14,2,16,2022,01-17,23:13
019 Louis Blanc,11,5,16,2022,01-17,23:13
020 Gambetta,4,4,8,2022,01-17,23:13
021 Port Marianne,11,5,16,2022,01-17,23:13
022 Clemenceau,7,5,12,2022,01-17,23:13
023 Les Arceaux,0,16,16,2022,01-17,23:13
024 Cit� Mion,3,5,8,2022,01-17,23:13
025 Nouveau Saint-Roch,4,4,8,2022,01-17,23:13
026 Renouvier,1,7,8,2022,01-17,23:13
027 Odysseum,4,4,8,2022,01-17,23:13
028 Saint-Denis,7,1,8,2022,01-17,23:13
029 Richter,8,8,16,2022,01-17,23:13
030 Charles Flahault,7,1,8,2022,01-17,23:13
031 Voltaire,5,3,8,2022,01-17,23:13
032 Pr�s d'Ar�nes,7,1,8,2022,01-17,23:13
033 Garcia Lorca,8,0,8,2022,01-17,23:13
034 Vert Bois,0,16,16,2022,01-17,23:13
035 Malbosc,1,7,8,2022,01-17,23:13
036 Occitanie,1,31,32,2022,01-17,23:13
037 FacdesSciences,5,19,24,2022,01-17,23:13
038 Fac de Lettres,5,11,16,2022,01-17,23:13
039 Aiguelongue,8,0,8,2022,01-17,23:13
040 Jeu de Mail des Abb�s,8,0,8,2022,01-17,23:13
041 Eurom�decine,1,7,8,2022,01-17,23:13
042 Marie Caizergues,3,5,8,2022,01-17,23:13
043 Sabines,0,8,8,2022,01-17,23:13
044 Celleneuve,1,7,8,2022,01-17,23:13
045 Jardin de la Lironde,8,0,8,2022,01-17,23:13
046 P�re Soulas,3,5,8,2022,01-17,23:13
047 Place Viala,1,7,8,2022,01-17,23:13
048 H�tel du D�partement,0,8,8,2022,01-17,23:13
049 Tonnelles,3,5,8,2022,01-17,23:13
050 Parvis Jules Ferry - Gare Saint-Roch,6,2,8,2022,01-17,23:13
051 Pont de Lattes - Gare Saint-Roch,1,11,12,2022,01-17,23:13
053 Deux Ponts - Gare Saint-Roch,3,5,8,2022,01-17,23:13
054 Providence - Ovalie,3,5,8,2022,01-17,23:13
055 P�rols Etang de l'Or,24,44,68,2022,01-17,23:13
056 Albert 1er - Cath�drale,0,12,12,2022,01-17,23:13
057 Saint-Guilhem - Courreau,3,5,8,2022,01-17,23:13
059 Sud De France,1,7,8,2022,01-17,23:13
001 Rue Jules Ferry - Gare Saint-Roch,7,5,12,2022,01-17,23:23
002 Com�die,3,21,24,2022,01-17,23:23
003 Esplanade,5,27,32,2022,01-17,23:23
004 H�tel de Ville,14,2,16,2022,01-17,23:23
005 Corum,5,7,12,2022,01-17,23:23
006 Place Albert 1er - St Charles,10,21,31,2022,01-17,23:23
007 Foch,1,7,8,2022,01-17,23:23
008 Halles Castellane,0,12,12,2022,01-17,23:23
009 Observatoire,2,6,8,2022,01-17,23:23
010 Rondelet,5,11,16,2022,01-17,23:23
011 Plan Cabanes,7,5,12,2022,01-17,23:23
012 Boutonnet,6,6,12,2022,01-17,23:23
013 Emile Combes,8,0,8,2022,01-17,23:23
014 Beaux-Arts,8,0,8,2022,01-17,23:23
015 Les Aubes,6,1,8,2022,01-17,23:23
016 Antigone centre,13,3,16,2022,01-17,23:23
017 M�diath�que Emile Zola,10,6,16,2022,01-17,23:23
018 Nombre d'Or,14,2,16,2022,01-17,23:23
019 Louis Blanc,9,7,16,2022,01-17,23:23
020 Gambetta,4,4,8,2022,01-17,23:23
021 Port Marianne,11,5,16,2022,01-17,23:23
022 Clemenceau,7,5,12,2022,01-17,23:23
023 Les Arceaux,0,16,16,2022,01-17,23:23
024 Cit� Mion,4,4,8,2022,01-17,23:23
025 Nouveau Saint-Roch,4,4,8,2022,01-17,23:23
026 Renouvier,1,7,8,2022,01-17,23:23
027 Odysseum,4,4,8,2022,01-17,23:23
028 Saint-Denis,7,1,8,2022,01-17,23:23
029 Richter,8,8,16,2022,01-17,23:23
030 Charles Flahault,7,1,8,2022,01-17,23:23
031 Voltaire,5,3,8,2022,01-17,23:23
032 Pr�s d'Ar�nes,7,1,8,2022,01-17,23:23
033 Garcia Lorca,7,1,8,2022,01-17,23:23
034 Vert Bois,0,16,16,2022,01-17,23:23
035 Malbosc,1,7,8,2022,01-17,23:23
036 Occitanie,1,31,32,2022,01-17,23:23
037 FacdesSciences,5,19,24,2022,01-17,23:23
038 Fac de Lettres,5,11,16,2022,01-17,23:23
039 Aiguelongue,8,0,8,2022,01-17,23:23
040 Jeu de Mail des Abb�s,8,0,8,2022,01-17,23:23
041 Eurom�decine,1,7,8,2022,01-17,23:23
042 Marie Caizergues,3,5,8,2022,01-17,23:23
043 Sabines,0,8,8,2022,01-17,23:23
044 Celleneuve,1,7,8,2022,01-17,23:23
045 Jardin de la Lironde,8,0,8,2022,01-17,23:23
046 P�re Soulas,3,5,8,2022,01-17,23:23
047 Place Viala,1,7,8,2022,01-17,23:23
048 H�tel du D�partement,0,8,8,2022,01-17,23:23
049 Tonnelles,3,5,8,2022,01-17,23:23
050 Parvis Jules Ferry - Gare Saint-Roch,6,2,8,2022,01-17,23:23
051 Pont de Lattes - Gare Saint-Roch,1,11,12,2022,01-17,23:23
053 Deux Ponts - Gare Saint-Roch,3,5,8,2022,01-17,23:23
054 Providence - Ovalie,3,5,8,2022,01-17,23:23
055 P�rols Etang de l'Or,24,44,68,2022,01-17,23:23
056 Albert 1er - Cath�drale,0,12,12,2022,01-17,23:23
057 Saint-Guilhem - Courreau,3,5,8,2022,01-17,23:23
059 Sud De France,1,7,8,2022,01-17,23:23
001 Rue Jules Ferry - Gare Saint-Roch,7,5,12,2022,01-17,23:33
002 Com�die,3,21,24,2022,01-17,23:33
003 Esplanade,5,27,32,2022,01-17,23:33
004 H�tel de Ville,14,2,16,2022,01-17,23:33
005 Corum,5,7,12,2022,01-17,23:33
006 Place Albert 1er - St Charles,10,21,31,2022,01-17,23:33
007 Foch,1,7,8,2022,01-17,23:33
008 Halles Castellane,0,12,12,2022,01-17,23:33
009 Observatoire,2,6,8,2022,01-17,23:33
010 Rondelet,5,11,16,2022,01-17,23:33
011 Plan Cabanes,8,4,12,2022,01-17,23:33
012 Boutonnet,6,6,12,2022,01-17,23:33
013 Emile Combes,8,0,8,2022,01-17,23:33
014 Beaux-Arts,8,0,8,2022,01-17,23:33
015 Les Aubes,6,1,8,2022,01-17,23:33
016 Antigone centre,13,3,16,2022,01-17,23:33
017 M�diath�que Emile Zola,10,6,16,2022,01-17,23:33
018 Nombre d'Or,14,2,16,2022,01-17,23:33
019 Louis Blanc,9,7,16,2022,01-17,23:33
020 Gambetta,4,4,8,2022,01-17,23:33
021 Port Marianne,11,5,16,2022,01-17,23:33
022 Clemenceau,3,9,12,2022,01-17,23:33
023 Les Arceaux,0,16,16,2022,01-17,23:33
024 Cit� Mion,4,4,8,2022,01-17,23:33
025 Nouveau Saint-Roch,4,4,8,2022,01-17,23:33
026 Renouvier,1,7,8,2022,01-17,23:33
027 Odysseum,4,4,8,2022,01-17,23:33
028 Saint-Denis,7,1,8,2022,01-17,23:33
029 Richter,8,8,16,2022,01-17,23:33
030 Charles Flahault,7,1,8,2022,01-17,23:33
031 Voltaire,5,3,8,2022,01-17,23:33
032 Pr�s d'Ar�nes,7,1,8,2022,01-17,23:33
033 Garcia Lorca,7,1,8,2022,01-17,23:33
034 Vert Bois,0,16,16,2022,01-17,23:33
035 Malbosc,1,7,8,2022,01-17,23:33
036 Occitanie,1,31,32,2022,01-17,23:33
037 FacdesSciences,7,17,24,2022,01-17,23:33
038 Fac de Lettres,5,11,16,2022,01-17,23:33
039 Aiguelongue,8,0,8,2022,01-17,23:33
040 Jeu de Mail des Abb�s,8,0,8,2022,01-17,23:33
041 Eurom�decine,1,7,8,2022,01-17,23:33
042 Marie Caizergues,3,5,8,2022,01-17,23:33
043 Sabines,0,8,8,2022,01-17,23:33
044 Celleneuve,1,7,8,2022,01-17,23:33
045 Jardin de la Lironde,8,0,8,2022,01-17,23:33
046 P�re Soulas,4,4,8,2022,01-17,23:33
047 Place Viala,2,6,8,2022,01-17,23:33
048 H�tel du D�partement,0,8,8,2022,01-17,23:33
049 Tonnelles,2,6,8,2022,01-17,23:33
050 Parvis Jules Ferry - Gare Saint-Roch,6,2,8,2022,01-17,23:33
051 Pont de Lattes - Gare Saint-Roch,1,11,12,2022,01-17,23:33
053 Deux Ponts - Gare Saint-Roch,3,5,8,2022,01-17,23:33
054 Providence - Ovalie,3,5,8,2022,01-17,23:33
055 P�rols Etang de l'Or,24,44,68,2022,01-17,23:33
056 Albert 1er - Cath�drale,0,12,12,2022,01-17,23:33
057 Saint-Guilhem - Courreau,6,2,8,2022,01-17,23:33
059 Sud De France,1,7,8,2022,01-17,23:33
001 Rue Jules Ferry - Gare Saint-Roch,7,5,12,2022,01-17,23:44
002 Com�die,3,21,24,2022,01-17,23:44
003 Esplanade,5,27,32,2022,01-17,23:44
004 H�tel de Ville,14,2,16,2022,01-17,23:44
005 Corum,5,7,12,2022,01-17,23:44
006 Place Albert 1er - St Charles,10,21,31,2022,01-17,23:44
007 Foch,1,7,8,2022,01-17,23:44
008 Halles Castellane,0,12,12,2022,01-17,23:44
009 Observatoire,2,6,8,2022,01-17,23:44
010 Rondelet,5,11,16,2022,01-17,23:44
011 Plan Cabanes,7,5,12,2022,01-17,23:44
012 Boutonnet,6,6,12,2022,01-17,23:44
013 Emile Combes,8,0,8,2022,01-17,23:44
014 Beaux-Arts,8,0,8,2022,01-17,23:44
015 Les Aubes,6,1,8,2022,01-17,23:44
016 Antigone centre,13,3,16,2022,01-17,23:44
017 M�diath�que Emile Zola,10,6,16,2022,01-17,23:44
018 Nombre d'Or,14,2,16,2022,01-17,23:44
019 Louis Blanc,9,7,16,2022,01-17,23:44
020 Gambetta,4,4,8,2022,01-17,23:44
021 Port Marianne,11,5,16,2022,01-17,23:44
022 Clemenceau,3,9,12,2022,01-17,23:44
023 Les Arceaux,0,16,16,2022,01-17,23:44
024 Cit� Mion,4,4,8,2022,01-17,23:44
025 Nouveau Saint-Roch,4,4,8,2022,01-17,23:44
026 Renouvier,1,7,8,2022,01-17,23:44
027 Odysseum,4,4,8,2022,01-17,23:44
028 Saint-Denis,7,1,8,2022,01-17,23:44
029 Richter,8,8,16,2022,01-17,23:44
030 Charles Flahault,7,1,8,2022,01-17,23:44
031 Voltaire,5,3,8,2022,01-17,23:44
032 Pr�s d'Ar�nes,7,1,8,2022,01-17,23:44
033 Garcia Lorca,7,1,8,2022,01-17,23:44
034 Vert Bois,0,16,16,2022,01-17,23:44
035 Malbosc,1,7,8,2022,01-17,23:44
036 Occitanie,1,31,32,2022,01-17,23:44
037 FacdesSciences,8,16,24,2022,01-17,23:44
038 Fac de Lettres,5,11,16,2022,01-17,23:44
039 Aiguelongue,8,0,8,2022,01-17,23:44
040 Jeu de Mail des Abb�s,8,0,8,2022,01-17,23:44
041 Eurom�decine,1,7,8,2022,01-17,23:44
042 Marie Caizergues,3,5,8,2022,01-17,23:44
043 Sabines,0,8,8,2022,01-17,23:44
044 Celleneuve,1,7,8,2022,01-17,23:44
045 Jardin de la Lironde,8,0,8,2022,01-17,23:44
046 P�re Soulas,4,4,8,2022,01-17,23:44
047 Place Viala,2,6,8,2022,01-17,23:44
048 H�tel du D�partement,0,8,8,2022,01-17,23:44
049 Tonnelles,2,6,8,2022,01-17,23:44
050 Parvis Jules Ferry - Gare Saint-Roch,6,2,8,2022,01-17,23:44
051 Pont de Lattes - Gare Saint-Roch,1,11,12,2022,01-17,23:44
053 Deux Ponts - Gare Saint-Roch,3,5,8,2022,01-17,23:44
054 Providence - Ovalie,3,5,8,2022,01-17,23:44
055 P�rols Etang de l'Or,24,44,68,2022,01-17,23:44
056 Albert 1er - Cath�drale,0,12,12,2022,01-17,23:44
057 Saint-Guilhem - Courreau,6,2,8,2022,01-17,23:44
059 Sud De France,1,7,8,2022,01-17,23:44
001 Rue Jules Ferry - Gare Saint-Roch,7,5,12,2022,01-17,23:54
002 Com�die,3,21,24,2022,01-17,23:54
003 Esplanade,5,27,32,2022,01-17,23:54
004 H�tel de Ville,14,2,16,2022,01-17,23:54
005 Corum,5,7,12,2022,01-17,23:54
006 Place Albert 1er - St Charles,10,21,31,2022,01-17,23:54
007 Foch,1,7,8,2022,01-17,23:54
008 Halles Castellane,0,12,12,2022,01-17,23:54
009 Observatoire,2,6,8,2022,01-17,23:54
010 Rondelet,5,11,16,2022,01-17,23:54
011 Plan Cabanes,8,4,12,2022,01-17,23:54
012 Boutonnet,6,6,12,2022,01-17,23:54
013 Emile Combes,8,0,8,2022,01-17,23:54
014 Beaux-Arts,8,0,8,2022,01-17,23:54
015 Les Aubes,6,1,8,2022,01-17,23:54
016 Antigone centre,13,3,16,2022,01-17,23:54
017 M�diath�que Emile Zola,13,3,16,2022,01-17,23:54
018 Nombre d'Or,14,2,16,2022,01-17,23:54
019 Louis Blanc,9,7,16,2022,01-17,23:54
020 Gambetta,4,4,8,2022,01-17,23:54
021 Port Marianne,11,5,16,2022,01-17,23:54
022 Clemenceau,3,9,12,2022,01-17,23:54
023 Les Arceaux,0,16,16,2022,01-17,23:54
024 Cit� Mion,4,4,8,2022,01-17,23:54
025 Nouveau Saint-Roch,4,4,8,2022,01-17,23:54
026 Renouvier,0,8,8,2022,01-17,23:54
027 Odysseum,4,4,8,2022,01-17,23:54
028 Saint-Denis,6,2,8,2022,01-17,23:54
029 Richter,8,8,16,2022,01-17,23:54
030 Charles Flahault,7,1,8,2022,01-17,23:54
031 Voltaire,1,7,8,2022,01-17,23:54
032 Pr�s d'Ar�nes,7,1,8,2022,01-17,23:54
033 Garcia Lorca,7,1,8,2022,01-17,23:54
034 Vert Bois,0,16,16,2022,01-17,23:54
035 Malbosc,1,7,8,2022,01-17,23:54
036 Occitanie,1,31,32,2022,01-17,23:54
037 FacdesSciences,8,16,24,2022,01-17,23:54
038 Fac de Lettres,5,11,16,2022,01-17,23:54
039 Aiguelongue,8,0,8,2022,01-17,23:54
040 Jeu de Mail des Abb�s,8,0,8,2022,01-17,23:54
041 Eurom�decine,1,7,8,2022,01-17,23:54
042 Marie Caizergues,3,5,8,2022,01-17,23:54
043 Sabines,0,8,8,2022,01-17,23:54
044 Celleneuve,1,7,8,2022,01-17,23:54
045 Jardin de la Lironde,8,0,8,2022,01-17,23:54
046 P�re Soulas,4,4,8,2022,01-17,23:54
047 Place Viala,2,6,8,2022,01-17,23:54
048 H�tel du D�partement,0,8,8,2022,01-17,23:54
049 Tonnelles,2,6,8,2022,01-17,23:54
050 Parvis Jules Ferry - Gare Saint-Roch,6,2,8,2022,01-17,23:54
051 Pont de Lattes - Gare Saint-Roch,1,11,12,2022,01-17,23:54
053 Deux Ponts - Gare Saint-Roch,3,5,8,2022,01-17,23:54
054 Providence - Ovalie,3,5,8,2022,01-17,23:54
055 P�rols Etang de l'Or,24,44,68,2022,01-17,23:54
056 Albert 1er - Cath�drale,0,12,12,2022,01-17,23:54
057 Saint-Guilhem - Courreau,6,2,8,2022,01-17,23:54
059 Sud De France,1,7,8,2022,01-17,23:54
001 Rue Jules Ferry - Gare Saint-Roch,7,5,12,2022,01-18,00:04
002 Com�die,3,21,24,2022,01-18,00:04
003 Esplanade,5,27,32,2022,01-18,00:04
004 H�tel de Ville,14,2,16,2022,01-18,00:04
005 Corum,5,7,12,2022,01-18,00:04
006 Place Albert 1er - St Charles,10,21,31,2022,01-18,00:04
007 Foch,1,7,8,2022,01-18,00:04
008 Halles Castellane,0,12,12,2022,01-18,00:04
009 Observatoire,2,6,8,2022,01-18,00:04
010 Rondelet,5,11,16,2022,01-18,00:04
011 Plan Cabanes,8,4,12,2022,01-18,00:04
012 Boutonnet,6,6,12,2022,01-18,00:04
013 Emile Combes,8,0,8,2022,01-18,00:04
014 Beaux-Arts,8,0,8,2022,01-18,00:04
015 Les Aubes,6,1,8,2022,01-18,00:04
016 Antigone centre,13,3,16,2022,01-18,00:04
017 M�diath�que Emile Zola,13,3,16,2022,01-18,00:04
018 Nombre d'Or,14,2,16,2022,01-18,00:04
019 Louis Blanc,9,7,16,2022,01-18,00:04
020 Gambetta,4,4,8,2022,01-18,00:04
021 Port Marianne,11,5,16,2022,01-18,00:04
022 Clemenceau,3,9,12,2022,01-18,00:04
023 Les Arceaux,0,16,16,2022,01-18,00:04
024 Cit� Mion,4,4,8,2022,01-18,00:04
025 Nouveau Saint-Roch,4,4,8,2022,01-18,00:04
026 Renouvier,0,8,8,2022,01-18,00:04
027 Odysseum,4,4,8,2022,01-18,00:04
028 Saint-Denis,6,2,8,2022,01-18,00:04
029 Richter,8,8,16,2022,01-18,00:04
030 Charles Flahault,7,1,8,2022,01-18,00:04
031 Voltaire,2,6,8,2022,01-18,00:04
032 Pr�s d'Ar�nes,7,1,8,2022,01-18,00:04
033 Garcia Lorca,7,1,8,2022,01-18,00:04
034 Vert Bois,0,16,16,2022,01-18,00:04
035 Malbosc,1,7,8,2022,01-18,00:04
036 Occitanie,1,31,32,2022,01-18,00:04
037 FacdesSciences,8,16,24,2022,01-18,00:04
038 Fac de Lettres,6,10,16,2022,01-18,00:04
039 Aiguelongue,8,0,8,2022,01-18,00:04
040 Jeu de Mail des Abb�s,8,0,8,2022,01-18,00:04
041 Eurom�decine,1,7,8,2022,01-18,00:04
042 Marie Caizergues,3,5,8,2022,01-18,00:04
043 Sabines,0,8,8,2022,01-18,00:04
044 Celleneuve,1,7,8,2022,01-18,00:04
045 Jardin de la Lironde,8,0,8,2022,01-18,00:04
046 P�re Soulas,4,4,8,2022,01-18,00:04
047 Place Viala,2,6,8,2022,01-18,00:04
048 H�tel du D�partement,0,8,8,2022,01-18,00:04
049 Tonnelles,2,6,8,2022,01-18,00:04
050 Parvis Jules Ferry - Gare Saint-Roch,6,2,8,2022,01-18,00:04
051 Pont de Lattes - Gare Saint-Roch,1,11,12,2022,01-18,00:04
053 Deux Ponts - Gare Saint-Roch,3,5,8,2022,01-18,00:04
054 Providence - Ovalie,3,5,8,2022,01-18,00:04
055 P�rols Etang de l'Or,24,44,68,2022,01-18,00:04
056 Albert 1er - Cath�drale,0,12,12,2022,01-18,00:04
057 Saint-Guilhem - Courreau,6,2,8,2022,01-18,00:04
059 Sud De France,1,7,8,2022,01-18,00:04
001 Rue Jules Ferry - Gare Saint-Roch,7,5,12,2022,01-18,00:14
002 Com�die,3,21,24,2022,01-18,00:14
003 Esplanade,5,27,32,2022,01-18,00:14
004 H�tel de Ville,14,2,16,2022,01-18,00:14
005 Corum,4,8,12,2022,01-18,00:14
006 Place Albert 1er - St Charles,10,21,31,2022,01-18,00:14
007 Foch,1,7,8,2022,01-18,00:14
008 Halles Castellane,0,12,12,2022,01-18,00:14
009 Observatoire,1,7,8,2022,01-18,00:14
010 Rondelet,5,11,16,2022,01-18,00:14
011 Plan Cabanes,8,4,12,2022,01-18,00:14
012 Boutonnet,6,6,12,2022,01-18,00:14
013 Emile Combes,8,0,8,2022,01-18,00:14
014 Beaux-Arts,8,0,8,2022,01-18,00:14
015 Les Aubes,6,1,8,2022,01-18,00:14
016 Antigone centre,14,2,16,2022,01-18,00:14
017 M�diath�que Emile Zola,13,3,16,2022,01-18,00:14
018 Nombre d'Or,14,2,16,2022,01-18,00:14
019 Louis Blanc,9,7,16,2022,01-18,00:14
020 Gambetta,4,4,8,2022,01-18,00:14
021 Port Marianne,11,5,16,2022,01-18,00:14
022 Clemenceau,3,9,12,2022,01-18,00:14
023 Les Arceaux,0,16,16,2022,01-18,00:14
024 Cit� Mion,4,4,8,2022,01-18,00:14
025 Nouveau Saint-Roch,4,4,8,2022,01-18,00:14
026 Renouvier,0,8,8,2022,01-18,00:14
027 Odysseum,4,4,8,2022,01-18,00:14
028 Saint-Denis,6,2,8,2022,01-18,00:14
029 Richter,8,8,16,2022,01-18,00:14
030 Charles Flahault,7,1,8,2022,01-18,00:14
031 Voltaire,2,6,8,2022,01-18,00:14
032 Pr�s d'Ar�nes,7,1,8,2022,01-18,00:14
033 Garcia Lorca,7,1,8,2022,01-18,00:14
034 Vert Bois,0,16,16,2022,01-18,00:14
035 Malbosc,1,7,8,2022,01-18,00:14
036 Occitanie,1,31,32,2022,01-18,00:14
037 FacdesSciences,7,17,24,2022,01-18,00:14
038 Fac de Lettres,6,10,16,2022,01-18,00:14
039 Aiguelongue,8,0,8,2022,01-18,00:14
040 Jeu de Mail des Abb�s,8,0,8,2022,01-18,00:14
041 Eurom�decine,1,7,8,2022,01-18,00:14
042 Marie Caizergues,3,5,8,2022,01-18,00:14
043 Sabines,0,8,8,2022,01-18,00:14
044 Celleneuve,1,7,8,2022,01-18,00:14
045 Jardin de la Lironde,8,0,8,2022,01-18,00:14
046 P�re Soulas,4,4,8,2022,01-18,00:14
047 Place Viala,2,6,8,2022,01-18,00:14
048 H�tel du D�partement,0,8,8,2022,01-18,00:14
049 Tonnelles,2,6,8,2022,01-18,00:14
050 Parvis Jules Ferry - Gare Saint-Roch,6,2,8,2022,01-18,00:14
051 Pont de Lattes - Gare Saint-Roch,1,11,12,2022,01-18,00:14
053 Deux Ponts - Gare Saint-Roch,3,5,8,2022,01-18,00:14
054 Providence - Ovalie,3,5,8,2022,01-18,00:14
055 P�rols Etang de l'Or,24,44,68,2022,01-18,00:14
056 Albert 1er - Cath�drale,0,12,12,2022,01-18,00:14
057 Saint-Guilhem - Courreau,6,2,8,2022,01-18,00:14
059 Sud De France,1,7,8,2022,01-18,00:14
001 Rue Jules Ferry - Gare Saint-Roch,7,5,12,2022,01-18,00:24
002 Com�die,3,21,24,2022,01-18,00:24
003 Esplanade,5,27,32,2022,01-18,00:24
004 H�tel de Ville,13,3,16,2022,01-18,00:24
005 Corum,4,8,12,2022,01-18,00:24
006 Place Albert 1er - St Charles,10,21,31,2022,01-18,00:24
007 Foch,1,7,8,2022,01-18,00:24
008 Halles Castellane,0,12,12,2022,01-18,00:24
009 Observatoire,3,5,8,2022,01-18,00:24
010 Rondelet,5,11,16,2022,01-18,00:24
011 Plan Cabanes,8,4,12,2022,01-18,00:24
012 Boutonnet,6,6,12,2022,01-18,00:24
013 Emile Combes,8,0,8,2022,01-18,00:24
014 Beaux-Arts,8,0,8,2022,01-18,00:24
015 Les Aubes,6,1,8,2022,01-18,00:24
016 Antigone centre,14,2,16,2022,01-18,00:24
017 M�diath�que Emile Zola,13,3,16,2022,01-18,00:24
018 Nombre d'Or,14,2,16,2022,01-18,00:24
019 Louis Blanc,9,7,16,2022,01-18,00:24
020 Gambetta,4,4,8,2022,01-18,00:24
021 Port Marianne,11,5,16,2022,01-18,00:24
022 Clemenceau,3,9,12,2022,01-18,00:24
023 Les Arceaux,1,15,16,2022,01-18,00:24
024 Cit� Mion,4,4,8,2022,01-18,00:24
025 Nouveau Saint-Roch,4,4,8,2022,01-18,00:24
026 Renouvier,0,8,8,2022,01-18,00:24
027 Odysseum,4,4,8,2022,01-18,00:24
028 Saint-Denis,6,2,8,2022,01-18,00:24
029 Richter,8,8,16,2022,01-18,00:24
030 Charles Flahault,7,1,8,2022,01-18,00:24
031 Voltaire,0,8,8,2022,01-18,00:24
032 Pr�s d'Ar�nes,7,1,8,2022,01-18,00:24
033 Garcia Lorca,7,1,8,2022,01-18,00:24
034 Vert Bois,0,16,16,2022,01-18,00:24
035 Malbosc,1,7,8,2022,01-18,00:24
036 Occitanie,1,31,32,2022,01-18,00:24
037 FacdesSciences,7,17,24,2022,01-18,00:24
038 Fac de Lettres,6,10,16,2022,01-18,00:24
039 Aiguelongue,8,0,8,2022,01-18,00:24
040 Jeu de Mail des Abb�s,8,0,8,2022,01-18,00:24
041 Eurom�decine,1,7,8,2022,01-18,00:24
042 Marie Caizergues,3,5,8,2022,01-18,00:24
043 Sabines,0,8,8,2022,01-18,00:24
044 Celleneuve,1,7,8,2022,01-18,00:24
045 Jardin de la Lironde,8,0,8,2022,01-18,00:24
046 P�re Soulas,4,4,8,2022,01-18,00:24
047 Place Viala,2,6,8,2022,01-18,00:24
048 H�tel du D�partement,0,8,8,2022,01-18,00:24
049 Tonnelles,2,6,8,2022,01-18,00:24
050 Parvis Jules Ferry - Gare Saint-Roch,6,2,8,2022,01-18,00:24
051 Pont de Lattes - Gare Saint-Roch,1,11,12,2022,01-18,00:24
053 Deux Ponts - Gare Saint-Roch,3,5,8,2022,01-18,00:24
054 Providence - Ovalie,3,5,8,2022,01-18,00:24
055 P�rols Etang de l'Or,24,44,68,2022,01-18,00:24
056 Albert 1er - Cath�drale,0,12,12,2022,01-18,00:24
057 Saint-Guilhem - Courreau,6,2,8,2022,01-18,00:24
059 Sud De France,1,7,8,2022,01-18,00:24
001 Rue Jules Ferry - Gare Saint-Roch,7,5,12,2022,01-18,00:34
002 Com�die,3,21,24,2022,01-18,00:34
003 Esplanade,5,27,32,2022,01-18,00:34
004 H�tel de Ville,13,3,16,2022,01-18,00:34
005 Corum,4,8,12,2022,01-18,00:34
006 Place Albert 1er - St Charles,10,21,31,2022,01-18,00:34
007 Foch,1,7,8,2022,01-18,00:34
008 Halles Castellane,0,12,12,2022,01-18,00:34
009 Observatoire,3,5,8,2022,01-18,00:34
010 Rondelet,5,11,16,2022,01-18,00:34
011 Plan Cabanes,8,4,12,2022,01-18,00:34
012 Boutonnet,6,6,12,2022,01-18,00:34
013 Emile Combes,8,0,8,2022,01-18,00:34
014 Beaux-Arts,8,0,8,2022,01-18,00:34
015 Les Aubes,6,1,8,2022,01-18,00:34
016 Antigone centre,14,2,16,2022,01-18,00:34
017 M�diath�que Emile Zola,13,3,16,2022,01-18,00:34
018 Nombre d'Or,14,2,16,2022,01-18,00:34
019 Louis Blanc,9,7,16,2022,01-18,00:34
020 Gambetta,4,4,8,2022,01-18,00:34
021 Port Marianne,11,5,16,2022,01-18,00:34
022 Clemenceau,3,9,12,2022,01-18,00:34
023 Les Arceaux,1,15,16,2022,01-18,00:34
024 Cit� Mion,4,4,8,2022,01-18,00:34
025 Nouveau Saint-Roch,4,4,8,2022,01-18,00:34
026 Renouvier,0,8,8,2022,01-18,00:34
027 Odysseum,4,4,8,2022,01-18,00:34
028 Saint-Denis,6,2,8,2022,01-18,00:34
029 Richter,8,8,16,2022,01-18,00:34
030 Charles Flahault,6,2,8,2022,01-18,00:34
031 Voltaire,0,8,8,2022,01-18,00:34
032 Pr�s d'Ar�nes,7,1,8,2022,01-18,00:34
033 Garcia Lorca,7,1,8,2022,01-18,00:34
034 Vert Bois,0,16,16,2022,01-18,00:34
035 Malbosc,1,7,8,2022,01-18,00:34
036 Occitanie,1,31,32,2022,01-18,00:34
037 FacdesSciences,7,17,24,2022,01-18,00:34
038 Fac de Lettres,6,10,16,2022,01-18,00:34
039 Aiguelongue,8,0,8,2022,01-18,00:34
040 Jeu de Mail des Abb�s,8,0,8,2022,01-18,00:34
041 Eurom�decine,1,7,8,2022,01-18,00:34
042 Marie Caizergues,3,5,8,2022,01-18,00:34
043 Sabines,0,8,8,2022,01-18,00:34
044 Celleneuve,1,7,8,2022,01-18,00:34
045 Jardin de la Lironde,8,0,8,2022,01-18,00:34
046 P�re Soulas,4,4,8,2022,01-18,00:34
047 Place Viala,2,6,8,2022,01-18,00:34
048 H�tel du D�partement,0,8,8,2022,01-18,00:34
049 Tonnelles,2,6,8,2022,01-18,00:34
050 Parvis Jules Ferry - Gare Saint-Roch,6,2,8,2022,01-18,00:34
051 Pont de Lattes - Gare Saint-Roch,1,11,12,2022,01-18,00:34
053 Deux Ponts - Gare Saint-Roch,3,5,8,2022,01-18,00:34
054 Providence - Ovalie,3,5,8,2022,01-18,00:34
055 P�rols Etang de l'Or,24,44,68,2022,01-18,00:34
056 Albert 1er - Cath�drale,0,12,12,2022,01-18,00:34
057 Saint-Guilhem - Courreau,6,2,8,2022,01-18,00:34
059 Sud De France,1,7,8,2022,01-18,00:34
001 Rue Jules Ferry - Gare Saint-Roch,7,5,12,2022,01-18,00:44
002 Com�die,3,21,24,2022,01-18,00:44
003 Esplanade,5,27,32,2022,01-18,00:44
004 H�tel de Ville,14,2,16,2022,01-18,00:44
005 Corum,4,8,12,2022,01-18,00:44
006 Place Albert 1er - St Charles,10,21,31,2022,01-18,00:44
007 Foch,1,7,8,2022,01-18,00:44
008 Halles Castellane,0,12,12,2022,01-18,00:44
009 Observatoire,3,5,8,2022,01-18,00:44
010 Rondelet,5,11,16,2022,01-18,00:44
011 Plan Cabanes,8,4,12,2022,01-18,00:44
012 Boutonnet,6,6,12,2022,01-18,00:44
013 Emile Combes,8,0,8,2022,01-18,00:44
014 Beaux-Arts,8,0,8,2022,01-18,00:44
015 Les Aubes,6,1,8,2022,01-18,00:44
016 Antigone centre,14,2,16,2022,01-18,00:44
017 M�diath�que Emile Zola,13,3,16,2022,01-18,00:44
018 Nombre d'Or,14,2,16,2022,01-18,00:44
019 Louis Blanc,10,6,16,2022,01-18,00:44
020 Gambetta,4,4,8,2022,01-18,00:44
021 Port Marianne,11,5,16,2022,01-18,00:44
022 Clemenceau,3,9,12,2022,01-18,00:44
023 Les Arceaux,1,15,16,2022,01-18,00:44
024 Cit� Mion,4,4,8,2022,01-18,00:44
025 Nouveau Saint-Roch,4,4,8,2022,01-18,00:44
026 Renouvier,0,8,8,2022,01-18,00:44
027 Odysseum,4,4,8,2022,01-18,00:44
028 Saint-Denis,6,2,8,2022,01-18,00:44
029 Richter,8,8,16,2022,01-18,00:44
030 Charles Flahault,6,2,8,2022,01-18,00:44
031 Voltaire,0,8,8,2022,01-18,00:44
032 Pr�s d'Ar�nes,7,1,8,2022,01-18,00:44
033 Garcia Lorca,7,1,8,2022,01-18,00:44
034 Vert Bois,0,16,16,2022,01-18,00:44
035 Malbosc,1,7,8,2022,01-18,00:44
036 Occitanie,1,31,32,2022,01-18,00:44
037 FacdesSciences,7,17,24,2022,01-18,00:44
038 Fac de Lettres,6,10,16,2022,01-18,00:44
039 Aiguelongue,8,0,8,2022,01-18,00:44
040 Jeu de Mail des Abb�s,8,0,8,2022,01-18,00:44
041 Eurom�decine,1,7,8,2022,01-18,00:44
042 Marie Caizergues,3,5,8,2022,01-18,00:44
043 Sabines,0,8,8,2022,01-18,00:44
044 Celleneuve,1,7,8,2022,01-18,00:44
045 Jardin de la Lironde,8,0,8,2022,01-18,00:44
046 P�re Soulas,4,4,8,2022,01-18,00:44
047 Place Viala,2,6,8,2022,01-18,00:44
048 H�tel du D�partement,0,8,8,2022,01-18,00:44
049 Tonnelles,2,6,8,2022,01-18,00:44
050 Parvis Jules Ferry - Gare Saint-Roch,6,2,8,2022,01-18,00:44
051 Pont de Lattes - Gare Saint-Roch,1,11,12,2022,01-18,00:44
053 Deux Ponts - Gare Saint-Roch,3,5,8,2022,01-18,00:44
054 Providence - Ovalie,3,5,8,2022,01-18,00:44
055 P�rols Etang de l'Or,24,44,68,2022,01-18,00:44
056 Albert 1er - Cath�drale,0,12,12,2022,01-18,00:44
057 Saint-Guilhem - Courreau,6,2,8,2022,01-18,00:44
059 Sud De France,1,7,8,2022,01-18,00:44
001 Rue Jules Ferry - Gare Saint-Roch,7,5,12,2022,01-18,00:55
002 Com�die,3,21,24,2022,01-18,00:55
003 Esplanade,5,27,32,2022,01-18,00:55
004 H�tel de Ville,14,2,16,2022,01-18,00:55
005 Corum,4,8,12,2022,01-18,00:55
006 Place Albert 1er - St Charles,10,21,31,2022,01-18,00:55
007 Foch,1,7,8,2022,01-18,00:55
008 Halles Castellane,0,12,12,2022,01-18,00:55
009 Observatoire,3,5,8,2022,01-18,00:55
010 Rondelet,5,11,16,2022,01-18,00:55
011 Plan Cabanes,8,4,12,2022,01-18,00:55
012 Boutonnet,5,7,12,2022,01-18,00:55
013 Emile Combes,8,0,8,2022,01-18,00:55
014 Beaux-Arts,8,0,8,2022,01-18,00:55
015 Les Aubes,6,1,8,2022,01-18,00:55
016 Antigone centre,14,2,16,2022,01-18,00:55
017 M�diath�que Emile Zola,13,3,16,2022,01-18,00:55
018 Nombre d'Or,14,2,16,2022,01-18,00:55
019 Louis Blanc,10,6,16,2022,01-18,00:55
020 Gambetta,4,4,8,2022,01-18,00:55
021 Port Marianne,11,5,16,2022,01-18,00:55
022 Clemenceau,3,9,12,2022,01-18,00:55
023 Les Arceaux,1,15,16,2022,01-18,00:55
024 Cit� Mion,4,4,8,2022,01-18,00:55
025 Nouveau Saint-Roch,4,4,8,2022,01-18,00:55
026 Renouvier,0,8,8,2022,01-18,00:55
027 Odysseum,4,4,8,2022,01-18,00:55
028 Saint-Denis,6,2,8,2022,01-18,00:55
029 Richter,8,8,16,2022,01-18,00:55
030 Charles Flahault,6,2,8,2022,01-18,00:55
031 Voltaire,0,8,8,2022,01-18,00:55
032 Pr�s d'Ar�nes,7,1,8,2022,01-18,00:55
033 Garcia Lorca,7,1,8,2022,01-18,00:55
034 Vert Bois,0,16,16,2022,01-18,00:55
035 Malbosc,1,7,8,2022,01-18,00:55
036 Occitanie,1,31,32,2022,01-18,00:55
037 FacdesSciences,8,16,24,2022,01-18,00:55
038 Fac de Lettres,6,10,16,2022,01-18,00:55
039 Aiguelongue,8,0,8,2022,01-18,00:55
040 Jeu de Mail des Abb�s,8,0,8,2022,01-18,00:55
041 Eurom�decine,1,7,8,2022,01-18,00:55
042 Marie Caizergues,3,5,8,2022,01-18,00:55
043 Sabines,0,8,8,2022,01-18,00:55
044 Celleneuve,1,7,8,2022,01-18,00:55
045 Jardin de la Lironde,8,0,8,2022,01-18,00:55
046 P�re Soulas,4,4,8,2022,01-18,00:55
047 Place Viala,2,6,8,2022,01-18,00:55
048 H�tel du D�partement,0,8,8,2022,01-18,00:55
049 Tonnelles,2,6,8,2022,01-18,00:55
050 Parvis Jules Ferry - Gare Saint-Roch,6,2,8,2022,01-18,00:55
051 Pont de Lattes - Gare Saint-Roch,1,11,12,2022,01-18,00:55
053 Deux Ponts - Gare Saint-Roch,3,5,8,2022,01-18,00:55
054 Providence - Ovalie,3,5,8,2022,01-18,00:55
055 P�rols Etang de l'Or,24,44,68,2022,01-18,00:55
056 Albert 1er - Cath�drale,0,12,12,2022,01-18,00:55
057 Saint-Guilhem - Courreau,6,2,8,2022,01-18,00:55
059 Sud De France,1,7,8,2022,01-18,00:55
001 Rue Jules Ferry - Gare Saint-Roch,7,5,12,2022,01-18,01:05
002 Com�die,3,21,24,2022,01-18,01:05
003 Esplanade,4,28,32,2022,01-18,01:05
004 H�tel de Ville,14,2,16,2022,01-18,01:05
005 Corum,3,9,12,2022,01-18,01:05
006 Place Albert 1er - St Charles,9,22,31,2022,01-18,01:05
007 Foch,1,7,8,2022,01-18,01:05
008 Halles Castellane,0,12,12,2022,01-18,01:05
009 Observatoire,3,5,8,2022,01-18,01:05
010 Rondelet,5,11,16,2022,01-18,01:05
011 Plan Cabanes,8,4,12,2022,01-18,01:05
012 Boutonnet,5,7,12,2022,01-18,01:05
013 Emile Combes,8,0,8,2022,01-18,01:05
014 Beaux-Arts,8,0,8,2022,01-18,01:05
015 Les Aubes,6,1,8,2022,01-18,01:05
016 Antigone centre,14,2,16,2022,01-18,01:05
017 M�diath�que Emile Zola,13,3,16,2022,01-18,01:05
018 Nombre d'Or,14,2,16,2022,01-18,01:05
019 Louis Blanc,10,6,16,2022,01-18,01:05
020 Gambetta,4,4,8,2022,01-18,01:05
021 Port Marianne,11,5,16,2022,01-18,01:05
022 Clemenceau,3,9,12,2022,01-18,01:05
023 Les Arceaux,1,15,16,2022,01-18,01:05
024 Cit� Mion,4,4,8,2022,01-18,01:05
025 Nouveau Saint-Roch,4,4,8,2022,01-18,01:05
026 Renouvier,0,8,8,2022,01-18,01:05
027 Odysseum,4,4,8,2022,01-18,01:05
028 Saint-Denis,4,4,8,2022,01-18,01:05
029 Richter,8,8,16,2022,01-18,01:05
030 Charles Flahault,6,2,8,2022,01-18,01:05
031 Voltaire,0,8,8,2022,01-18,01:05
032 Pr�s d'Ar�nes,7,1,8,2022,01-18,01:05
033 Garcia Lorca,7,1,8,2022,01-18,01:05
034 Vert Bois,0,16,16,2022,01-18,01:05
035 Malbosc,1,7,8,2022,01-18,01:05
036 Occitanie,1,31,32,2022,01-18,01:05
037 FacdesSciences,8,16,24,2022,01-18,01:05
038 Fac de Lettres,6,10,16,2022,01-18,01:05
039 Aiguelongue,8,0,8,2022,01-18,01:05
040 Jeu de Mail des Abb�s,8,0,8,2022,01-18,01:05
041 Eurom�decine,1,7,8,2022,01-18,01:05
042 Marie Caizergues,3,5,8,2022,01-18,01:05
043 Sabines,0,8,8,2022,01-18,01:05
044 Celleneuve,1,7,8,2022,01-18,01:05
045 Jardin de la Lironde,8,0,8,2022,01-18,01:05
046 P�re Soulas,4,4,8,2022,01-18,01:05
047 Place Viala,2,6,8,2022,01-18,01:05
048 H�tel du D�partement,0,8,8,2022,01-18,01:05
049 Tonnelles,2,6,8,2022,01-18,01:05
050 Parvis Jules Ferry - Gare Saint-Roch,6,2,8,2022,01-18,01:05
051 Pont de Lattes - Gare Saint-Roch,1,11,12,2022,01-18,01:05
053 Deux Ponts - Gare Saint-Roch,3,5,8,2022,01-18,01:05
054 Providence - Ovalie,3,5,8,2022,01-18,01:05
055 P�rols Etang de l'Or,24,44,68,2022,01-18,01:05
056 Albert 1er - Cath�drale,0,12,12,2022,01-18,01:05
057 Saint-Guilhem - Courreau,6,2,8,2022,01-18,01:05
059 Sud De France,1,7,8,2022,01-18,01:05
001 Rue Jules Ferry - Gare Saint-Roch,7,5,12,2022,01-18,01:25
002 Com�die,3,21,24,2022,01-18,01:25
003 Esplanade,4,28,32,2022,01-18,01:25
004 H�tel de Ville,14,2,16,2022,01-18,01:25
005 Corum,3,9,12,2022,01-18,01:25
006 Place Albert 1er - St Charles,9,22,31,2022,01-18,01:25
007 Foch,1,7,8,2022,01-18,01:25
008 Halles Castellane,0,12,12,2022,01-18,01:25
009 Observatoire,3,5,8,2022,01-18,01:25
010 Rondelet,5,11,16,2022,01-18,01:25
011 Plan Cabanes,10,2,12,2022,01-18,01:25
012 Boutonnet,2,10,12,2022,01-18,01:25
013 Emile Combes,8,0,8,2022,01-18,01:25
014 Beaux-Arts,8,0,8,2022,01-18,01:25
015 Les Aubes,6,1,8,2022,01-18,01:25
016 Antigone centre,14,2,16,2022,01-18,01:25
017 M�diath�que Emile Zola,13,3,16,2022,01-18,01:25
018 Nombre d'Or,14,2,16,2022,01-18,01:25
019 Louis Blanc,10,6,16,2022,01-18,01:25
020 Gambetta,4,4,8,2022,01-18,01:25
021 Port Marianne,11,5,16,2022,01-18,01:25
022 Clemenceau,3,9,12,2022,01-18,01:25
023 Les Arceaux,1,15,16,2022,01-18,01:25
024 Cit� Mion,4,4,8,2022,01-18,01:25
025 Nouveau Saint-Roch,6,2,8,2022,01-18,01:25
026 Renouvier,0,8,8,2022,01-18,01:25
027 Odysseum,4,4,8,2022,01-18,01:25
028 Saint-Denis,4,4,8,2022,01-18,01:25
029 Richter,9,7,16,2022,01-18,01:25
030 Charles Flahault,6,2,8,2022,01-18,01:25
031 Voltaire,0,8,8,2022,01-18,01:25
032 Pr�s d'Ar�nes,7,1,8,2022,01-18,01:25
033 Garcia Lorca,7,1,8,2022,01-18,01:25
034 Vert Bois,0,16,16,2022,01-18,01:25
035 Malbosc,1,7,8,2022,01-18,01:25
036 Occitanie,1,31,32,2022,01-18,01:25
037 FacdesSciences,7,17,24,2022,01-18,01:25
038 Fac de Lettres,7,9,16,2022,01-18,01:25
039 Aiguelongue,7,1,8,2022,01-18,01:25
040 Jeu de Mail des Abb�s,8,0,8,2022,01-18,01:25
041 Eurom�decine,1,7,8,2022,01-18,01:25
042 Marie Caizergues,3,5,8,2022,01-18,01:25
043 Sabines,0,8,8,2022,01-18,01:25
044 Celleneuve,1,7,8,2022,01-18,01:25
045 Jardin de la Lironde,8,0,8,2022,01-18,01:25
046 P�re Soulas,4,4,8,2022,01-18,01:25
047 Place Viala,4,4,8,2022,01-18,01:25
048 H�tel du D�partement,0,8,8,2022,01-18,01:25
049 Tonnelles,2,6,8,2022,01-18,01:25
050 Parvis Jules Ferry - Gare Saint-Roch,8,0,8,2022,01-18,01:25
051 Pont de Lattes - Gare Saint-Roch,2,10,12,2022,01-18,01:25
053 Deux Ponts - Gare Saint-Roch,3,5,8,2022,01-18,01:25
054 Providence - Ovalie,3,5,8,2022,01-18,01:25
055 P�rols Etang de l'Or,24,44,68,2022,01-18,01:25
056 Albert 1er - Cath�drale,0,12,12,2022,01-18,01:25
057 Saint-Guilhem - Courreau,5,3,8,2022,01-18,01:25
059 Sud De France,1,7,8,2022,01-18,01:25
001 Rue Jules Ferry - Gare Saint-Roch,7,5,12,2022,01-18,01:56
002 Com�die,3,21,24,2022,01-18,01:56
003 Esplanade,4,28,32,2022,01-18,01:56
004 H�tel de Ville,14,2,16,2022,01-18,01:56
005 Corum,3,9,12,2022,01-18,01:56
006 Place Albert 1er - St Charles,9,22,31,2022,01-18,01:56
007 Foch,1,7,8,2022,01-18,01:56
008 Halles Castellane,0,12,12,2022,01-18,01:56
009 Observatoire,3,5,8,2022,01-18,01:56
010 Rondelet,5,11,16,2022,01-18,01:56
011 Plan Cabanes,9,3,12,2022,01-18,01:56
012 Boutonnet,2,10,12,2022,01-18,01:56
013 Emile Combes,8,0,8,2022,01-18,01:56
014 Beaux-Arts,8,0,8,2022,01-18,01:56
015 Les Aubes,6,1,8,2022,01-18,01:56
016 Antigone centre,14,2,16,2022,01-18,01:56
017 M�diath�que Emile Zola,13,3,16,2022,01-18,01:56
018 Nombre d'Or,14,2,16,2022,01-18,01:56
019 Louis Blanc,11,5,16,2022,01-18,01:56
020 Gambetta,4,4,8,2022,01-18,01:56
021 Port Marianne,11,5,16,2022,01-18,01:56
022 Clemenceau,3,9,12,2022,01-18,01:56
023 Les Arceaux,1,15,16,2022,01-18,01:56
024 Cit� Mion,4,4,8,2022,01-18,01:56
025 Nouveau Saint-Roch,6,2,8,2022,01-18,01:56
026 Renouvier,0,8,8,2022,01-18,01:56
027 Odysseum,4,4,8,2022,01-18,01:56
028 Saint-Denis,4,4,8,2022,01-18,01:56
029 Richter,9,7,16,2022,01-18,01:56
030 Charles Flahault,6,2,8,2022,01-18,01:56
031 Voltaire,0,8,8,2022,01-18,01:56
032 Pr�s d'Ar�nes,7,1,8,2022,01-18,01:56
033 Garcia Lorca,7,1,8,2022,01-18,01:56
034 Vert Bois,0,16,16,2022,01-18,01:56
035 Malbosc,1,7,8,2022,01-18,01:56
036 Occitanie,1,31,32,2022,01-18,01:56
037 FacdesSciences,8,16,24,2022,01-18,01:56
038 Fac de Lettres,7,9,16,2022,01-18,01:56
039 Aiguelongue,7,1,8,2022,01-18,01:56
040 Jeu de Mail des Abb�s,8,0,8,2022,01-18,01:56
041 Eurom�decine,1,7,8,2022,01-18,01:56
042 Marie Caizergues,3,5,8,2022,01-18,01:56
043 Sabines,2,6,8,2022,01-18,01:56
044 Celleneuve,1,7,8,2022,01-18,01:56
045 Jardin de la Lironde,8,0,8,2022,01-18,01:56
046 P�re Soulas,4,4,8,2022,01-18,01:56
047 Place Viala,4,4,8,2022,01-18,01:56
048 H�tel du D�partement,0,8,8,2022,01-18,01:56
049 Tonnelles,2,6,8,2022,01-18,01:56
050 Parvis Jules Ferry - Gare Saint-Roch,8,0,8,2022,01-18,01:56
051 Pont de Lattes - Gare Saint-Roch,2,10,12,2022,01-18,01:56
053 Deux Ponts - Gare Saint-Roch,3,5,8,2022,01-18,01:56
054 Providence - Ovalie,3,5,8,2022,01-18,01:56
055 P�rols Etang de l'Or,24,44,68,2022,01-18,01:56
056 Albert 1er - Cath�drale,0,12,12,2022,01-18,01:56
057 Saint-Guilhem - Courreau,3,5,8,2022,01-18,01:56
059 Sud De France,1,7,8,2022,01-18,01:56
001 Rue Jules Ferry - Gare Saint-Roch,7,5,12,2022,01-18,02:06
002 Com�die,4,20,24,2022,01-18,02:06
003 Esplanade,4,28,32,2022,01-18,02:06
004 H�tel de Ville,14,2,16,2022,01-18,02:06
005 Corum,3,9,12,2022,01-18,02:06
006 Place Albert 1er - St Charles,9,22,31,2022,01-18,02:06
007 Foch,1,7,8,2022,01-18,02:06
008 Halles Castellane,0,12,12,2022,01-18,02:06
009 Observatoire,3,5,8,2022,01-18,02:06
010 Rondelet,5,11,16,2022,01-18,02:06
011 Plan Cabanes,9,3,12,2022,01-18,02:06
012 Boutonnet,2,10,12,2022,01-18,02:06
013 Emile Combes,8,0,8,2022,01-18,02:06
014 Beaux-Arts,8,0,8,2022,01-18,02:06
015 Les Aubes,6,1,8,2022,01-18,02:06
016 Antigone centre,14,2,16,2022,01-18,02:06
017 M�diath�que Emile Zola,13,3,16,2022,01-18,02:06
018 Nombre d'Or,14,2,16,2022,01-18,02:06
019 Louis Blanc,11,5,16,2022,01-18,02:06
020 Gambetta,4,4,8,2022,01-18,02:06
021 Port Marianne,11,5,16,2022,01-18,02:06
022 Clemenceau,3,9,12,2022,01-18,02:06
023 Les Arceaux,1,15,16,2022,01-18,02:06
024 Cit� Mion,4,4,8,2022,01-18,02:06
025 Nouveau Saint-Roch,6,2,8,2022,01-18,02:06
026 Renouvier,0,8,8,2022,01-18,02:06
027 Odysseum,4,4,8,2022,01-18,02:06
028 Saint-Denis,4,4,8,2022,01-18,02:06
029 Richter,9,7,16,2022,01-18,02:06
030 Charles Flahault,6,2,8,2022,01-18,02:06
031 Voltaire,0,8,8,2022,01-18,02:06
032 Pr�s d'Ar�nes,7,1,8,2022,01-18,02:06
033 Garcia Lorca,7,1,8,2022,01-18,02:06
034 Vert Bois,0,16,16,2022,01-18,02:06
035 Malbosc,1,7,8,2022,01-18,02:06
036 Occitanie,1,31,32,2022,01-18,02:06
037 FacdesSciences,8,16,24,2022,01-18,02:06
038 Fac de Lettres,8,8,16,2022,01-18,02:06
039 Aiguelongue,7,1,8,2022,01-18,02:06
040 Jeu de Mail des Abb�s,8,0,8,2022,01-18,02:06
041 Eurom�decine,1,7,8,2022,01-18,02:06
042 Marie Caizergues,3,5,8,2022,01-18,02:06
043 Sabines,2,6,8,2022,01-18,02:06
044 Celleneuve,1,7,8,2022,01-18,02:06
045 Jardin de la Lironde,8,0,8,2022,01-18,02:06
046 P�re Soulas,5,3,8,2022,01-18,02:06
047 Place Viala,4,4,8,2022,01-18,02:06
048 H�tel du D�partement,0,8,8,2022,01-18,02:06
049 Tonnelles,2,6,8,2022,01-18,02:06
050 Parvis Jules Ferry - Gare Saint-Roch,8,0,8,2022,01-18,02:06
051 Pont de Lattes - Gare Saint-Roch,2,10,12,2022,01-18,02:06
053 Deux Ponts - Gare Saint-Roch,3,5,8,2022,01-18,02:06
054 Providence - Ovalie,3,5,8,2022,01-18,02:06
055 P�rols Etang de l'Or,24,44,68,2022,01-18,02:06
056 Albert 1er - Cath�drale,0,12,12,2022,01-18,02:06
057 Saint-Guilhem - Courreau,3,5,8,2022,01-18,02:06
059 Sud De France,1,7,8,2022,01-18,02:06
001 Rue Jules Ferry - Gare Saint-Roch,7,5,12,2022,01-18,02:17
002 Com�die,4,20,24,2022,01-18,02:17
003 Esplanade,4,28,32,2022,01-18,02:17
004 H�tel de Ville,14,2,16,2022,01-18,02:17
005 Corum,3,9,12,2022,01-18,02:17
006 Place Albert 1er - St Charles,9,22,31,2022,01-18,02:17
007 Foch,1,7,8,2022,01-18,02:17
008 Halles Castellane,0,12,12,2022,01-18,02:17
009 Observatoire,3,5,8,2022,01-18,02:17
010 Rondelet,5,11,16,2022,01-18,02:17
011 Plan Cabanes,9,3,12,2022,01-18,02:17
012 Boutonnet,2,10,12,2022,01-18,02:17
013 Emile Combes,8,0,8,2022,01-18,02:17
014 Beaux-Arts,8,0,8,2022,01-18,02:17
015 Les Aubes,6,1,8,2022,01-18,02:17
016 Antigone centre,14,2,16,2022,01-18,02:17
017 M�diath�que Emile Zola,13,3,16,2022,01-18,02:17
018 Nombre d'Or,14,2,16,2022,01-18,02:17
019 Louis Blanc,11,5,16,2022,01-18,02:17
020 Gambetta,4,4,8,2022,01-18,02:17
021 Port Marianne,11,5,16,2022,01-18,02:17
022 Clemenceau,3,9,12,2022,01-18,02:17
023 Les Arceaux,1,15,16,2022,01-18,02:17
024 Cit� Mion,4,4,8,2022,01-18,02:17
025 Nouveau Saint-Roch,6,2,8,2022,01-18,02:17
026 Renouvier,0,8,8,2022,01-18,02:17
027 Odysseum,4,4,8,2022,01-18,02:17
028 Saint-Denis,4,4,8,2022,01-18,02:17
029 Richter,9,7,16,2022,01-18,02:17
030 Charles Flahault,7,1,8,2022,01-18,02:17
031 Voltaire,0,8,8,2022,01-18,02:17
032 Pr�s d'Ar�nes,7,1,8,2022,01-18,02:17
033 Garcia Lorca,7,1,8,2022,01-18,02:17
034 Vert Bois,0,16,16,2022,01-18,02:17
035 Malbosc,1,7,8,2022,01-18,02:17
036 Occitanie,1,31,32,2022,01-18,02:17
037 FacdesSciences,9,15,24,2022,01-18,02:17
038 Fac de Lettres,8,8,16,2022,01-18,02:17
039 Aiguelongue,7,1,8,2022,01-18,02:17
040 Jeu de Mail des Abb�s,8,0,8,2022,01-18,02:17
041 Eurom�decine,1,7,8,2022,01-18,02:17
042 Marie Caizergues,3,5,8,2022,01-18,02:17
043 Sabines,2,6,8,2022,01-18,02:17
044 Celleneuve,1,7,8,2022,01-18,02:17
045 Jardin de la Lironde,8,0,8,2022,01-18,02:17
046 P�re Soulas,5,3,8,2022,01-18,02:17
047 Place Viala,4,4,8,2022,01-18,02:17
048 H�tel du D�partement,0,8,8,2022,01-18,02:17
049 Tonnelles,2,6,8,2022,01-18,02:17
050 Parvis Jules Ferry - Gare Saint-Roch,8,0,8,2022,01-18,02:17
051 Pont de Lattes - Gare Saint-Roch,2,10,12,2022,01-18,02:17
053 Deux Ponts - Gare Saint-Roch,3,5,8,2022,01-18,02:17
054 Providence - Ovalie,3,5,8,2022,01-18,02:17
055 P�rols Etang de l'Or,24,44,68,2022,01-18,02:17
056 Albert 1er - Cath�drale,0,12,12,2022,01-18,02:17
057 Saint-Guilhem - Courreau,3,5,8,2022,01-18,02:17
059 Sud De France,1,7,8,2022,01-18,02:17
001 Rue Jules Ferry - Gare Saint-Roch,7,5,12,2022,01-18,02:27
002 Com�die,4,20,24,2022,01-18,02:27
003 Esplanade,4,28,32,2022,01-18,02:27
004 H�tel de Ville,14,2,16,2022,01-18,02:27
005 Corum,3,9,12,2022,01-18,02:27
006 Place Albert 1er - St Charles,9,22,31,2022,01-18,02:27
007 Foch,1,7,8,2022,01-18,02:27
008 Halles Castellane,0,12,12,2022,01-18,02:27
009 Observatoire,3,5,8,2022,01-18,02:27
010 Rondelet,5,11,16,2022,01-18,02:27
011 Plan Cabanes,9,3,12,2022,01-18,02:27
012 Boutonnet,2,10,12,2022,01-18,02:27
013 Emile Combes,8,0,8,2022,01-18,02:27
014 Beaux-Arts,8,0,8,2022,01-18,02:27
015 Les Aubes,6,1,8,2022,01-18,02:27
016 Antigone centre,14,2,16,2022,01-18,02:27
017 M�diath�que Emile Zola,13,3,16,2022,01-18,02:27
018 Nombre d'Or,14,2,16,2022,01-18,02:27
019 Louis Blanc,11,5,16,2022,01-18,02:27
020 Gambetta,4,4,8,2022,01-18,02:27
021 Port Marianne,11,5,16,2022,01-18,02:27
022 Clemenceau,3,9,12,2022,01-18,02:27
023 Les Arceaux,1,15,16,2022,01-18,02:27
024 Cit� Mion,4,4,8,2022,01-18,02:27
025 Nouveau Saint-Roch,5,3,8,2022,01-18,02:27
026 Renouvier,0,8,8,2022,01-18,02:27
027 Odysseum,4,4,8,2022,01-18,02:27
028 Saint-Denis,4,4,8,2022,01-18,02:27
029 Richter,7,9,16,2022,01-18,02:27
030 Charles Flahault,7,1,8,2022,01-18,02:27
031 Voltaire,0,8,8,2022,01-18,02:27
032 Pr�s d'Ar�nes,7,1,8,2022,01-18,02:27
033 Garcia Lorca,7,1,8,2022,01-18,02:27
034 Vert Bois,0,16,16,2022,01-18,02:27
035 Malbosc,1,7,8,2022,01-18,02:27
036 Occitanie,1,31,32,2022,01-18,02:27
037 FacdesSciences,9,15,24,2022,01-18,02:27
038 Fac de Lettres,8,8,16,2022,01-18,02:27
039 Aiguelongue,7,1,8,2022,01-18,02:27
040 Jeu de Mail des Abb�s,8,0,8,2022,01-18,02:27
041 Eurom�decine,1,7,8,2022,01-18,02:27
042 Marie Caizergues,3,5,8,2022,01-18,02:27
043 Sabines,2,6,8,2022,01-18,02:27
044 Celleneuve,1,7,8,2022,01-18,02:27
045 Jardin de la Lironde,8,0,8,2022,01-18,02:27
046 P�re Soulas,5,3,8,2022,01-18,02:27
047 Place Viala,4,4,8,2022,01-18,02:27
048 H�tel du D�partement,0,8,8,2022,01-18,02:27
049 Tonnelles,2,6,8,2022,01-18,02:27
050 Parvis Jules Ferry - Gare Saint-Roch,8,0,8,2022,01-18,02:27
051 Pont de Lattes - Gare Saint-Roch,2,10,12,2022,01-18,02:27
053 Deux Ponts - Gare Saint-Roch,3,5,8,2022,01-18,02:27
054 Providence - Ovalie,3,5,8,2022,01-18,02:27
055 P�rols Etang de l'Or,24,44,68,2022,01-18,02:27
056 Albert 1er - Cath�drale,0,12,12,2022,01-18,02:27
057 Saint-Guilhem - Courreau,3,5,8,2022,01-18,02:27
059 Sud De France,1,7,8,2022,01-18,02:27
001 Rue Jules Ferry - Gare Saint-Roch,7,5,12,2022,01-18,02:37
002 Com�die,4,20,24,2022,01-18,02:37
003 Esplanade,4,28,32,2022,01-18,02:37
004 H�tel de Ville,14,2,16,2022,01-18,02:37
005 Corum,3,9,12,2022,01-18,02:37
006 Place Albert 1er - St Charles,9,22,31,2022,01-18,02:37
007 Foch,1,7,8,2022,01-18,02:37
008 Halles Castellane,0,12,12,2022,01-18,02:37
009 Observatoire,3,5,8,2022,01-18,02:37
010 Rondelet,5,11,16,2022,01-18,02:37
011 Plan Cabanes,9,3,12,2022,01-18,02:37
012 Boutonnet,2,10,12,2022,01-18,02:37
013 Emile Combes,8,0,8,2022,01-18,02:37
014 Beaux-Arts,8,0,8,2022,01-18,02:37
015 Les Aubes,6,1,8,2022,01-18,02:37
016 Antigone centre,14,2,16,2022,01-18,02:37
017 M�diath�que Emile Zola,13,3,16,2022,01-18,02:37
018 Nombre d'Or,14,2,16,2022,01-18,02:37
019 Louis Blanc,11,5,16,2022,01-18,02:37
020 Gambetta,4,4,8,2022,01-18,02:37
021 Port Marianne,11,5,16,2022,01-18,02:37
022 Clemenceau,3,9,12,2022,01-18,02:37
023 Les Arceaux,1,15,16,2022,01-18,02:37
024 Cit� Mion,4,4,8,2022,01-18,02:37
025 Nouveau Saint-Roch,5,3,8,2022,01-18,02:37
026 Renouvier,0,8,8,2022,01-18,02:37
027 Odysseum,4,4,8,2022,01-18,02:37
028 Saint-Denis,4,4,8,2022,01-18,02:37
029 Richter,7,9,16,2022,01-18,02:37
030 Charles Flahault,7,1,8,2022,01-18,02:37
031 Voltaire,0,8,8,2022,01-18,02:37
032 Pr�s d'Ar�nes,7,1,8,2022,01-18,02:37
033 Garcia Lorca,7,1,8,2022,01-18,02:37
034 Vert Bois,0,16,16,2022,01-18,02:37
035 Malbosc,1,7,8,2022,01-18,02:37
036 Occitanie,1,31,32,2022,01-18,02:37
037 FacdesSciences,9,15,24,2022,01-18,02:37
038 Fac de Lettres,8,8,16,2022,01-18,02:37
039 Aiguelongue,7,1,8,2022,01-18,02:37
040 Jeu de Mail des Abb�s,8,0,8,2022,01-18,02:37
041 Eurom�decine,1,7,8,2022,01-18,02:37
042 Marie Caizergues,3,5,8,2022,01-18,02:37
043 Sabines,2,6,8,2022,01-18,02:37
044 Celleneuve,1,7,8,2022,01-18,02:37
045 Jardin de la Lironde,8,0,8,2022,01-18,02:37
046 P�re Soulas,5,3,8,2022,01-18,02:37
047 Place Viala,4,4,8,2022,01-18,02:37
048 H�tel du D�partement,0,8,8,2022,01-18,02:37
049 Tonnelles,2,6,8,2022,01-18,02:37
050 Parvis Jules Ferry - Gare Saint-Roch,8,0,8,2022,01-18,02:37
051 Pont de Lattes - Gare Saint-Roch,2,10,12,2022,01-18,02:37
053 Deux Ponts - Gare Saint-Roch,3,5,8,2022,01-18,02:37
054 Providence - Ovalie,3,5,8,2022,01-18,02:37
055 P�rols Etang de l'Or,24,44,68,2022,01-18,02:37
056 Albert 1er - Cath�drale,0,12,12,2022,01-18,02:37
057 Saint-Guilhem - Courreau,3,5,8,2022,01-18,02:37
059 Sud De France,1,7,8,2022,01-18,02:37
001 Rue Jules Ferry - Gare Saint-Roch,7,5,12,2022,01-18,02:47
002 Com�die,4,20,24,2022,01-18,02:47
003 Esplanade,4,28,32,2022,01-18,02:47
004 H�tel de Ville,14,2,16,2022,01-18,02:47
005 Corum,3,9,12,2022,01-18,02:47
006 Place Albert 1er - St Charles,9,22,31,2022,01-18,02:47
007 Foch,1,7,8,2022,01-18,02:47
008 Halles Castellane,0,12,12,2022,01-18,02:47
009 Observatoire,3,5,8,2022,01-18,02:47
010 Rondelet,5,11,16,2022,01-18,02:47
011 Plan Cabanes,9,3,12,2022,01-18,02:47
012 Boutonnet,2,10,12,2022,01-18,02:47
013 Emile Combes,8,0,8,2022,01-18,02:47
014 Beaux-Arts,8,0,8,2022,01-18,02:47
015 Les Aubes,6,1,8,2022,01-18,02:47
016 Antigone centre,14,2,16,2022,01-18,02:47
017 M�diath�que Emile Zola,13,3,16,2022,01-18,02:47
018 Nombre d'Or,14,2,16,2022,01-18,02:47
019 Louis Blanc,11,5,16,2022,01-18,02:47
020 Gambetta,4,4,8,2022,01-18,02:47
021 Port Marianne,11,5,16,2022,01-18,02:47
022 Clemenceau,3,9,12,2022,01-18,02:47
023 Les Arceaux,1,15,16,2022,01-18,02:47
024 Cit� Mion,4,4,8,2022,01-18,02:47
025 Nouveau Saint-Roch,5,3,8,2022,01-18,02:47
026 Renouvier,0,8,8,2022,01-18,02:47
027 Odysseum,4,4,8,2022,01-18,02:47
028 Saint-Denis,4,4,8,2022,01-18,02:47
029 Richter,7,9,16,2022,01-18,02:47
030 Charles Flahault,7,1,8,2022,01-18,02:47
031 Voltaire,0,8,8,2022,01-18,02:47
032 Pr�s d'Ar�nes,7,1,8,2022,01-18,02:47
033 Garcia Lorca,7,1,8,2022,01-18,02:47
034 Vert Bois,0,16,16,2022,01-18,02:47
035 Malbosc,1,7,8,2022,01-18,02:47
036 Occitanie,1,31,32,2022,01-18,02:47
037 FacdesSciences,9,15,24,2022,01-18,02:47
038 Fac de Lettres,8,8,16,2022,01-18,02:47
039 Aiguelongue,7,1,8,2022,01-18,02:47
040 Jeu de Mail des Abb�s,8,0,8,2022,01-18,02:47
041 Eurom�decine,1,7,8,2022,01-18,02:47
042 Marie Caizergues,3,5,8,2022,01-18,02:47
043 Sabines,2,6,8,2022,01-18,02:47
044 Celleneuve,1,7,8,2022,01-18,02:47
045 Jardin de la Lironde,8,0,8,2022,01-18,02:47
046 P�re Soulas,5,3,8,2022,01-18,02:47
047 Place Viala,4,4,8,2022,01-18,02:47
048 H�tel du D�partement,0,8,8,2022,01-18,02:47
049 Tonnelles,2,6,8,2022,01-18,02:47
050 Parvis Jules Ferry - Gare Saint-Roch,8,0,8,2022,01-18,02:47
051 Pont de Lattes - Gare Saint-Roch,2,10,12,2022,01-18,02:47
053 Deux Ponts - Gare Saint-Roch,3,5,8,2022,01-18,02:47
054 Providence - Ovalie,3,5,8,2022,01-18,02:47
055 P�rols Etang de l'Or,24,44,68,2022,01-18,02:47
056 Albert 1er - Cath�drale,0,12,12,2022,01-18,02:47
057 Saint-Guilhem - Courreau,3,5,8,2022,01-18,02:47
059 Sud De France,1,7,8,2022,01-18,02:47
001 Rue Jules Ferry - Gare Saint-Roch,7,5,12,2022,01-18,02:57
002 Com�die,4,20,24,2022,01-18,02:57
003 Esplanade,4,28,32,2022,01-18,02:57
004 H�tel de Ville,14,2,16,2022,01-18,02:57
005 Corum,3,9,12,2022,01-18,02:57
006 Place Albert 1er - St Charles,9,22,31,2022,01-18,02:57
007 Foch,1,7,8,2022,01-18,02:57
008 Halles Castellane,0,12,12,2022,01-18,02:57
009 Observatoire,3,5,8,2022,01-18,02:57
010 Rondelet,5,11,16,2022,01-18,02:57
011 Plan Cabanes,7,5,12,2022,01-18,02:57
012 Boutonnet,2,10,12,2022,01-18,02:57
013 Emile Combes,8,0,8,2022,01-18,02:57
014 Beaux-Arts,8,0,8,2022,01-18,02:57
015 Les Aubes,6,1,8,2022,01-18,02:57
016 Antigone centre,14,2,16,2022,01-18,02:57
017 M�diath�que Emile Zola,11,5,16,2022,01-18,02:57
018 Nombre d'Or,14,2,16,2022,01-18,02:57
019 Louis Blanc,10,6,16,2022,01-18,02:57
020 Gambetta,4,4,8,2022,01-18,02:57
021 Port Marianne,11,5,16,2022,01-18,02:57
022 Clemenceau,3,9,12,2022,01-18,02:57
023 Les Arceaux,1,15,16,2022,01-18,02:57
024 Cit� Mion,4,4,8,2022,01-18,02:57
025 Nouveau Saint-Roch,5,3,8,2022,01-18,02:57
026 Renouvier,0,8,8,2022,01-18,02:57
027 Odysseum,4,4,8,2022,01-18,02:57
028 Saint-Denis,4,4,8,2022,01-18,02:57
029 Richter,7,9,16,2022,01-18,02:57
030 Charles Flahault,7,1,8,2022,01-18,02:57
031 Voltaire,0,8,8,2022,01-18,02:57
032 Pr�s d'Ar�nes,7,1,8,2022,01-18,02:57
033 Garcia Lorca,7,1,8,2022,01-18,02:57
034 Vert Bois,0,16,16,2022,01-18,02:57
035 Malbosc,1,7,8,2022,01-18,02:57
036 Occitanie,1,31,32,2022,01-18,02:57
037 FacdesSciences,9,15,24,2022,01-18,02:57
038 Fac de Lettres,8,8,16,2022,01-18,02:57
039 Aiguelongue,7,1,8,2022,01-18,02:57
040 Jeu de Mail des Abb�s,8,0,8,2022,01-18,02:57
041 Eurom�decine,1,7,8,2022,01-18,02:57
042 Marie Caizergues,3,5,8,2022,01-18,02:57
043 Sabines,2,6,8,2022,01-18,02:57
044 Celleneuve,1,7,8,2022,01-18,02:57
045 Jardin de la Lironde,8,0,8,2022,01-18,02:57
046 P�re Soulas,5,3,8,2022,01-18,02:57
047 Place Viala,4,4,8,2022,01-18,02:57
048 H�tel du D�partement,0,8,8,2022,01-18,02:57
049 Tonnelles,2,6,8,2022,01-18,02:57
050 Parvis Jules Ferry - Gare Saint-Roch,8,0,8,2022,01-18,02:57
051 Pont de Lattes - Gare Saint-Roch,2,10,12,2022,01-18,02:57
053 Deux Ponts - Gare Saint-Roch,3,5,8,2022,01-18,02:57
054 Providence - Ovalie,3,5,8,2022,01-18,02:57
055 P�rols Etang de l'Or,24,44,68,2022,01-18,02:57
056 Albert 1er - Cath�drale,0,12,12,2022,01-18,02:57
057 Saint-Guilhem - Courreau,3,5,8,2022,01-18,02:57
059 Sud De France,1,7,8,2022,01-18,02:57
001 Rue Jules Ferry - Gare Saint-Roch,9,3,12,2022,01-18,03:07
002 Com�die,4,20,24,2022,01-18,03:07
003 Esplanade,4,28,32,2022,01-18,03:07
004 H�tel de Ville,14,2,16,2022,01-18,03:07
005 Corum,3,9,12,2022,01-18,03:07
006 Place Albert 1er - St Charles,9,22,31,2022,01-18,03:07
007 Foch,1,7,8,2022,01-18,03:07
008 Halles Castellane,0,12,12,2022,01-18,03:07
009 Observatoire,3,5,8,2022,01-18,03:07
010 Rondelet,5,11,16,2022,01-18,03:07
011 Plan Cabanes,7,5,12,2022,01-18,03:07
012 Boutonnet,2,10,12,2022,01-18,03:07
013 Emile Combes,8,0,8,2022,01-18,03:07
014 Beaux-Arts,8,0,8,2022,01-18,03:07
015 Les Aubes,6,1,8,2022,01-18,03:07
016 Antigone centre,14,2,16,2022,01-18,03:07
017 M�diath�que Emile Zola,11,5,16,2022,01-18,03:07
018 Nombre d'Or,14,2,16,2022,01-18,03:07
019 Louis Blanc,10,6,16,2022,01-18,03:07
020 Gambetta,4,4,8,2022,01-18,03:07
021 Port Marianne,11,5,16,2022,01-18,03:07
022 Clemenceau,3,9,12,2022,01-18,03:07
023 Les Arceaux,1,15,16,2022,01-18,03:07
024 Cit� Mion,4,4,8,2022,01-18,03:07
025 Nouveau Saint-Roch,5,3,8,2022,01-18,03:07
026 Renouvier,0,8,8,2022,01-18,03:07
027 Odysseum,4,4,8,2022,01-18,03:07
028 Saint-Denis,4,4,8,2022,01-18,03:07
029 Richter,7,9,16,2022,01-18,03:07
030 Charles Flahault,7,1,8,2022,01-18,03:07
031 Voltaire,0,8,8,2022,01-18,03:07
032 Pr�s d'Ar�nes,7,1,8,2022,01-18,03:07
033 Garcia Lorca,7,1,8,2022,01-18,03:07
034 Vert Bois,0,16,16,2022,01-18,03:07
035 Malbosc,1,7,8,2022,01-18,03:07
036 Occitanie,1,31,32,2022,01-18,03:07
037 FacdesSciences,10,14,24,2022,01-18,03:07
038 Fac de Lettres,8,8,16,2022,01-18,03:07
039 Aiguelongue,7,1,8,2022,01-18,03:07
040 Jeu de Mail des Abb�s,8,0,8,2022,01-18,03:07
041 Eurom�decine,1,7,8,2022,01-18,03:07
042 Marie Caizergues,3,5,8,2022,01-18,03:07
043 Sabines,2,6,8,2022,01-18,03:07
044 Celleneuve,1,7,8,2022,01-18,03:07
045 Jardin de la Lironde,8,0,8,2022,01-18,03:07
046 P�re Soulas,5,3,8,2022,01-18,03:07
047 Place Viala,4,4,8,2022,01-18,03:07
048 H�tel du D�partement,0,8,8,2022,01-18,03:07
049 Tonnelles,2,6,8,2022,01-18,03:07
050 Parvis Jules Ferry - Gare Saint-Roch,8,0,8,2022,01-18,03:07
051 Pont de Lattes - Gare Saint-Roch,2,10,12,2022,01-18,03:07
053 Deux Ponts - Gare Saint-Roch,3,5,8,2022,01-18,03:07
054 Providence - Ovalie,3,5,8,2022,01-18,03:07
055 P�rols Etang de l'Or,24,44,68,2022,01-18,03:07
056 Albert 1er - Cath�drale,0,12,12,2022,01-18,03:07
057 Saint-Guilhem - Courreau,3,5,8,2022,01-18,03:07
059 Sud De France,1,7,8,2022,01-18,03:07
001 Rue Jules Ferry - Gare Saint-Roch,9,3,12,2022,01-18,03:17
002 Com�die,4,20,24,2022,01-18,03:17
003 Esplanade,4,28,32,2022,01-18,03:17
004 H�tel de Ville,14,2,16,2022,01-18,03:17
005 Corum,3,9,12,2022,01-18,03:17
006 Place Albert 1er - St Charles,9,22,31,2022,01-18,03:17
007 Foch,1,7,8,2022,01-18,03:17
008 Halles Castellane,0,12,12,2022,01-18,03:17
009 Observatoire,3,5,8,2022,01-18,03:17
010 Rondelet,5,11,16,2022,01-18,03:17
011 Plan Cabanes,7,5,12,2022,01-18,03:17
012 Boutonnet,2,10,12,2022,01-18,03:17
013 Emile Combes,8,0,8,2022,01-18,03:17
014 Beaux-Arts,8,0,8,2022,01-18,03:17
015 Les Aubes,6,1,8,2022,01-18,03:17
016 Antigone centre,14,2,16,2022,01-18,03:17
017 M�diath�que Emile Zola,11,5,16,2022,01-18,03:17
018 Nombre d'Or,14,2,16,2022,01-18,03:17
019 Louis Blanc,10,6,16,2022,01-18,03:17
020 Gambetta,4,4,8,2022,01-18,03:17
021 Port Marianne,11,5,16,2022,01-18,03:17
022 Clemenceau,3,9,12,2022,01-18,03:17
023 Les Arceaux,1,15,16,2022,01-18,03:17
024 Cit� Mion,4,4,8,2022,01-18,03:17
025 Nouveau Saint-Roch,5,3,8,2022,01-18,03:17
026 Renouvier,0,8,8,2022,01-18,03:17
027 Odysseum,4,4,8,2022,01-18,03:17
028 Saint-Denis,4,4,8,2022,01-18,03:17
029 Richter,8,8,16,2022,01-18,03:17
030 Charles Flahault,7,1,8,2022,01-18,03:17
031 Voltaire,0,8,8,2022,01-18,03:17
032 Pr�s d'Ar�nes,7,1,8,2022,01-18,03:17
033 Garcia Lorca,7,1,8,2022,01-18,03:17
034 Vert Bois,0,16,16,2022,01-18,03:17
035 Malbosc,1,7,8,2022,01-18,03:17
036 Occitanie,1,31,32,2022,01-18,03:17
037 FacdesSciences,9,15,24,2022,01-18,03:17
038 Fac de Lettres,8,8,16,2022,01-18,03:17
039 Aiguelongue,7,1,8,2022,01-18,03:17
040 Jeu de Mail des Abb�s,8,0,8,2022,01-18,03:17
041 Eurom�decine,1,7,8,2022,01-18,03:17
042 Marie Caizergues,3,5,8,2022,01-18,03:17
043 Sabines,2,6,8,2022,01-18,03:17
044 Celleneuve,1,7,8,2022,01-18,03:17
045 Jardin de la Lironde,8,0,8,2022,01-18,03:17
046 P�re Soulas,5,3,8,2022,01-18,03:17
047 Place Viala,4,4,8,2022,01-18,03:17
048 H�tel du D�partement,0,8,8,2022,01-18,03:17
049 Tonnelles,2,6,8,2022,01-18,03:17
050 Parvis Jules Ferry - Gare Saint-Roch,8,0,8,2022,01-18,03:17
051 Pont de Lattes - Gare Saint-Roch,2,10,12,2022,01-18,03:17
053 Deux Ponts - Gare Saint-Roch,3,5,8,2022,01-18,03:17
054 Providence - Ovalie,5,3,8,2022,01-18,03:17
055 P�rols Etang de l'Or,24,44,68,2022,01-18,03:17
056 Albert 1er - Cath�drale,0,12,12,2022,01-18,03:17
057 Saint-Guilhem - Courreau,3,5,8,2022,01-18,03:17
059 Sud De France,1,7,8,2022,01-18,03:17
001 Rue Jules Ferry - Gare Saint-Roch,9,3,12,2022,01-18,03:28
002 Com�die,4,20,24,2022,01-18,03:28
003 Esplanade,4,28,32,2022,01-18,03:28
004 H�tel de Ville,14,2,16,2022,01-18,03:28
005 Corum,4,8,12,2022,01-18,03:28
006 Place Albert 1er - St Charles,9,22,31,2022,01-18,03:28
007 Foch,1,7,8,2022,01-18,03:28
008 Halles Castellane,0,12,12,2022,01-18,03:28
009 Observatoire,3,5,8,2022,01-18,03:28
010 Rondelet,5,11,16,2022,01-18,03:28
011 Plan Cabanes,7,5,12,2022,01-18,03:28
012 Boutonnet,2,10,12,2022,01-18,03:28
013 Emile Combes,8,0,8,2022,01-18,03:28
014 Beaux-Arts,8,0,8,2022,01-18,03:28
015 Les Aubes,6,1,8,2022,01-18,03:28
016 Antigone centre,14,2,16,2022,01-18,03:28
017 M�diath�que Emile Zola,11,5,16,2022,01-18,03:28
018 Nombre d'Or,14,2,16,2022,01-18,03:28
019 Louis Blanc,10,6,16,2022,01-18,03:28
020 Gambetta,4,4,8,2022,01-18,03:28
021 Port Marianne,11,5,16,2022,01-18,03:28
022 Clemenceau,3,9,12,2022,01-18,03:28
023 Les Arceaux,1,15,16,2022,01-18,03:28
024 Cit� Mion,4,4,8,2022,01-18,03:28
025 Nouveau Saint-Roch,5,3,8,2022,01-18,03:28
026 Renouvier,0,8,8,2022,01-18,03:28
027 Odysseum,4,4,8,2022,01-18,03:28
028 Saint-Denis,4,4,8,2022,01-18,03:28
029 Richter,8,8,16,2022,01-18,03:28
030 Charles Flahault,7,1,8,2022,01-18,03:28
031 Voltaire,0,8,8,2022,01-18,03:28
032 Pr�s d'Ar�nes,7,1,8,2022,01-18,03:28
033 Garcia Lorca,7,1,8,2022,01-18,03:28
034 Vert Bois,0,16,16,2022,01-18,03:28
035 Malbosc,1,7,8,2022,01-18,03:28
036 Occitanie,1,31,32,2022,01-18,03:28
037 FacdesSciences,9,15,24,2022,01-18,03:28
038 Fac de Lettres,8,8,16,2022,01-18,03:28
039 Aiguelongue,7,1,8,2022,01-18,03:28
040 Jeu de Mail des Abb�s,8,0,8,2022,01-18,03:28
041 Eurom�decine,1,7,8,2022,01-18,03:28
042 Marie Caizergues,3,5,8,2022,01-18,03:28
043 Sabines,2,6,8,2022,01-18,03:28
044 Celleneuve,1,7,8,2022,01-18,03:28
045 Jardin de la Lironde,8,0,8,2022,01-18,03:28
046 P�re Soulas,5,3,8,2022,01-18,03:28
047 Place Viala,4,4,8,2022,01-18,03:28
048 H�tel du D�partement,0,8,8,2022,01-18,03:28
049 Tonnelles,2,6,8,2022,01-18,03:28
050 Parvis Jules Ferry - Gare Saint-Roch,8,0,8,2022,01-18,03:28
051 Pont de Lattes - Gare Saint-Roch,2,10,12,2022,01-18,03:28
053 Deux Ponts - Gare Saint-Roch,3,5,8,2022,01-18,03:28
054 Providence - Ovalie,5,3,8,2022,01-18,03:28
055 P�rols Etang de l'Or,24,44,68,2022,01-18,03:28
056 Albert 1er - Cath�drale,0,12,12,2022,01-18,03:28
057 Saint-Guilhem - Courreau,3,5,8,2022,01-18,03:28
059 Sud De France,1,7,8,2022,01-18,03:28
001 Rue Jules Ferry - Gare Saint-Roch,9,3,12,2022,01-18,03:38
002 Com�die,4,20,24,2022,01-18,03:38
003 Esplanade,4,28,32,2022,01-18,03:38
004 H�tel de Ville,14,2,16,2022,01-18,03:38
005 Corum,4,8,12,2022,01-18,03:38
006 Place Albert 1er - St Charles,9,22,31,2022,01-18,03:38
007 Foch,1,7,8,2022,01-18,03:38
008 Halles Castellane,0,12,12,2022,01-18,03:38
009 Observatoire,3,5,8,2022,01-18,03:38
010 Rondelet,5,11,16,2022,01-18,03:38
011 Plan Cabanes,7,5,12,2022,01-18,03:38
012 Boutonnet,2,10,12,2022,01-18,03:38
013 Emile Combes,8,0,8,2022,01-18,03:38
014 Beaux-Arts,8,0,8,2022,01-18,03:38
015 Les Aubes,6,1,8,2022,01-18,03:38
016 Antigone centre,16,0,16,2022,01-18,03:38
017 M�diath�que Emile Zola,11,5,16,2022,01-18,03:38
018 Nombre d'Or,14,2,16,2022,01-18,03:38
019 Louis Blanc,8,8,16,2022,01-18,03:38
020 Gambetta,4,4,8,2022,01-18,03:38
021 Port Marianne,11,5,16,2022,01-18,03:38
022 Clemenceau,3,9,12,2022,01-18,03:38
023 Les Arceaux,1,15,16,2022,01-18,03:38
024 Cit� Mion,4,4,8,2022,01-18,03:38
025 Nouveau Saint-Roch,5,3,8,2022,01-18,03:38
026 Renouvier,0,8,8,2022,01-18,03:38
027 Odysseum,4,4,8,2022,01-18,03:38
028 Saint-Denis,4,4,8,2022,01-18,03:38
029 Richter,8,8,16,2022,01-18,03:38
030 Charles Flahault,7,1,8,2022,01-18,03:38
031 Voltaire,0,8,8,2022,01-18,03:38
032 Pr�s d'Ar�nes,7,1,8,2022,01-18,03:38
033 Garcia Lorca,7,1,8,2022,01-18,03:38
034 Vert Bois,0,16,16,2022,01-18,03:38
035 Malbosc,1,7,8,2022,01-18,03:38
036 Occitanie,1,31,32,2022,01-18,03:38
037 FacdesSciences,9,15,24,2022,01-18,03:38
038 Fac de Lettres,8,8,16,2022,01-18,03:38
039 Aiguelongue,7,1,8,2022,01-18,03:38
040 Jeu de Mail des Abb�s,8,0,8,2022,01-18,03:38
041 Eurom�decine,1,7,8,2022,01-18,03:38
042 Marie Caizergues,3,5,8,2022,01-18,03:38
043 Sabines,3,5,8,2022,01-18,03:38
044 Celleneuve,1,7,8,2022,01-18,03:38
045 Jardin de la Lironde,8,0,8,2022,01-18,03:38
046 P�re Soulas,5,3,8,2022,01-18,03:38
047 Place Viala,4,4,8,2022,01-18,03:38
048 H�tel du D�partement,0,8,8,2022,01-18,03:38
049 Tonnelles,2,6,8,2022,01-18,03:38
050 Parvis Jules Ferry - Gare Saint-Roch,8,0,8,2022,01-18,03:38
051 Pont de Lattes - Gare Saint-Roch,2,10,12,2022,01-18,03:38
053 Deux Ponts - Gare Saint-Roch,3,5,8,2022,01-18,03:38
054 Providence - Ovalie,5,3,8,2022,01-18,03:38
055 P�rols Etang de l'Or,24,44,68,2022,01-18,03:38
056 Albert 1er - Cath�drale,0,12,12,2022,01-18,03:38
057 Saint-Guilhem - Courreau,3,5,8,2022,01-18,03:38
059 Sud De France,1,7,8,2022,01-18,03:38
001 Rue Jules Ferry - Gare Saint-Roch,9,3,12,2022,01-18,03:48
002 Com�die,4,20,24,2022,01-18,03:48
003 Esplanade,4,28,32,2022,01-18,03:48
004 H�tel de Ville,14,2,16,2022,01-18,03:48
005 Corum,4,8,12,2022,01-18,03:48
006 Place Albert 1er - St Charles,9,22,31,2022,01-18,03:48
007 Foch,1,7,8,2022,01-18,03:48
008 Halles Castellane,0,12,12,2022,01-18,03:48
009 Observatoire,3,5,8,2022,01-18,03:48
010 Rondelet,5,11,16,2022,01-18,03:48
011 Plan Cabanes,7,5,12,2022,01-18,03:48
012 Boutonnet,2,10,12,2022,01-18,03:48
013 Emile Combes,8,0,8,2022,01-18,03:48
014 Beaux-Arts,8,0,8,2022,01-18,03:48
015 Les Aubes,6,1,8,2022,01-18,03:48
016 Antigone centre,16,0,16,2022,01-18,03:48
017 M�diath�que Emile Zola,11,5,16,2022,01-18,03:48
018 Nombre d'Or,14,2,16,2022,01-18,03:48
019 Louis Blanc,8,8,16,2022,01-18,03:48
020 Gambetta,4,4,8,2022,01-18,03:48
021 Port Marianne,11,5,16,2022,01-18,03:48
022 Clemenceau,3,9,12,2022,01-18,03:48
023 Les Arceaux,1,15,16,2022,01-18,03:48
024 Cit� Mion,4,4,8,2022,01-18,03:48
025 Nouveau Saint-Roch,5,3,8,2022,01-18,03:48
026 Renouvier,0,8,8,2022,01-18,03:48
027 Odysseum,4,4,8,2022,01-18,03:48
028 Saint-Denis,4,4,8,2022,01-18,03:48
029 Richter,8,8,16,2022,01-18,03:48
030 Charles Flahault,7,1,8,2022,01-18,03:48
031 Voltaire,0,8,8,2022,01-18,03:48
032 Pr�s d'Ar�nes,7,1,8,2022,01-18,03:48
033 Garcia Lorca,7,1,8,2022,01-18,03:48
034 Vert Bois,0,16,16,2022,01-18,03:48
035 Malbosc,1,7,8,2022,01-18,03:48
036 Occitanie,1,31,32,2022,01-18,03:48
037 FacdesSciences,9,15,24,2022,01-18,03:48
038 Fac de Lettres,8,8,16,2022,01-18,03:48
039 Aiguelongue,7,1,8,2022,01-18,03:48
040 Jeu de Mail des Abb�s,8,0,8,2022,01-18,03:48
041 Eurom�decine,1,7,8,2022,01-18,03:48
042 Marie Caizergues,3,5,8,2022,01-18,03:48
043 Sabines,3,5,8,2022,01-18,03:48
044 Celleneuve,1,7,8,2022,01-18,03:48
045 Jardin de la Lironde,8,0,8,2022,01-18,03:48
046 P�re Soulas,5,3,8,2022,01-18,03:48
047 Place Viala,4,4,8,2022,01-18,03:48
048 H�tel du D�partement,0,8,8,2022,01-18,03:48
049 Tonnelles,2,6,8,2022,01-18,03:48
050 Parvis Jules Ferry - Gare Saint-Roch,8,0,8,2022,01-18,03:48
051 Pont de Lattes - Gare Saint-Roch,2,10,12,2022,01-18,03:48
053 Deux Ponts - Gare Saint-Roch,3,5,8,2022,01-18,03:48
054 Providence - Ovalie,5,3,8,2022,01-18,03:48
055 P�rols Etang de l'Or,24,44,68,2022,01-18,03:48
056 Albert 1er - Cath�drale,0,12,12,2022,01-18,03:48
057 Saint-Guilhem - Courreau,3,5,8,2022,01-18,03:48
059 Sud De France,1,7,8,2022,01-18,03:48
001 Rue Jules Ferry - Gare Saint-Roch,9,3,12,2022,01-18,03:58
002 Com�die,4,20,24,2022,01-18,03:58
003 Esplanade,4,28,32,2022,01-18,03:58
004 H�tel de Ville,14,2,16,2022,01-18,03:58
005 Corum,4,8,12,2022,01-18,03:58
006 Place Albert 1er - St Charles,9,22,31,2022,01-18,03:58
007 Foch,1,7,8,2022,01-18,03:58
008 Halles Castellane,0,12,12,2022,01-18,03:58
009 Observatoire,3,5,8,2022,01-18,03:58
010 Rondelet,5,11,16,2022,01-18,03:58
011 Plan Cabanes,7,5,12,2022,01-18,03:58
012 Boutonnet,3,9,12,2022,01-18,03:58
013 Emile Combes,8,0,8,2022,01-18,03:58
014 Beaux-Arts,8,0,8,2022,01-18,03:58
015 Les Aubes,6,1,8,2022,01-18,03:58
016 Antigone centre,16,0,16,2022,01-18,03:58
017 M�diath�que Emile Zola,11,5,16,2022,01-18,03:58
018 Nombre d'Or,14,2,16,2022,01-18,03:58
019 Louis Blanc,8,8,16,2022,01-18,03:58
020 Gambetta,4,4,8,2022,01-18,03:58
021 Port Marianne,11,5,16,2022,01-18,03:58
022 Clemenceau,3,9,12,2022,01-18,03:58
023 Les Arceaux,1,15,16,2022,01-18,03:58
024 Cit� Mion,4,4,8,2022,01-18,03:58
025 Nouveau Saint-Roch,5,3,8,2022,01-18,03:58
026 Renouvier,0,8,8,2022,01-18,03:58
027 Odysseum,4,4,8,2022,01-18,03:58
028 Saint-Denis,4,4,8,2022,01-18,03:58
029 Richter,8,8,16,2022,01-18,03:58
030 Charles Flahault,7,1,8,2022,01-18,03:58
031 Voltaire,0,8,8,2022,01-18,03:58
032 Pr�s d'Ar�nes,7,1,8,2022,01-18,03:58
033 Garcia Lorca,7,1,8,2022,01-18,03:58
034 Vert Bois,0,16,16,2022,01-18,03:58
035 Malbosc,1,7,8,2022,01-18,03:58
036 Occitanie,1,31,32,2022,01-18,03:58
037 FacdesSciences,9,15,24,2022,01-18,03:58
038 Fac de Lettres,8,8,16,2022,01-18,03:58
039 Aiguelongue,7,1,8,2022,01-18,03:58
040 Jeu de Mail des Abb�s,8,0,8,2022,01-18,03:58
041 Eurom�decine,1,7,8,2022,01-18,03:58
042 Marie Caizergues,3,5,8,2022,01-18,03:58
043 Sabines,3,5,8,2022,01-18,03:58
044 Celleneuve,1,7,8,2022,01-18,03:58
045 Jardin de la Lironde,8,0,8,2022,01-18,03:58
046 P�re Soulas,5,3,8,2022,01-18,03:58
047 Place Viala,4,4,8,2022,01-18,03:58
048 H�tel du D�partement,0,8,8,2022,01-18,03:58
049 Tonnelles,2,6,8,2022,01-18,03:58
050 Parvis Jules Ferry - Gare Saint-Roch,8,0,8,2022,01-18,03:58
051 Pont de Lattes - Gare Saint-Roch,2,10,12,2022,01-18,03:58
053 Deux Ponts - Gare Saint-Roch,3,5,8,2022,01-18,03:58
054 Providence - Ovalie,5,3,8,2022,01-18,03:58
055 P�rols Etang de l'Or,24,44,68,2022,01-18,03:58
056 Albert 1er - Cath�drale,0,12,12,2022,01-18,03:58
057 Saint-Guilhem - Courreau,2,6,8,2022,01-18,03:58
059 Sud De France,1,7,8,2022,01-18,03:58
001 Rue Jules Ferry - Gare Saint-Roch,9,3,12,2022,01-18,04:08
002 Com�die,4,20,24,2022,01-18,04:08
003 Esplanade,4,28,32,2022,01-18,04:08
004 H�tel de Ville,14,2,16,2022,01-18,04:08
005 Corum,4,8,12,2022,01-18,04:08
006 Place Albert 1er - St Charles,9,22,31,2022,01-18,04:08
007 Foch,1,7,8,2022,01-18,04:08
008 Halles Castellane,0,12,12,2022,01-18,04:08
009 Observatoire,3,5,8,2022,01-18,04:08
010 Rondelet,5,11,16,2022,01-18,04:08
011 Plan Cabanes,7,5,12,2022,01-18,04:08
012 Boutonnet,3,9,12,2022,01-18,04:08
013 Emile Combes,8,0,8,2022,01-18,04:08
014 Beaux-Arts,8,0,8,2022,01-18,04:08
015 Les Aubes,6,1,8,2022,01-18,04:08
016 Antigone centre,16,0,16,2022,01-18,04:08
017 M�diath�que Emile Zola,11,5,16,2022,01-18,04:08
018 Nombre d'Or,14,2,16,2022,01-18,04:08
019 Louis Blanc,9,7,16,2022,01-18,04:08
020 Gambetta,4,4,8,2022,01-18,04:08
021 Port Marianne,11,5,16,2022,01-18,04:08
022 Clemenceau,3,9,12,2022,01-18,04:08
023 Les Arceaux,1,15,16,2022,01-18,04:08
024 Cit� Mion,4,4,8,2022,01-18,04:08
025 Nouveau Saint-Roch,5,3,8,2022,01-18,04:08
026 Renouvier,0,8,8,2022,01-18,04:08
027 Odysseum,4,4,8,2022,01-18,04:08
028 Saint-Denis,4,4,8,2022,01-18,04:08
029 Richter,8,8,16,2022,01-18,04:08
030 Charles Flahault,7,1,8,2022,01-18,04:08
031 Voltaire,0,8,8,2022,01-18,04:08
032 Pr�s d'Ar�nes,7,1,8,2022,01-18,04:08
033 Garcia Lorca,7,1,8,2022,01-18,04:08
034 Vert Bois,0,16,16,2022,01-18,04:08
035 Malbosc,1,7,8,2022,01-18,04:08
036 Occitanie,1,31,32,2022,01-18,04:08
037 FacdesSciences,9,15,24,2022,01-18,04:08
038 Fac de Lettres,8,8,16,2022,01-18,04:08
039 Aiguelongue,7,1,8,2022,01-18,04:08
040 Jeu de Mail des Abb�s,8,0,8,2022,01-18,04:08
041 Eurom�decine,1,7,8,2022,01-18,04:08
042 Marie Caizergues,3,5,8,2022,01-18,04:08
043 Sabines,3,5,8,2022,01-18,04:08
044 Celleneuve,1,7,8,2022,01-18,04:08
045 Jardin de la Lironde,8,0,8,2022,01-18,04:08
046 P�re Soulas,5,3,8,2022,01-18,04:08
047 Place Viala,4,4,8,2022,01-18,04:08
048 H�tel du D�partement,0,8,8,2022,01-18,04:08
049 Tonnelles,2,6,8,2022,01-18,04:08
050 Parvis Jules Ferry - Gare Saint-Roch,8,0,8,2022,01-18,04:08
051 Pont de Lattes - Gare Saint-Roch,2,10,12,2022,01-18,04:08
053 Deux Ponts - Gare Saint-Roch,3,5,8,2022,01-18,04:08
054 Providence - Ovalie,5,3,8,2022,01-18,04:08
055 P�rols Etang de l'Or,24,44,68,2022,01-18,04:08
056 Albert 1er - Cath�drale,0,12,12,2022,01-18,04:08
057 Saint-Guilhem - Courreau,2,6,8,2022,01-18,04:08
059 Sud De France,1,7,8,2022,01-18,04:08
001 Rue Jules Ferry - Gare Saint-Roch,9,3,12,2022,01-18,04:29
002 Com�die,4,20,24,2022,01-18,04:29
003 Esplanade,4,28,32,2022,01-18,04:29
004 H�tel de Ville,14,2,16,2022,01-18,04:29
005 Corum,4,8,12,2022,01-18,04:29
006 Place Albert 1er - St Charles,9,22,31,2022,01-18,04:29
007 Foch,1,7,8,2022,01-18,04:29
008 Halles Castellane,0,12,12,2022,01-18,04:29
009 Observatoire,3,5,8,2022,01-18,04:29
010 Rondelet,5,11,16,2022,01-18,04:29
011 Plan Cabanes,7,5,12,2022,01-18,04:29
012 Boutonnet,3,9,12,2022,01-18,04:29
013 Emile Combes,8,0,8,2022,01-18,04:29
014 Beaux-Arts,8,0,8,2022,01-18,04:29
015 Les Aubes,6,1,8,2022,01-18,04:29
016 Antigone centre,16,0,16,2022,01-18,04:29
017 M�diath�que Emile Zola,11,5,16,2022,01-18,04:29
018 Nombre d'Or,14,2,16,2022,01-18,04:29
019 Louis Blanc,9,7,16,2022,01-18,04:29
020 Gambetta,4,4,8,2022,01-18,04:29
021 Port Marianne,11,5,16,2022,01-18,04:29
022 Clemenceau,3,9,12,2022,01-18,04:29
023 Les Arceaux,1,15,16,2022,01-18,04:29
024 Cit� Mion,4,4,8,2022,01-18,04:29
025 Nouveau Saint-Roch,5,3,8,2022,01-18,04:29
026 Renouvier,0,8,8,2022,01-18,04:29
027 Odysseum,4,4,8,2022,01-18,04:29
028 Saint-Denis,4,4,8,2022,01-18,04:29
029 Richter,8,8,16,2022,01-18,04:29
030 Charles Flahault,7,1,8,2022,01-18,04:29
031 Voltaire,0,8,8,2022,01-18,04:29
032 Pr�s d'Ar�nes,7,1,8,2022,01-18,04:29
033 Garcia Lorca,7,1,8,2022,01-18,04:29
034 Vert Bois,0,16,16,2022,01-18,04:29
035 Malbosc,1,7,8,2022,01-18,04:29
036 Occitanie,1,31,32,2022,01-18,04:29
037 FacdesSciences,9,15,24,2022,01-18,04:29
038 Fac de Lettres,8,8,16,2022,01-18,04:29
039 Aiguelongue,7,1,8,2022,01-18,04:29
040 Jeu de Mail des Abb�s,8,0,8,2022,01-18,04:29
041 Eurom�decine,1,7,8,2022,01-18,04:29
042 Marie Caizergues,3,5,8,2022,01-18,04:29
043 Sabines,3,5,8,2022,01-18,04:29
044 Celleneuve,1,7,8,2022,01-18,04:29
045 Jardin de la Lironde,8,0,8,2022,01-18,04:29
046 P�re Soulas,5,3,8,2022,01-18,04:29
047 Place Viala,4,4,8,2022,01-18,04:29
048 H�tel du D�partement,0,8,8,2022,01-18,04:29
049 Tonnelles,2,6,8,2022,01-18,04:29
050 Parvis Jules Ferry - Gare Saint-Roch,8,0,8,2022,01-18,04:29
051 Pont de Lattes - Gare Saint-Roch,2,10,12,2022,01-18,04:29
053 Deux Ponts - Gare Saint-Roch,3,5,8,2022,01-18,04:29
054 Providence - Ovalie,5,3,8,2022,01-18,04:29
055 P�rols Etang de l'Or,24,44,68,2022,01-18,04:29
056 Albert 1er - Cath�drale,0,12,12,2022,01-18,04:29
057 Saint-Guilhem - Courreau,2,6,8,2022,01-18,04:29
059 Sud De France,1,7,8,2022,01-18,04:29
001 Rue Jules Ferry - Gare Saint-Roch,9,3,12,2022,01-18,04:39
002 Com�die,4,20,24,2022,01-18,04:39
003 Esplanade,4,28,32,2022,01-18,04:39
004 H�tel de Ville,14,2,16,2022,01-18,04:39
005 Corum,4,8,12,2022,01-18,04:39
006 Place Albert 1er - St Charles,9,22,31,2022,01-18,04:39
007 Foch,1,7,8,2022,01-18,04:39
008 Halles Castellane,0,12,12,2022,01-18,04:39
009 Observatoire,3,5,8,2022,01-18,04:39
010 Rondelet,5,11,16,2022,01-18,04:39
011 Plan Cabanes,7,5,12,2022,01-18,04:39
012 Boutonnet,2,10,12,2022,01-18,04:39
013 Emile Combes,8,0,8,2022,01-18,04:39
014 Beaux-Arts,8,0,8,2022,01-18,04:39
015 Les Aubes,6,1,8,2022,01-18,04:39
016 Antigone centre,16,0,16,2022,01-18,04:39
017 M�diath�que Emile Zola,11,5,16,2022,01-18,04:39
018 Nombre d'Or,14,2,16,2022,01-18,04:39
019 Louis Blanc,9,7,16,2022,01-18,04:39
020 Gambetta,4,4,8,2022,01-18,04:39
021 Port Marianne,11,5,16,2022,01-18,04:39
022 Clemenceau,3,9,12,2022,01-18,04:39
023 Les Arceaux,1,15,16,2022,01-18,04:39
024 Cit� Mion,4,4,8,2022,01-18,04:39
025 Nouveau Saint-Roch,5,3,8,2022,01-18,04:39
026 Renouvier,0,8,8,2022,01-18,04:39
027 Odysseum,4,4,8,2022,01-18,04:39
028 Saint-Denis,4,4,8,2022,01-18,04:39
029 Richter,8,8,16,2022,01-18,04:39
030 Charles Flahault,7,1,8,2022,01-18,04:39
031 Voltaire,0,8,8,2022,01-18,04:39
032 Pr�s d'Ar�nes,7,1,8,2022,01-18,04:39
033 Garcia Lorca,7,1,8,2022,01-18,04:39
034 Vert Bois,0,16,16,2022,01-18,04:39
035 Malbosc,1,7,8,2022,01-18,04:39
036 Occitanie,1,31,32,2022,01-18,04:39
037 FacdesSciences,8,16,24,2022,01-18,04:39
038 Fac de Lettres,8,8,16,2022,01-18,04:39
039 Aiguelongue,6,2,8,2022,01-18,04:39
040 Jeu de Mail des Abb�s,8,0,8,2022,01-18,04:39
041 Eurom�decine,1,7,8,2022,01-18,04:39
042 Marie Caizergues,3,5,8,2022,01-18,04:39
043 Sabines,3,5,8,2022,01-18,04:39
044 Celleneuve,1,7,8,2022,01-18,04:39
045 Jardin de la Lironde,8,0,8,2022,01-18,04:39
046 P�re Soulas,5,3,8,2022,01-18,04:39
047 Place Viala,4,4,8,2022,01-18,04:39
048 H�tel du D�partement,0,8,8,2022,01-18,04:39
049 Tonnelles,2,6,8,2022,01-18,04:39
050 Parvis Jules Ferry - Gare Saint-Roch,8,0,8,2022,01-18,04:39
051 Pont de Lattes - Gare Saint-Roch,2,10,12,2022,01-18,04:39
053 Deux Ponts - Gare Saint-Roch,3,5,8,2022,01-18,04:39
054 Providence - Ovalie,5,3,8,2022,01-18,04:39
055 P�rols Etang de l'Or,24,44,68,2022,01-18,04:39
056 Albert 1er - Cath�drale,0,12,12,2022,01-18,04:39
057 Saint-Guilhem - Courreau,2,6,8,2022,01-18,04:39
059 Sud De France,1,7,8,2022,01-18,04:39
001 Rue Jules Ferry - Gare Saint-Roch,9,3,12,2022,01-18,04:49
002 Com�die,4,20,24,2022,01-18,04:49
003 Esplanade,4,28,32,2022,01-18,04:49
004 H�tel de Ville,14,2,16,2022,01-18,04:49
005 Corum,4,8,12,2022,01-18,04:49
006 Place Albert 1er - St Charles,9,22,31,2022,01-18,04:49
007 Foch,1,7,8,2022,01-18,04:49
008 Halles Castellane,0,12,12,2022,01-18,04:49
009 Observatoire,3,5,8,2022,01-18,04:49
010 Rondelet,5,11,16,2022,01-18,04:49
011 Plan Cabanes,7,5,12,2022,01-18,04:49
012 Boutonnet,2,10,12,2022,01-18,04:49
013 Emile Combes,8,0,8,2022,01-18,04:49
014 Beaux-Arts,8,0,8,2022,01-18,04:49
015 Les Aubes,6,1,8,2022,01-18,04:49
016 Antigone centre,16,0,16,2022,01-18,04:49
017 M�diath�que Emile Zola,11,5,16,2022,01-18,04:49
018 Nombre d'Or,14,2,16,2022,01-18,04:49
019 Louis Blanc,9,7,16,2022,01-18,04:49
020 Gambetta,4,4,8,2022,01-18,04:49
021 Port Marianne,11,5,16,2022,01-18,04:49
022 Clemenceau,3,9,12,2022,01-18,04:49
023 Les Arceaux,1,15,16,2022,01-18,04:49
024 Cit� Mion,4,4,8,2022,01-18,04:49
025 Nouveau Saint-Roch,5,3,8,2022,01-18,04:49
026 Renouvier,0,8,8,2022,01-18,04:49
027 Odysseum,4,4,8,2022,01-18,04:49
028 Saint-Denis,4,4,8,2022,01-18,04:49
029 Richter,8,8,16,2022,01-18,04:49
030 Charles Flahault,7,1,8,2022,01-18,04:49
031 Voltaire,0,8,8,2022,01-18,04:49
032 Pr�s d'Ar�nes,7,1,8,2022,01-18,04:49
033 Garcia Lorca,7,1,8,2022,01-18,04:49
034 Vert Bois,0,16,16,2022,01-18,04:49
035 Malbosc,1,7,8,2022,01-18,04:49
036 Occitanie,1,31,32,2022,01-18,04:49
037 FacdesSciences,8,16,24,2022,01-18,04:49
038 Fac de Lettres,8,8,16,2022,01-18,04:49
039 Aiguelongue,6,2,8,2022,01-18,04:49
040 Jeu de Mail des Abb�s,8,0,8,2022,01-18,04:49
041 Eurom�decine,1,7,8,2022,01-18,04:49
042 Marie Caizergues,3,5,8,2022,01-18,04:49
043 Sabines,3,5,8,2022,01-18,04:49
044 Celleneuve,1,7,8,2022,01-18,04:49
045 Jardin de la Lironde,8,0,8,2022,01-18,04:49
046 P�re Soulas,5,3,8,2022,01-18,04:49
047 Place Viala,4,4,8,2022,01-18,04:49
048 H�tel du D�partement,0,8,8,2022,01-18,04:49
049 Tonnelles,2,6,8,2022,01-18,04:49
050 Parvis Jules Ferry - Gare Saint-Roch,8,0,8,2022,01-18,04:49
051 Pont de Lattes - Gare Saint-Roch,2,10,12,2022,01-18,04:49
053 Deux Ponts - Gare Saint-Roch,3,5,8,2022,01-18,04:49
054 Providence - Ovalie,5,3,8,2022,01-18,04:49
055 P�rols Etang de l'Or,24,44,68,2022,01-18,04:49
056 Albert 1er - Cath�drale,0,12,12,2022,01-18,04:49
057 Saint-Guilhem - Courreau,2,6,8,2022,01-18,04:49
059 Sud De France,1,7,8,2022,01-18,04:49
001 Rue Jules Ferry - Gare Saint-Roch,9,3,12,2022,01-18,04:59
002 Com�die,4,20,24,2022,01-18,04:59
003 Esplanade,5,27,32,2022,01-18,04:59
004 H�tel de Ville,14,2,16,2022,01-18,04:59
005 Corum,6,6,12,2022,01-18,04:59
006 Place Albert 1er - St Charles,9,22,31,2022,01-18,04:59
007 Foch,1,7,8,2022,01-18,04:59
008 Halles Castellane,0,12,12,2022,01-18,04:59
009 Observatoire,3,5,8,2022,01-18,04:59
010 Rondelet,5,11,16,2022,01-18,04:59
011 Plan Cabanes,7,5,12,2022,01-18,04:59
012 Boutonnet,2,10,12,2022,01-18,04:59
013 Emile Combes,8,0,8,2022,01-18,04:59
014 Beaux-Arts,8,0,8,2022,01-18,04:59
015 Les Aubes,6,1,8,2022,01-18,04:59
016 Antigone centre,16,0,16,2022,01-18,04:59
017 M�diath�que Emile Zola,11,5,16,2022,01-18,04:59
018 Nombre d'Or,14,2,16,2022,01-18,04:59
019 Louis Blanc,9,7,16,2022,01-18,04:59
020 Gambetta,4,4,8,2022,01-18,04:59
021 Port Marianne,11,5,16,2022,01-18,04:59
022 Clemenceau,3,9,12,2022,01-18,04:59
023 Les Arceaux,1,15,16,2022,01-18,04:59
024 Cit� Mion,4,4,8,2022,01-18,04:59
025 Nouveau Saint-Roch,4,4,8,2022,01-18,04:59
026 Renouvier,0,8,8,2022,01-18,04:59
027 Odysseum,4,4,8,2022,01-18,04:59
028 Saint-Denis,4,4,8,2022,01-18,04:59
029 Richter,8,8,16,2022,01-18,04:59
030 Charles Flahault,7,1,8,2022,01-18,04:59
031 Voltaire,0,8,8,2022,01-18,04:59
032 Pr�s d'Ar�nes,7,1,8,2022,01-18,04:59
033 Garcia Lorca,7,1,8,2022,01-18,04:59
034 Vert Bois,0,16,16,2022,01-18,04:59
035 Malbosc,1,7,8,2022,01-18,04:59
036 Occitanie,1,31,32,2022,01-18,04:59
037 FacdesSciences,8,16,24,2022,01-18,04:59
038 Fac de Lettres,8,8,16,2022,01-18,04:59
039 Aiguelongue,6,2,8,2022,01-18,04:59
040 Jeu de Mail des Abb�s,8,0,8,2022,01-18,04:59
041 Eurom�decine,1,7,8,2022,01-18,04:59
042 Marie Caizergues,3,5,8,2022,01-18,04:59
043 Sabines,3,5,8,2022,01-18,04:59
044 Celleneuve,1,7,8,2022,01-18,04:59
045 Jardin de la Lironde,8,0,8,2022,01-18,04:59
046 P�re Soulas,5,3,8,2022,01-18,04:59
047 Place Viala,4,4,8,2022,01-18,04:59
048 H�tel du D�partement,0,8,8,2022,01-18,04:59
049 Tonnelles,2,6,8,2022,01-18,04:59
050 Parvis Jules Ferry - Gare Saint-Roch,8,0,8,2022,01-18,04:59
051 Pont de Lattes - Gare Saint-Roch,2,10,12,2022,01-18,04:59
053 Deux Ponts - Gare Saint-Roch,3,5,8,2022,01-18,04:59
054 Providence - Ovalie,5,3,8,2022,01-18,04:59
055 P�rols Etang de l'Or,24,44,68,2022,01-18,04:59
056 Albert 1er - Cath�drale,0,12,12,2022,01-18,04:59
057 Saint-Guilhem - Courreau,2,6,8,2022,01-18,04:59
059 Sud De France,1,7,8,2022,01-18,04:59
001 Rue Jules Ferry - Gare Saint-Roch,9,3,12,2022,01-18,05:09
002 Com�die,4,20,24,2022,01-18,05:09
003 Esplanade,5,27,32,2022,01-18,05:09
004 H�tel de Ville,14,2,16,2022,01-18,05:09
005 Corum,6,6,12,2022,01-18,05:09
006 Place Albert 1er - St Charles,9,22,31,2022,01-18,05:09
007 Foch,1,7,8,2022,01-18,05:09
008 Halles Castellane,0,12,12,2022,01-18,05:09
009 Observatoire,3,5,8,2022,01-18,05:09
010 Rondelet,5,11,16,2022,01-18,05:09
011 Plan Cabanes,7,5,12,2022,01-18,05:09
012 Boutonnet,2,10,12,2022,01-18,05:09
013 Emile Combes,8,0,8,2022,01-18,05:09
014 Beaux-Arts,8,0,8,2022,01-18,05:09
015 Les Aubes,6,1,8,2022,01-18,05:09
016 Antigone centre,16,0,16,2022,01-18,05:09
017 M�diath�que Emile Zola,11,5,16,2022,01-18,05:09
018 Nombre d'Or,15,1,16,2022,01-18,05:09
019 Louis Blanc,9,7,16,2022,01-18,05:09
020 Gambetta,4,4,8,2022,01-18,05:09
021 Port Marianne,11,5,16,2022,01-18,05:09
022 Clemenceau,3,9,12,2022,01-18,05:09
023 Les Arceaux,1,15,16,2022,01-18,05:09
024 Cit� Mion,4,4,8,2022,01-18,05:09
025 Nouveau Saint-Roch,4,4,8,2022,01-18,05:09
026 Renouvier,0,8,8,2022,01-18,05:09
027 Odysseum,4,4,8,2022,01-18,05:09
028 Saint-Denis,4,4,8,2022,01-18,05:09
029 Richter,8,8,16,2022,01-18,05:09
030 Charles Flahault,7,1,8,2022,01-18,05:09
031 Voltaire,0,8,8,2022,01-18,05:09
032 Pr�s d'Ar�nes,7,1,8,2022,01-18,05:09
033 Garcia Lorca,7,1,8,2022,01-18,05:09
034 Vert Bois,0,16,16,2022,01-18,05:09
035 Malbosc,1,7,8,2022,01-18,05:09
036 Occitanie,1,31,32,2022,01-18,05:09
037 FacdesSciences,8,16,24,2022,01-18,05:09
038 Fac de Lettres,8,8,16,2022,01-18,05:09
039 Aiguelongue,6,2,8,2022,01-18,05:09
040 Jeu de Mail des Abb�s,8,0,8,2022,01-18,05:09
041 Eurom�decine,1,7,8,2022,01-18,05:09
042 Marie Caizergues,3,5,8,2022,01-18,05:09
043 Sabines,3,5,8,2022,01-18,05:09
044 Celleneuve,1,7,8,2022,01-18,05:09
045 Jardin de la Lironde,8,0,8,2022,01-18,05:09
046 P�re Soulas,5,3,8,2022,01-18,05:09
047 Place Viala,4,4,8,2022,01-18,05:09
048 H�tel du D�partement,0,8,8,2022,01-18,05:09
049 Tonnelles,2,6,8,2022,01-18,05:09
050 Parvis Jules Ferry - Gare Saint-Roch,8,0,8,2022,01-18,05:09
051 Pont de Lattes - Gare Saint-Roch,2,10,12,2022,01-18,05:09
053 Deux Ponts - Gare Saint-Roch,3,5,8,2022,01-18,05:09
054 Providence - Ovalie,5,3,8,2022,01-18,05:09
055 P�rols Etang de l'Or,24,44,68,2022,01-18,05:09
056 Albert 1er - Cath�drale,0,12,12,2022,01-18,05:09
057 Saint-Guilhem - Courreau,2,6,8,2022,01-18,05:09
059 Sud De France,1,7,8,2022,01-18,05:09
001 Rue Jules Ferry - Gare Saint-Roch,9,3,12,2022,01-18,05:20
002 Com�die,4,20,24,2022,01-18,05:20
003 Esplanade,5,27,32,2022,01-18,05:20
004 H�tel de Ville,14,2,16,2022,01-18,05:20
005 Corum,6,6,12,2022,01-18,05:20
006 Place Albert 1er - St Charles,9,22,31,2022,01-18,05:20
007 Foch,1,7,8,2022,01-18,05:20
008 Halles Castellane,0,12,12,2022,01-18,05:20
009 Observatoire,3,5,8,2022,01-18,05:20
010 Rondelet,5,11,16,2022,01-18,05:20
011 Plan Cabanes,7,5,12,2022,01-18,05:20
012 Boutonnet,2,10,12,2022,01-18,05:20
013 Emile Combes,8,0,8,2022,01-18,05:20
014 Beaux-Arts,8,0,8,2022,01-18,05:20
015 Les Aubes,6,1,8,2022,01-18,05:20
016 Antigone centre,16,0,16,2022,01-18,05:20
017 M�diath�que Emile Zola,11,5,16,2022,01-18,05:20
018 Nombre d'Or,15,1,16,2022,01-18,05:20
019 Louis Blanc,9,7,16,2022,01-18,05:20
020 Gambetta,4,4,8,2022,01-18,05:20
021 Port Marianne,11,5,16,2022,01-18,05:20
022 Clemenceau,3,9,12,2022,01-18,05:20
023 Les Arceaux,1,15,16,2022,01-18,05:20
024 Cit� Mion,4,4,8,2022,01-18,05:20
025 Nouveau Saint-Roch,4,4,8,2022,01-18,05:20
026 Renouvier,0,8,8,2022,01-18,05:20
027 Odysseum,4,4,8,2022,01-18,05:20
028 Saint-Denis,4,4,8,2022,01-18,05:20
029 Richter,8,8,16,2022,01-18,05:20
030 Charles Flahault,7,1,8,2022,01-18,05:20
031 Voltaire,0,8,8,2022,01-18,05:20
032 Pr�s d'Ar�nes,7,1,8,2022,01-18,05:20
033 Garcia Lorca,7,1,8,2022,01-18,05:20
034 Vert Bois,0,16,16,2022,01-18,05:20
035 Malbosc,1,7,8,2022,01-18,05:20
036 Occitanie,1,31,32,2022,01-18,05:20
037 FacdesSciences,8,16,24,2022,01-18,05:20
038 Fac de Lettres,8,8,16,2022,01-18,05:20
039 Aiguelongue,5,3,8,2022,01-18,05:20
040 Jeu de Mail des Abb�s,8,0,8,2022,01-18,05:20
041 Eurom�decine,1,7,8,2022,01-18,05:20
042 Marie Caizergues,3,5,8,2022,01-18,05:20
043 Sabines,3,5,8,2022,01-18,05:20
044 Celleneuve,1,7,8,2022,01-18,05:20
045 Jardin de la Lironde,8,0,8,2022,01-18,05:20
046 P�re Soulas,5,3,8,2022,01-18,05:20
047 Place Viala,4,4,8,2022,01-18,05:20
048 H�tel du D�partement,0,8,8,2022,01-18,05:20
049 Tonnelles,2,6,8,2022,01-18,05:20
050 Parvis Jules Ferry - Gare Saint-Roch,8,0,8,2022,01-18,05:20
051 Pont de Lattes - Gare Saint-Roch,2,10,12,2022,01-18,05:20
053 Deux Ponts - Gare Saint-Roch,3,5,8,2022,01-18,05:20
054 Providence - Ovalie,5,3,8,2022,01-18,05:20
055 P�rols Etang de l'Or,24,44,68,2022,01-18,05:20
056 Albert 1er - Cath�drale,0,12,12,2022,01-18,05:20
057 Saint-Guilhem - Courreau,2,6,8,2022,01-18,05:20
059 Sud De France,1,7,8,2022,01-18,05:20
001 Rue Jules Ferry - Gare Saint-Roch,9,3,12,2022,01-18,05:30
002 Com�die,4,20,24,2022,01-18,05:30
003 Esplanade,5,27,32,2022,01-18,05:30
004 H�tel de Ville,14,2,16,2022,01-18,05:30
005 Corum,7,5,12,2022,01-18,05:30
006 Place Albert 1er - St Charles,9,22,31,2022,01-18,05:30
007 Foch,1,7,8,2022,01-18,05:30
008 Halles Castellane,0,12,12,2022,01-18,05:30
009 Observatoire,3,5,8,2022,01-18,05:30
010 Rondelet,5,11,16,2022,01-18,05:30
011 Plan Cabanes,7,5,12,2022,01-18,05:30
012 Boutonnet,2,10,12,2022,01-18,05:30
013 Emile Combes,8,0,8,2022,01-18,05:30
014 Beaux-Arts,8,0,8,2022,01-18,05:30
015 Les Aubes,6,1,8,2022,01-18,05:30
016 Antigone centre,16,0,16,2022,01-18,05:30
017 M�diath�que Emile Zola,11,5,16,2022,01-18,05:30
018 Nombre d'Or,15,1,16,2022,01-18,05:30
019 Louis Blanc,9,7,16,2022,01-18,05:30
020 Gambetta,4,4,8,2022,01-18,05:30
021 Port Marianne,11,5,16,2022,01-18,05:30
022 Clemenceau,3,9,12,2022,01-18,05:30
023 Les Arceaux,1,15,16,2022,01-18,05:30
024 Cit� Mion,4,4,8,2022,01-18,05:30
025 Nouveau Saint-Roch,4,4,8,2022,01-18,05:30
026 Renouvier,0,8,8,2022,01-18,05:30
027 Odysseum,4,4,8,2022,01-18,05:30
028 Saint-Denis,4,4,8,2022,01-18,05:30
029 Richter,8,8,16,2022,01-18,05:30
030 Charles Flahault,7,1,8,2022,01-18,05:30
031 Voltaire,0,8,8,2022,01-18,05:30
032 Pr�s d'Ar�nes,7,1,8,2022,01-18,05:30
033 Garcia Lorca,7,1,8,2022,01-18,05:30
034 Vert Bois,0,16,16,2022,01-18,05:30
035 Malbosc,1,7,8,2022,01-18,05:30
036 Occitanie,1,31,32,2022,01-18,05:30
037 FacdesSciences,8,16,24,2022,01-18,05:30
038 Fac de Lettres,8,8,16,2022,01-18,05:30
039 Aiguelongue,5,3,8,2022,01-18,05:30
040 Jeu de Mail des Abb�s,8,0,8,2022,01-18,05:30
041 Eurom�decine,1,7,8,2022,01-18,05:30
042 Marie Caizergues,3,5,8,2022,01-18,05:30
043 Sabines,3,5,8,2022,01-18,05:30
044 Celleneuve,1,7,8,2022,01-18,05:30
045 Jardin de la Lironde,8,0,8,2022,01-18,05:30
046 P�re Soulas,5,3,8,2022,01-18,05:30
047 Place Viala,4,4,8,2022,01-18,05:30
048 H�tel du D�partement,0,8,8,2022,01-18,05:30
049 Tonnelles,2,6,8,2022,01-18,05:30
050 Parvis Jules Ferry - Gare Saint-Roch,8,0,8,2022,01-18,05:30
051 Pont de Lattes - Gare Saint-Roch,2,10,12,2022,01-18,05:30
053 Deux Ponts - Gare Saint-Roch,3,5,8,2022,01-18,05:30
054 Providence - Ovalie,5,3,8,2022,01-18,05:30
055 P�rols Etang de l'Or,24,44,68,2022,01-18,05:30
056 Albert 1er - Cath�drale,0,12,12,2022,01-18,05:30
057 Saint-Guilhem - Courreau,1,7,8,2022,01-18,05:30
059 Sud De France,1,7,8,2022,01-18,05:30
001 Rue Jules Ferry - Gare Saint-Roch,9,3,12,2022,01-18,05:40
002 Com�die,4,20,24,2022,01-18,05:40
003 Esplanade,5,27,32,2022,01-18,05:40
004 H�tel de Ville,14,2,16,2022,01-18,05:40
005 Corum,7,5,12,2022,01-18,05:40
006 Place Albert 1er - St Charles,9,22,31,2022,01-18,05:40
007 Foch,1,7,8,2022,01-18,05:40
008 Halles Castellane,0,12,12,2022,01-18,05:40
009 Observatoire,3,5,8,2022,01-18,05:40
010 Rondelet,5,11,16,2022,01-18,05:40
011 Plan Cabanes,7,5,12,2022,01-18,05:40
012 Boutonnet,2,10,12,2022,01-18,05:40
013 Emile Combes,8,0,8,2022,01-18,05:40
014 Beaux-Arts,8,0,8,2022,01-18,05:40
015 Les Aubes,6,1,8,2022,01-18,05:40
016 Antigone centre,16,0,16,2022,01-18,05:40
017 M�diath�que Emile Zola,11,5,16,2022,01-18,05:40
018 Nombre d'Or,15,1,16,2022,01-18,05:40
019 Louis Blanc,9,7,16,2022,01-18,05:40
020 Gambetta,4,4,8,2022,01-18,05:40
021 Port Marianne,11,5,16,2022,01-18,05:40
022 Clemenceau,3,9,12,2022,01-18,05:40
023 Les Arceaux,1,15,16,2022,01-18,05:40
024 Cit� Mion,4,4,8,2022,01-18,05:40
025 Nouveau Saint-Roch,4,4,8,2022,01-18,05:40
026 Renouvier,0,8,8,2022,01-18,05:40
027 Odysseum,4,4,8,2022,01-18,05:40
028 Saint-Denis,4,4,8,2022,01-18,05:40
029 Richter,8,8,16,2022,01-18,05:40
030 Charles Flahault,7,1,8,2022,01-18,05:40
031 Voltaire,0,8,8,2022,01-18,05:40
032 Pr�s d'Ar�nes,7,1,8,2022,01-18,05:40
033 Garcia Lorca,7,1,8,2022,01-18,05:40
034 Vert Bois,0,16,16,2022,01-18,05:40
035 Malbosc,1,7,8,2022,01-18,05:40
036 Occitanie,2,30,32,2022,01-18,05:40
037 FacdesSciences,8,16,24,2022,01-18,05:40
038 Fac de Lettres,8,8,16,2022,01-18,05:40
039 Aiguelongue,5,3,8,2022,01-18,05:40
040 Jeu de Mail des Abb�s,8,0,8,2022,01-18,05:40
041 Eurom�decine,1,7,8,2022,01-18,05:40
042 Marie Caizergues,3,5,8,2022,01-18,05:40
043 Sabines,3,5,8,2022,01-18,05:40
044 Celleneuve,1,7,8,2022,01-18,05:40
045 Jardin de la Lironde,8,0,8,2022,01-18,05:40
046 P�re Soulas,5,3,8,2022,01-18,05:40
047 Place Viala,4,4,8,2022,01-18,05:40
048 H�tel du D�partement,0,8,8,2022,01-18,05:40
049 Tonnelles,2,6,8,2022,01-18,05:40
050 Parvis Jules Ferry - Gare Saint-Roch,8,0,8,2022,01-18,05:40
051 Pont de Lattes - Gare Saint-Roch,2,10,12,2022,01-18,05:40
053 Deux Ponts - Gare Saint-Roch,3,5,8,2022,01-18,05:40
054 Providence - Ovalie,5,3,8,2022,01-18,05:40
055 P�rols Etang de l'Or,24,44,68,2022,01-18,05:40
056 Albert 1er - Cath�drale,0,12,12,2022,01-18,05:40
057 Saint-Guilhem - Courreau,1,7,8,2022,01-18,05:40
059 Sud De France,1,7,8,2022,01-18,05:40
001 Rue Jules Ferry - Gare Saint-Roch,10,2,12,2022,01-18,05:50
002 Com�die,4,20,24,2022,01-18,05:50
003 Esplanade,5,27,32,2022,01-18,05:50
004 H�tel de Ville,14,2,16,2022,01-18,05:50
005 Corum,7,5,12,2022,01-18,05:50
006 Place Albert 1er - St Charles,9,22,31,2022,01-18,05:50
007 Foch,1,7,8,2022,01-18,05:50
008 Halles Castellane,0,12,12,2022,01-18,05:50
009 Observatoire,3,5,8,2022,01-18,05:50
010 Rondelet,5,11,16,2022,01-18,05:50
011 Plan Cabanes,7,5,12,2022,01-18,05:50
012 Boutonnet,2,10,12,2022,01-18,05:50
013 Emile Combes,8,0,8,2022,01-18,05:50
014 Beaux-Arts,8,0,8,2022,01-18,05:50
015 Les Aubes,6,1,8,2022,01-18,05:50
016 Antigone centre,16,0,16,2022,01-18,05:50
017 M�diath�que Emile Zola,11,5,16,2022,01-18,05:50
018 Nombre d'Or,15,1,16,2022,01-18,05:50
019 Louis Blanc,9,7,16,2022,01-18,05:50
020 Gambetta,4,4,8,2022,01-18,05:50
021 Port Marianne,11,5,16,2022,01-18,05:50
022 Clemenceau,3,9,12,2022,01-18,05:50
023 Les Arceaux,1,15,16,2022,01-18,05:50
024 Cit� Mion,4,4,8,2022,01-18,05:50
025 Nouveau Saint-Roch,4,4,8,2022,01-18,05:50
026 Renouvier,0,8,8,2022,01-18,05:50
027 Odysseum,4,4,8,2022,01-18,05:50
028 Saint-Denis,4,4,8,2022,01-18,05:50
029 Richter,8,8,16,2022,01-18,05:50
030 Charles Flahault,7,1,8,2022,01-18,05:50
031 Voltaire,0,8,8,2022,01-18,05:50
032 Pr�s d'Ar�nes,7,1,8,2022,01-18,05:50
033 Garcia Lorca,7,1,8,2022,01-18,05:50
034 Vert Bois,0,16,16,2022,01-18,05:50
035 Malbosc,1,7,8,2022,01-18,05:50
036 Occitanie,2,30,32,2022,01-18,05:50
037 FacdesSciences,8,16,24,2022,01-18,05:50
038 Fac de Lettres,8,8,16,2022,01-18,05:50
039 Aiguelongue,5,3,8,2022,01-18,05:50
040 Jeu de Mail des Abb�s,8,0,8,2022,01-18,05:50
041 Eurom�decine,1,7,8,2022,01-18,05:50
042 Marie Caizergues,3,5,8,2022,01-18,05:50
043 Sabines,3,5,8,2022,01-18,05:50
044 Celleneuve,1,7,8,2022,01-18,05:50
045 Jardin de la Lironde,8,0,8,2022,01-18,05:50
046 P�re Soulas,5,3,8,2022,01-18,05:50
047 Place Viala,4,4,8,2022,01-18,05:50
048 H�tel du D�partement,0,8,8,2022,01-18,05:50
049 Tonnelles,2,6,8,2022,01-18,05:50
050 Parvis Jules Ferry - Gare Saint-Roch,8,0,8,2022,01-18,05:50
051 Pont de Lattes - Gare Saint-Roch,2,10,12,2022,01-18,05:50
053 Deux Ponts - Gare Saint-Roch,3,5,8,2022,01-18,05:50
054 Providence - Ovalie,5,3,8,2022,01-18,05:50
055 P�rols Etang de l'Or,24,44,68,2022,01-18,05:50
056 Albert 1er - Cath�drale,0,12,12,2022,01-18,05:50
057 Saint-Guilhem - Courreau,1,7,8,2022,01-18,05:50
059 Sud De France,1,7,8,2022,01-18,05:50
001 Rue Jules Ferry - Gare Saint-Roch,10,2,12,2022,01-18,06:00
002 Com�die,4,20,24,2022,01-18,06:00
003 Esplanade,5,27,32,2022,01-18,06:00
004 H�tel de Ville,14,2,16,2022,01-18,06:00
005 Corum,7,5,12,2022,01-18,06:00
006 Place Albert 1er - St Charles,9,22,31,2022,01-18,06:00
007 Foch,1,7,8,2022,01-18,06:00
008 Halles Castellane,0,12,12,2022,01-18,06:00
009 Observatoire,3,5,8,2022,01-18,06:00
010 Rondelet,5,11,16,2022,01-18,06:00
011 Plan Cabanes,7,5,12,2022,01-18,06:00
012 Boutonnet,2,10,12,2022,01-18,06:00
013 Emile Combes,8,0,8,2022,01-18,06:00
014 Beaux-Arts,8,0,8,2022,01-18,06:00
015 Les Aubes,6,1,8,2022,01-18,06:00
016 Antigone centre,16,0,16,2022,01-18,06:00
017 M�diath�que Emile Zola,11,5,16,2022,01-18,06:00
018 Nombre d'Or,15,1,16,2022,01-18,06:00
019 Louis Blanc,9,7,16,2022,01-18,06:00
020 Gambetta,4,4,8,2022,01-18,06:00
021 Port Marianne,11,5,16,2022,01-18,06:00
022 Clemenceau,3,9,12,2022,01-18,06:00
023 Les Arceaux,1,15,16,2022,01-18,06:00
024 Cit� Mion,4,4,8,2022,01-18,06:00
025 Nouveau Saint-Roch,4,4,8,2022,01-18,06:00
026 Renouvier,0,8,8,2022,01-18,06:00
027 Odysseum,4,4,8,2022,01-18,06:00
028 Saint-Denis,4,4,8,2022,01-18,06:00
029 Richter,8,8,16,2022,01-18,06:00
030 Charles Flahault,7,1,8,2022,01-18,06:00
031 Voltaire,0,8,8,2022,01-18,06:00
032 Pr�s d'Ar�nes,7,1,8,2022,01-18,06:00
033 Garcia Lorca,7,1,8,2022,01-18,06:00
034 Vert Bois,0,16,16,2022,01-18,06:00
035 Malbosc,1,7,8,2022,01-18,06:00
036 Occitanie,2,30,32,2022,01-18,06:00
037 FacdesSciences,8,16,24,2022,01-18,06:00
038 Fac de Lettres,8,8,16,2022,01-18,06:00
039 Aiguelongue,4,4,8,2022,01-18,06:00
040 Jeu de Mail des Abb�s,8,0,8,2022,01-18,06:00
041 Eurom�decine,1,7,8,2022,01-18,06:00
042 Marie Caizergues,3,5,8,2022,01-18,06:00
043 Sabines,3,5,8,2022,01-18,06:00
044 Celleneuve,1,7,8,2022,01-18,06:00
045 Jardin de la Lironde,8,0,8,2022,01-18,06:00
046 P�re Soulas,5,3,8,2022,01-18,06:00
047 Place Viala,4,4,8,2022,01-18,06:00
048 H�tel du D�partement,0,8,8,2022,01-18,06:00
049 Tonnelles,2,6,8,2022,01-18,06:00
050 Parvis Jules Ferry - Gare Saint-Roch,8,0,8,2022,01-18,06:00
051 Pont de Lattes - Gare Saint-Roch,2,10,12,2022,01-18,06:00
053 Deux Ponts - Gare Saint-Roch,3,5,8,2022,01-18,06:00
054 Providence - Ovalie,5,3,8,2022,01-18,06:00
055 P�rols Etang de l'Or,24,44,68,2022,01-18,06:00
056 Albert 1er - Cath�drale,0,12,12,2022,01-18,06:00
057 Saint-Guilhem - Courreau,1,7,8,2022,01-18,06:00
059 Sud De France,1,7,8,2022,01-18,06:00
001 Rue Jules Ferry - Gare Saint-Roch,11,1,12,2022,01-18,06:10
002 Com�die,4,20,24,2022,01-18,06:10
003 Esplanade,5,27,32,2022,01-18,06:10
004 H�tel de Ville,14,2,16,2022,01-18,06:10
005 Corum,7,5,12,2022,01-18,06:10
006 Place Albert 1er - St Charles,9,22,31,2022,01-18,06:10
007 Foch,1,7,8,2022,01-18,06:10
008 Halles Castellane,0,12,12,2022,01-18,06:10
009 Observatoire,3,5,8,2022,01-18,06:10
010 Rondelet,5,11,16,2022,01-18,06:10
011 Plan Cabanes,5,7,12,2022,01-18,06:10
012 Boutonnet,2,10,12,2022,01-18,06:10
013 Emile Combes,8,0,8,2022,01-18,06:10
014 Beaux-Arts,8,0,8,2022,01-18,06:10
015 Les Aubes,6,1,8,2022,01-18,06:10
016 Antigone centre,16,0,16,2022,01-18,06:10
017 M�diath�que Emile Zola,11,5,16,2022,01-18,06:10
018 Nombre d'Or,15,1,16,2022,01-18,06:10
019 Louis Blanc,9,7,16,2022,01-18,06:10
020 Gambetta,4,4,8,2022,01-18,06:10
021 Port Marianne,11,5,16,2022,01-18,06:10
022 Clemenceau,3,9,12,2022,01-18,06:10
023 Les Arceaux,1,15,16,2022,01-18,06:10
024 Cit� Mion,4,4,8,2022,01-18,06:10
025 Nouveau Saint-Roch,4,4,8,2022,01-18,06:10
026 Renouvier,0,8,8,2022,01-18,06:10
027 Odysseum,4,4,8,2022,01-18,06:10
028 Saint-Denis,4,4,8,2022,01-18,06:10
029 Richter,8,8,16,2022,01-18,06:10
030 Charles Flahault,7,1,8,2022,01-18,06:10
031 Voltaire,0,8,8,2022,01-18,06:10
032 Pr�s d'Ar�nes,7,1,8,2022,01-18,06:10
033 Garcia Lorca,7,1,8,2022,01-18,06:10
034 Vert Bois,0,16,16,2022,01-18,06:10
035 Malbosc,1,7,8,2022,01-18,06:10
036 Occitanie,2,30,32,2022,01-18,06:10
037 FacdesSciences,8,16,24,2022,01-18,06:10
038 Fac de Lettres,8,8,16,2022,01-18,06:10
039 Aiguelongue,4,4,8,2022,01-18,06:10
040 Jeu de Mail des Abb�s,8,0,8,2022,01-18,06:10
041 Eurom�decine,1,7,8,2022,01-18,06:10
042 Marie Caizergues,3,5,8,2022,01-18,06:10
043 Sabines,3,5,8,2022,01-18,06:10
044 Celleneuve,1,7,8,2022,01-18,06:10
045 Jardin de la Lironde,8,0,8,2022,01-18,06:10
046 P�re Soulas,5,3,8,2022,01-18,06:10
047 Place Viala,4,4,8,2022,01-18,06:10
048 H�tel du D�partement,0,8,8,2022,01-18,06:10
049 Tonnelles,2,6,8,2022,01-18,06:10
050 Parvis Jules Ferry - Gare Saint-Roch,8,0,8,2022,01-18,06:10
051 Pont de Lattes - Gare Saint-Roch,2,10,12,2022,01-18,06:10
053 Deux Ponts - Gare Saint-Roch,3,5,8,2022,01-18,06:10
054 Providence - Ovalie,5,3,8,2022,01-18,06:10
055 P�rols Etang de l'Or,24,44,68,2022,01-18,06:10
056 Albert 1er - Cath�drale,0,12,12,2022,01-18,06:10
057 Saint-Guilhem - Courreau,1,7,8,2022,01-18,06:10
059 Sud De France,1,7,8,2022,01-18,06:10
001 Rue Jules Ferry - Gare Saint-Roch,11,1,12,2022,01-18,06:21
002 Com�die,4,20,24,2022,01-18,06:21
003 Esplanade,5,27,32,2022,01-18,06:21
004 H�tel de Ville,14,2,16,2022,01-18,06:21
005 Corum,6,6,12,2022,01-18,06:21
006 Place Albert 1er - St Charles,9,22,31,2022,01-18,06:21
007 Foch,1,7,8,2022,01-18,06:21
008 Halles Castellane,0,12,12,2022,01-18,06:21
009 Observatoire,3,5,8,2022,01-18,06:21
010 Rondelet,5,11,16,2022,01-18,06:21
011 Plan Cabanes,5,7,12,2022,01-18,06:21
012 Boutonnet,2,10,12,2022,01-18,06:21
013 Emile Combes,8,0,8,2022,01-18,06:21
014 Beaux-Arts,8,0,8,2022,01-18,06:21
015 Les Aubes,6,1,8,2022,01-18,06:21
016 Antigone centre,16,0,16,2022,01-18,06:21
017 M�diath�que Emile Zola,11,5,16,2022,01-18,06:21
018 Nombre d'Or,15,1,16,2022,01-18,06:21
019 Louis Blanc,9,7,16,2022,01-18,06:21
020 Gambetta,4,4,8,2022,01-18,06:21
021 Port Marianne,11,5,16,2022,01-18,06:21
022 Clemenceau,3,9,12,2022,01-18,06:21
023 Les Arceaux,1,15,16,2022,01-18,06:21
024 Cit� Mion,4,4,8,2022,01-18,06:21
025 Nouveau Saint-Roch,4,4,8,2022,01-18,06:21
026 Renouvier,0,8,8,2022,01-18,06:21
027 Odysseum,4,4,8,2022,01-18,06:21
028 Saint-Denis,4,4,8,2022,01-18,06:21
029 Richter,8,8,16,2022,01-18,06:21
030 Charles Flahault,7,1,8,2022,01-18,06:21
031 Voltaire,0,8,8,2022,01-18,06:21
032 Pr�s d'Ar�nes,7,1,8,2022,01-18,06:21
033 Garcia Lorca,7,1,8,2022,01-18,06:21
034 Vert Bois,0,16,16,2022,01-18,06:21
035 Malbosc,1,7,8,2022,01-18,06:21
036 Occitanie,2,30,32,2022,01-18,06:21
037 FacdesSciences,9,15,24,2022,01-18,06:21
038 Fac de Lettres,8,8,16,2022,01-18,06:21
039 Aiguelongue,4,4,8,2022,01-18,06:21
040 Jeu de Mail des Abb�s,8,0,8,2022,01-18,06:21
041 Eurom�decine,1,7,8,2022,01-18,06:21
042 Marie Caizergues,3,5,8,2022,01-18,06:21
043 Sabines,3,5,8,2022,01-18,06:21
044 Celleneuve,1,7,8,2022,01-18,06:21
045 Jardin de la Lironde,8,0,8,2022,01-18,06:21
046 P�re Soulas,5,3,8,2022,01-18,06:21
047 Place Viala,4,4,8,2022,01-18,06:21
048 H�tel du D�partement,0,8,8,2022,01-18,06:21
049 Tonnelles,2,6,8,2022,01-18,06:21
050 Parvis Jules Ferry - Gare Saint-Roch,8,0,8,2022,01-18,06:21
051 Pont de Lattes - Gare Saint-Roch,2,10,12,2022,01-18,06:21
053 Deux Ponts - Gare Saint-Roch,3,5,8,2022,01-18,06:21
054 Providence - Ovalie,5,3,8,2022,01-18,06:21
055 P�rols Etang de l'Or,24,44,68,2022,01-18,06:21
056 Albert 1er - Cath�drale,0,12,12,2022,01-18,06:21
057 Saint-Guilhem - Courreau,1,7,8,2022,01-18,06:21
059 Sud De France,1,7,8,2022,01-18,06:21
001 Rue Jules Ferry - Gare Saint-Roch,11,1,12,2022,01-18,06:31
002 Com�die,4,20,24,2022,01-18,06:31
003 Esplanade,5,27,32,2022,01-18,06:31
004 H�tel de Ville,14,2,16,2022,01-18,06:31
005 Corum,6,6,12,2022,01-18,06:31
006 Place Albert 1er - St Charles,9,22,31,2022,01-18,06:31
007 Foch,1,7,8,2022,01-18,06:31
008 Halles Castellane,0,12,12,2022,01-18,06:31
009 Observatoire,3,5,8,2022,01-18,06:31
010 Rondelet,5,11,16,2022,01-18,06:31
011 Plan Cabanes,5,7,12,2022,01-18,06:31
012 Boutonnet,2,10,12,2022,01-18,06:31
013 Emile Combes,8,0,8,2022,01-18,06:31
014 Beaux-Arts,8,0,8,2022,01-18,06:31
015 Les Aubes,6,1,8,2022,01-18,06:31
016 Antigone centre,6,10,16,2022,01-18,06:31
017 M�diath�que Emile Zola,11,5,16,2022,01-18,06:31
018 Nombre d'Or,15,1,16,2022,01-18,06:31
019 Louis Blanc,9,7,16,2022,01-18,06:31
020 Gambetta,4,4,8,2022,01-18,06:31
021 Port Marianne,11,5,16,2022,01-18,06:31
022 Clemenceau,3,9,12,2022,01-18,06:31
023 Les Arceaux,1,15,16,2022,01-18,06:31
024 Cit� Mion,4,4,8,2022,01-18,06:31
025 Nouveau Saint-Roch,4,4,8,2022,01-18,06:31
026 Renouvier,0,8,8,2022,01-18,06:31
027 Odysseum,4,4,8,2022,01-18,06:31
028 Saint-Denis,4,4,8,2022,01-18,06:31
029 Richter,8,8,16,2022,01-18,06:31
030 Charles Flahault,7,1,8,2022,01-18,06:31
031 Voltaire,0,8,8,2022,01-18,06:31
032 Pr�s d'Ar�nes,7,1,8,2022,01-18,06:31
033 Garcia Lorca,7,1,8,2022,01-18,06:31
034 Vert Bois,0,16,16,2022,01-18,06:31
035 Malbosc,1,7,8,2022,01-18,06:31
036 Occitanie,2,30,32,2022,01-18,06:31
037 FacdesSciences,9,15,24,2022,01-18,06:31
038 Fac de Lettres,8,8,16,2022,01-18,06:31
039 Aiguelongue,4,4,8,2022,01-18,06:31
040 Jeu de Mail des Abb�s,8,0,8,2022,01-18,06:31
041 Eurom�decine,1,7,8,2022,01-18,06:31
042 Marie Caizergues,3,5,8,2022,01-18,06:31
043 Sabines,3,5,8,2022,01-18,06:31
044 Celleneuve,1,7,8,2022,01-18,06:31
045 Jardin de la Lironde,8,0,8,2022,01-18,06:31
046 P�re Soulas,5,3,8,2022,01-18,06:31
047 Place Viala,4,4,8,2022,01-18,06:31
048 H�tel du D�partement,0,8,8,2022,01-18,06:31
049 Tonnelles,1,7,8,2022,01-18,06:31
050 Parvis Jules Ferry - Gare Saint-Roch,8,0,8,2022,01-18,06:31
051 Pont de Lattes - Gare Saint-Roch,3,9,12,2022,01-18,06:31
053 Deux Ponts - Gare Saint-Roch,3,5,8,2022,01-18,06:31
054 Providence - Ovalie,5,3,8,2022,01-18,06:31
055 P�rols Etang de l'Or,24,44,68,2022,01-18,06:31
056 Albert 1er - Cath�drale,0,12,12,2022,01-18,06:31
057 Saint-Guilhem - Courreau,1,7,8,2022,01-18,06:31
059 Sud De France,1,7,8,2022,01-18,06:31
001 Rue Jules Ferry - Gare Saint-Roch,11,1,12,2022,01-18,06:41
002 Com�die,13,11,24,2022,01-18,06:41
003 Esplanade,5,27,32,2022,01-18,06:41
004 H�tel de Ville,14,2,16,2022,01-18,06:41
005 Corum,6,6,12,2022,01-18,06:41
006 Place Albert 1er - St Charles,9,22,31,2022,01-18,06:41
007 Foch,1,7,8,2022,01-18,06:41
008 Halles Castellane,0,12,12,2022,01-18,06:41
009 Observatoire,4,4,8,2022,01-18,06:41
010 Rondelet,6,10,16,2022,01-18,06:41
011 Plan Cabanes,5,7,12,2022,01-18,06:41
012 Boutonnet,2,10,12,2022,01-18,06:41
013 Emile Combes,8,0,8,2022,01-18,06:41
014 Beaux-Arts,8,0,8,2022,01-18,06:41
015 Les Aubes,6,1,8,2022,01-18,06:41
016 Antigone centre,5,11,16,2022,01-18,06:41
017 M�diath�que Emile Zola,11,5,16,2022,01-18,06:41
018 Nombre d'Or,15,1,16,2022,01-18,06:41
019 Louis Blanc,9,7,16,2022,01-18,06:41
020 Gambetta,3,5,8,2022,01-18,06:41
021 Port Marianne,11,5,16,2022,01-18,06:41
022 Clemenceau,3,9,12,2022,01-18,06:41
023 Les Arceaux,1,15,16,2022,01-18,06:41
024 Cit� Mion,4,4,8,2022,01-18,06:41
025 Nouveau Saint-Roch,4,4,8,2022,01-18,06:41
026 Renouvier,0,8,8,2022,01-18,06:41
027 Odysseum,4,4,8,2022,01-18,06:41
028 Saint-Denis,4,4,8,2022,01-18,06:41
029 Richter,8,8,16,2022,01-18,06:41
030 Charles Flahault,7,1,8,2022,01-18,06:41
031 Voltaire,0,8,8,2022,01-18,06:41
032 Pr�s d'Ar�nes,7,1,8,2022,01-18,06:41
033 Garcia Lorca,7,1,8,2022,01-18,06:41
034 Vert Bois,0,16,16,2022,01-18,06:41
035 Malbosc,1,7,8,2022,01-18,06:41
036 Occitanie,2,30,32,2022,01-18,06:41
037 FacdesSciences,9,15,24,2022,01-18,06:41
038 Fac de Lettres,8,8,16,2022,01-18,06:41
039 Aiguelongue,4,4,8,2022,01-18,06:41
040 Jeu de Mail des Abb�s,8,0,8,2022,01-18,06:41
041 Eurom�decine,1,7,8,2022,01-18,06:41
042 Marie Caizergues,3,5,8,2022,01-18,06:41
043 Sabines,3,5,8,2022,01-18,06:41
044 Celleneuve,1,7,8,2022,01-18,06:41
045 Jardin de la Lironde,8,0,8,2022,01-18,06:41
046 P�re Soulas,5,3,8,2022,01-18,06:41
047 Place Viala,4,4,8,2022,01-18,06:41
048 H�tel du D�partement,0,8,8,2022,01-18,06:41
049 Tonnelles,1,7,8,2022,01-18,06:41
050 Parvis Jules Ferry - Gare Saint-Roch,8,0,8,2022,01-18,06:41
051 Pont de Lattes - Gare Saint-Roch,3,9,12,2022,01-18,06:41
053 Deux Ponts - Gare Saint-Roch,3,5,8,2022,01-18,06:41
054 Providence - Ovalie,5,3,8,2022,01-18,06:41
055 P�rols Etang de l'Or,24,44,68,2022,01-18,06:41
056 Albert 1er - Cath�drale,0,12,12,2022,01-18,06:41
057 Saint-Guilhem - Courreau,1,7,8,2022,01-18,06:41
059 Sud De France,1,7,8,2022,01-18,06:41
001 Rue Jules Ferry - Gare Saint-Roch,11,1,12,2022,01-18,06:51
002 Com�die,15,9,24,2022,01-18,06:51
003 Esplanade,5,27,32,2022,01-18,06:51
004 H�tel de Ville,14,2,16,2022,01-18,06:51
005 Corum,6,6,12,2022,01-18,06:51
006 Place Albert 1er - St Charles,9,22,31,2022,01-18,06:51
007 Foch,1,7,8,2022,01-18,06:51
008 Halles Castellane,0,12,12,2022,01-18,06:51
009 Observatoire,4,4,8,2022,01-18,06:51
010 Rondelet,6,10,16,2022,01-18,06:51
011 Plan Cabanes,5,7,12,2022,01-18,06:51
012 Boutonnet,2,10,12,2022,01-18,06:51
013 Emile Combes,8,0,8,2022,01-18,06:51
014 Beaux-Arts,3,5,8,2022,01-18,06:51
015 Les Aubes,6,1,8,2022,01-18,06:51
016 Antigone centre,5,11,16,2022,01-18,06:51
017 M�diath�que Emile Zola,11,5,16,2022,01-18,06:51
018 Nombre d'Or,15,1,16,2022,01-18,06:51
019 Louis Blanc,9,7,16,2022,01-18,06:51
020 Gambetta,3,5,8,2022,01-18,06:51
021 Port Marianne,11,5,16,2022,01-18,06:51
022 Clemenceau,3,9,12,2022,01-18,06:51
023 Les Arceaux,1,15,16,2022,01-18,06:51
024 Cit� Mion,4,4,8,2022,01-18,06:51
025 Nouveau Saint-Roch,4,4,8,2022,01-18,06:51
026 Renouvier,0,8,8,2022,01-18,06:51
027 Odysseum,4,4,8,2022,01-18,06:51
028 Saint-Denis,4,4,8,2022,01-18,06:51
029 Richter,8,8,16,2022,01-18,06:51
030 Charles Flahault,7,1,8,2022,01-18,06:51
031 Voltaire,0,8,8,2022,01-18,06:51
032 Pr�s d'Ar�nes,7,1,8,2022,01-18,06:51
033 Garcia Lorca,7,1,8,2022,01-18,06:51
034 Vert Bois,0,16,16,2022,01-18,06:51
035 Malbosc,1,7,8,2022,01-18,06:51
036 Occitanie,2,30,32,2022,01-18,06:51
037 FacdesSciences,10,14,24,2022,01-18,06:51
038 Fac de Lettres,8,8,16,2022,01-18,06:51
039 Aiguelongue,4,4,8,2022,01-18,06:51
040 Jeu de Mail des Abb�s,8,0,8,2022,01-18,06:51
041 Eurom�decine,1,7,8,2022,01-18,06:51
042 Marie Caizergues,3,5,8,2022,01-18,06:51
043 Sabines,3,5,8,2022,01-18,06:51
044 Celleneuve,1,7,8,2022,01-18,06:51
045 Jardin de la Lironde,8,0,8,2022,01-18,06:51
046 P�re Soulas,5,3,8,2022,01-18,06:51
047 Place Viala,4,4,8,2022,01-18,06:51
048 H�tel du D�partement,0,8,8,2022,01-18,06:51
049 Tonnelles,1,7,8,2022,01-18,06:51
050 Parvis Jules Ferry - Gare Saint-Roch,8,0,8,2022,01-18,06:51
051 Pont de Lattes - Gare Saint-Roch,3,9,12,2022,01-18,06:51
053 Deux Ponts - Gare Saint-Roch,3,5,8,2022,01-18,06:51
054 Providence - Ovalie,5,3,8,2022,01-18,06:51
055 P�rols Etang de l'Or,24,44,68,2022,01-18,06:51
056 Albert 1er - Cath�drale,0,12,12,2022,01-18,06:51
057 Saint-Guilhem - Courreau,1,7,8,2022,01-18,06:51
059 Sud De France,1,7,8,2022,01-18,06:51
001 Rue Jules Ferry - Gare Saint-Roch,11,1,12,2022,01-18,07:01
002 Com�die,15,9,24,2022,01-18,07:01
003 Esplanade,5,27,32,2022,01-18,07:01
004 H�tel de Ville,14,2,16,2022,01-18,07:01
005 Corum,6,6,12,2022,01-18,07:01
006 Place Albert 1er - St Charles,9,22,31,2022,01-18,07:01
007 Foch,1,7,8,2022,01-18,07:01
008 Halles Castellane,0,12,12,2022,01-18,07:01
009 Observatoire,4,4,8,2022,01-18,07:01
010 Rondelet,6,10,16,2022,01-18,07:01
011 Plan Cabanes,5,7,12,2022,01-18,07:01
012 Boutonnet,2,10,12,2022,01-18,07:01
013 Emile Combes,3,5,8,2022,01-18,07:01
014 Beaux-Arts,3,5,8,2022,01-18,07:01
015 Les Aubes,6,1,8,2022,01-18,07:01
016 Antigone centre,5,11,16,2022,01-18,07:01
017 M�diath�que Emile Zola,11,5,16,2022,01-18,07:01
018 Nombre d'Or,15,1,16,2022,01-18,07:01
019 Louis Blanc,9,7,16,2022,01-18,07:01
020 Gambetta,3,5,8,2022,01-18,07:01
021 Port Marianne,11,5,16,2022,01-18,07:01
022 Clemenceau,3,9,12,2022,01-18,07:01
023 Les Arceaux,1,15,16,2022,01-18,07:01
024 Cit� Mion,4,4,8,2022,01-18,07:01
025 Nouveau Saint-Roch,4,4,8,2022,01-18,07:01
026 Renouvier,0,8,8,2022,01-18,07:01
027 Odysseum,4,4,8,2022,01-18,07:01
028 Saint-Denis,4,4,8,2022,01-18,07:01
029 Richter,8,8,16,2022,01-18,07:01
030 Charles Flahault,7,1,8,2022,01-18,07:01
031 Voltaire,0,8,8,2022,01-18,07:01
032 Pr�s d'Ar�nes,7,1,8,2022,01-18,07:01
033 Garcia Lorca,7,1,8,2022,01-18,07:01
034 Vert Bois,0,16,16,2022,01-18,07:01
035 Malbosc,1,7,8,2022,01-18,07:01
036 Occitanie,2,30,32,2022,01-18,07:01
037 FacdesSciences,10,14,24,2022,01-18,07:01
038 Fac de Lettres,8,8,16,2022,01-18,07:01
039 Aiguelongue,4,4,8,2022,01-18,07:01
040 Jeu de Mail des Abb�s,8,0,8,2022,01-18,07:01
041 Eurom�decine,1,7,8,2022,01-18,07:01
042 Marie Caizergues,3,5,8,2022,01-18,07:01
043 Sabines,3,5,8,2022,01-18,07:01
044 Celleneuve,1,7,8,2022,01-18,07:01
045 Jardin de la Lironde,8,0,8,2022,01-18,07:01
046 P�re Soulas,5,3,8,2022,01-18,07:01
047 Place Viala,4,4,8,2022,01-18,07:01
048 H�tel du D�partement,0,8,8,2022,01-18,07:01
049 Tonnelles,1,7,8,2022,01-18,07:01
050 Parvis Jules Ferry - Gare Saint-Roch,8,0,8,2022,01-18,07:01
051 Pont de Lattes - Gare Saint-Roch,3,9,12,2022,01-18,07:01
053 Deux Ponts - Gare Saint-Roch,3,5,8,2022,01-18,07:01
054 Providence - Ovalie,5,3,8,2022,01-18,07:01
055 P�rols Etang de l'Or,24,44,68,2022,01-18,07:01
056 Albert 1er - Cath�drale,0,12,12,2022,01-18,07:01
057 Saint-Guilhem - Courreau,1,7,8,2022,01-18,07:01
059 Sud De France,1,7,8,2022,01-18,07:01
001 Rue Jules Ferry - Gare Saint-Roch,11,1,12,2022,01-18,07:11
002 Com�die,15,9,24,2022,01-18,07:11
003 Esplanade,5,27,32,2022,01-18,07:11
004 H�tel de Ville,14,2,16,2022,01-18,07:11
005 Corum,6,6,12,2022,01-18,07:11
006 Place Albert 1er - St Charles,9,22,31,2022,01-18,07:11
007 Foch,1,7,8,2022,01-18,07:11
008 Halles Castellane,0,12,12,2022,01-18,07:11
009 Observatoire,4,4,8,2022,01-18,07:11
010 Rondelet,6,10,16,2022,01-18,07:11
011 Plan Cabanes,5,7,12,2022,01-18,07:11
012 Boutonnet,2,10,12,2022,01-18,07:11
013 Emile Combes,3,5,8,2022,01-18,07:11
014 Beaux-Arts,3,5,8,2022,01-18,07:11
015 Les Aubes,6,1,8,2022,01-18,07:11
016 Antigone centre,5,11,16,2022,01-18,07:11
017 M�diath�que Emile Zola,11,5,16,2022,01-18,07:11
018 Nombre d'Or,15,1,16,2022,01-18,07:11
019 Louis Blanc,9,7,16,2022,01-18,07:11
020 Gambetta,3,5,8,2022,01-18,07:11
021 Port Marianne,11,5,16,2022,01-18,07:11
022 Clemenceau,3,9,12,2022,01-18,07:11
023 Les Arceaux,1,15,16,2022,01-18,07:11
024 Cit� Mion,4,4,8,2022,01-18,07:11
025 Nouveau Saint-Roch,4,4,8,2022,01-18,07:11
026 Renouvier,0,8,8,2022,01-18,07:11
027 Odysseum,4,4,8,2022,01-18,07:11
028 Saint-Denis,4,4,8,2022,01-18,07:11
029 Richter,8,8,16,2022,01-18,07:11
030 Charles Flahault,7,1,8,2022,01-18,07:11
031 Voltaire,0,8,8,2022,01-18,07:11
032 Pr�s d'Ar�nes,7,1,8,2022,01-18,07:11
033 Garcia Lorca,7,1,8,2022,01-18,07:11
034 Vert Bois,0,16,16,2022,01-18,07:11
035 Malbosc,1,7,8,2022,01-18,07:11
036 Occitanie,2,30,32,2022,01-18,07:11
037 FacdesSciences,10,14,24,2022,01-18,07:11
038 Fac de Lettres,8,8,16,2022,01-18,07:11
039 Aiguelongue,4,4,8,2022,01-18,07:11
040 Jeu de Mail des Abb�s,6,2,8,2022,01-18,07:11
041 Eurom�decine,1,7,8,2022,01-18,07:11
042 Marie Caizergues,3,5,8,2022,01-18,07:11
043 Sabines,3,5,8,2022,01-18,07:11
044 Celleneuve,1,7,8,2022,01-18,07:11
045 Jardin de la Lironde,8,0,8,2022,01-18,07:11
046 P�re Soulas,5,3,8,2022,01-18,07:11
047 Place Viala,4,4,8,2022,01-18,07:11
048 H�tel du D�partement,0,8,8,2022,01-18,07:11
049 Tonnelles,1,7,8,2022,01-18,07:11
050 Parvis Jules Ferry - Gare Saint-Roch,8,0,8,2022,01-18,07:11
051 Pont de Lattes - Gare Saint-Roch,3,9,12,2022,01-18,07:11
053 Deux Ponts - Gare Saint-Roch,3,5,8,2022,01-18,07:11
054 Providence - Ovalie,5,3,8,2022,01-18,07:11
055 P�rols Etang de l'Or,24,44,68,2022,01-18,07:11
056 Albert 1er - Cath�drale,0,12,12,2022,01-18,07:11
057 Saint-Guilhem - Courreau,1,7,8,2022,01-18,07:11
059 Sud De France,1,7,8,2022,01-18,07:11
001 Rue Jules Ferry - Gare Saint-Roch,11,1,12,2022,01-18,07:21
002 Com�die,15,9,24,2022,01-18,07:21
003 Esplanade,5,27,32,2022,01-18,07:21
004 H�tel de Ville,14,2,16,2022,01-18,07:21
005 Corum,6,6,12,2022,01-18,07:21
006 Place Albert 1er - St Charles,9,22,31,2022,01-18,07:21
007 Foch,1,7,8,2022,01-18,07:21
008 Halles Castellane,0,12,12,2022,01-18,07:21
009 Observatoire,4,4,8,2022,01-18,07:21
010 Rondelet,6,10,16,2022,01-18,07:21
011 Plan Cabanes,5,7,12,2022,01-18,07:21
012 Boutonnet,2,10,12,2022,01-18,07:21
013 Emile Combes,3,5,8,2022,01-18,07:21
014 Beaux-Arts,3,5,8,2022,01-18,07:21
015 Les Aubes,6,1,8,2022,01-18,07:21
016 Antigone centre,5,11,16,2022,01-18,07:21
017 M�diath�que Emile Zola,11,5,16,2022,01-18,07:21
018 Nombre d'Or,15,1,16,2022,01-18,07:21
019 Louis Blanc,9,7,16,2022,01-18,07:21
020 Gambetta,3,5,8,2022,01-18,07:21
021 Port Marianne,11,5,16,2022,01-18,07:21
022 Clemenceau,3,9,12,2022,01-18,07:21
023 Les Arceaux,1,15,16,2022,01-18,07:21
024 Cit� Mion,4,4,8,2022,01-18,07:21
025 Nouveau Saint-Roch,4,4,8,2022,01-18,07:21
026 Renouvier,0,8,8,2022,01-18,07:21
027 Odysseum,4,4,8,2022,01-18,07:21
028 Saint-Denis,4,4,8,2022,01-18,07:21
029 Richter,8,8,16,2022,01-18,07:21
030 Charles Flahault,7,1,8,2022,01-18,07:21
031 Voltaire,0,8,8,2022,01-18,07:21
032 Pr�s d'Ar�nes,7,1,8,2022,01-18,07:21
033 Garcia Lorca,7,1,8,2022,01-18,07:21
034 Vert Bois,0,16,16,2022,01-18,07:21
035 Malbosc,1,7,8,2022,01-18,07:21
036 Occitanie,2,30,32,2022,01-18,07:21
037 FacdesSciences,10,14,24,2022,01-18,07:21
038 Fac de Lettres,7,9,16,2022,01-18,07:21
039 Aiguelongue,4,4,8,2022,01-18,07:21
040 Jeu de Mail des Abb�s,3,5,8,2022,01-18,07:21
041 Eurom�decine,1,7,8,2022,01-18,07:21
042 Marie Caizergues,3,5,8,2022,01-18,07:21
043 Sabines,3,5,8,2022,01-18,07:21
044 Celleneuve,1,7,8,2022,01-18,07:21
045 Jardin de la Lironde,8,0,8,2022,01-18,07:21
046 P�re Soulas,5,3,8,2022,01-18,07:21
047 Place Viala,4,4,8,2022,01-18,07:21
048 H�tel du D�partement,0,8,8,2022,01-18,07:21
049 Tonnelles,1,7,8,2022,01-18,07:21
050 Parvis Jules Ferry - Gare Saint-Roch,8,0,8,2022,01-18,07:21
051 Pont de Lattes - Gare Saint-Roch,3,9,12,2022,01-18,07:21
053 Deux Ponts - Gare Saint-Roch,3,5,8,2022,01-18,07:21
054 Providence - Ovalie,5,3,8,2022,01-18,07:21
055 P�rols Etang de l'Or,24,44,68,2022,01-18,07:21
056 Albert 1er - Cath�drale,0,12,12,2022,01-18,07:21
057 Saint-Guilhem - Courreau,1,7,8,2022,01-18,07:21
059 Sud De France,1,7,8,2022,01-18,07:21
001 Rue Jules Ferry - Gare Saint-Roch,11,1,12,2022,01-18,07:32
002 Com�die,15,9,24,2022,01-18,07:32
003 Esplanade,11,21,32,2022,01-18,07:32
004 H�tel de Ville,14,2,16,2022,01-18,07:32
005 Corum,6,6,12,2022,01-18,07:32
006 Place Albert 1er - St Charles,9,22,31,2022,01-18,07:32
007 Foch,1,7,8,2022,01-18,07:32
008 Halles Castellane,0,12,12,2022,01-18,07:32
009 Observatoire,4,4,8,2022,01-18,07:32
010 Rondelet,6,10,16,2022,01-18,07:32
011 Plan Cabanes,5,7,12,2022,01-18,07:32
012 Boutonnet,3,9,12,2022,01-18,07:32
013 Emile Combes,3,5,8,2022,01-18,07:32
014 Beaux-Arts,3,5,8,2022,01-18,07:32
015 Les Aubes,6,1,8,2022,01-18,07:32
016 Antigone centre,5,11,16,2022,01-18,07:32
017 M�diath�que Emile Zola,11,5,16,2022,01-18,07:32
018 Nombre d'Or,15,1,16,2022,01-18,07:32
019 Louis Blanc,9,7,16,2022,01-18,07:32
020 Gambetta,3,5,8,2022,01-18,07:32
021 Port Marianne,11,5,16,2022,01-18,07:32
022 Clemenceau,3,9,12,2022,01-18,07:32
023 Les Arceaux,1,15,16,2022,01-18,07:32
024 Cit� Mion,4,4,8,2022,01-18,07:32
025 Nouveau Saint-Roch,4,4,8,2022,01-18,07:32
026 Renouvier,0,8,8,2022,01-18,07:32
027 Odysseum,4,4,8,2022,01-18,07:32
028 Saint-Denis,4,4,8,2022,01-18,07:32
029 Richter,8,8,16,2022,01-18,07:32
030 Charles Flahault,7,1,8,2022,01-18,07:32
031 Voltaire,0,8,8,2022,01-18,07:32
032 Pr�s d'Ar�nes,7,1,8,2022,01-18,07:32
033 Garcia Lorca,7,1,8,2022,01-18,07:32
034 Vert Bois,0,16,16,2022,01-18,07:32
035 Malbosc,1,7,8,2022,01-18,07:32
036 Occitanie,2,30,32,2022,01-18,07:32
037 FacdesSciences,10,14,24,2022,01-18,07:32
038 Fac de Lettres,7,9,16,2022,01-18,07:32
039 Aiguelongue,4,4,8,2022,01-18,07:32
040 Jeu de Mail des Abb�s,3,5,8,2022,01-18,07:32
041 Eurom�decine,1,7,8,2022,01-18,07:32
042 Marie Caizergues,3,5,8,2022,01-18,07:32
043 Sabines,3,5,8,2022,01-18,07:32
044 Celleneuve,1,7,8,2022,01-18,07:32
045 Jardin de la Lironde,8,0,8,2022,01-18,07:32
046 P�re Soulas,5,3,8,2022,01-18,07:32
047 Place Viala,4,4,8,2022,01-18,07:32
048 H�tel du D�partement,0,8,8,2022,01-18,07:32
049 Tonnelles,1,7,8,2022,01-18,07:32
050 Parvis Jules Ferry - Gare Saint-Roch,8,0,8,2022,01-18,07:32
051 Pont de Lattes - Gare Saint-Roch,3,9,12,2022,01-18,07:32
053 Deux Ponts - Gare Saint-Roch,3,5,8,2022,01-18,07:32
054 Providence - Ovalie,5,3,8,2022,01-18,07:32
055 P�rols Etang de l'Or,24,44,68,2022,01-18,07:32
056 Albert 1er - Cath�drale,0,12,12,2022,01-18,07:32
057 Saint-Guilhem - Courreau,1,7,8,2022,01-18,07:32
059 Sud De France,1,7,8,2022,01-18,07:32
001 Rue Jules Ferry - Gare Saint-Roch,11,1,12,2022,01-18,07:42
002 Com�die,15,9,24,2022,01-18,07:42
003 Esplanade,18,14,32,2022,01-18,07:42
004 H�tel de Ville,14,2,16,2022,01-18,07:42
005 Corum,6,6,12,2022,01-18,07:42
006 Place Albert 1er - St Charles,9,22,31,2022,01-18,07:42
007 Foch,1,7,8,2022,01-18,07:42
008 Halles Castellane,0,12,12,2022,01-18,07:42
009 Observatoire,4,4,8,2022,01-18,07:42
010 Rondelet,6,10,16,2022,01-18,07:42
011 Plan Cabanes,5,7,12,2022,01-18,07:42
012 Boutonnet,3,9,12,2022,01-18,07:42
013 Emile Combes,3,5,8,2022,01-18,07:42
014 Beaux-Arts,3,5,8,2022,01-18,07:42
015 Les Aubes,6,1,8,2022,01-18,07:42
016 Antigone centre,5,11,16,2022,01-18,07:42
017 M�diath�que Emile Zola,11,5,16,2022,01-18,07:42
018 Nombre d'Or,15,1,16,2022,01-18,07:42
019 Louis Blanc,9,7,16,2022,01-18,07:42
020 Gambetta,3,5,8,2022,01-18,07:42
021 Port Marianne,11,5,16,2022,01-18,07:42
022 Clemenceau,2,10,12,2022,01-18,07:42
023 Les Arceaux,1,15,16,2022,01-18,07:42
024 Cit� Mion,4,4,8,2022,01-18,07:42
025 Nouveau Saint-Roch,4,4,8,2022,01-18,07:42
026 Renouvier,0,8,8,2022,01-18,07:42
027 Odysseum,4,4,8,2022,01-18,07:42
028 Saint-Denis,4,4,8,2022,01-18,07:42
029 Richter,8,8,16,2022,01-18,07:42
030 Charles Flahault,7,1,8,2022,01-18,07:42
031 Voltaire,0,8,8,2022,01-18,07:42
032 Pr�s d'Ar�nes,7,1,8,2022,01-18,07:42
033 Garcia Lorca,7,1,8,2022,01-18,07:42
034 Vert Bois,0,16,16,2022,01-18,07:42
035 Malbosc,1,7,8,2022,01-18,07:42
036 Occitanie,2,30,32,2022,01-18,07:42
037 FacdesSciences,9,15,24,2022,01-18,07:42
038 Fac de Lettres,7,9,16,2022,01-18,07:42
039 Aiguelongue,4,4,8,2022,01-18,07:42
040 Jeu de Mail des Abb�s,3,5,8,2022,01-18,07:42
041 Eurom�decine,1,7,8,2022,01-18,07:42
042 Marie Caizergues,3,5,8,2022,01-18,07:42
043 Sabines,3,5,8,2022,01-18,07:42
044 Celleneuve,1,7,8,2022,01-18,07:42
045 Jardin de la Lironde,8,0,8,2022,01-18,07:42
046 P�re Soulas,5,3,8,2022,01-18,07:42
047 Place Viala,4,4,8,2022,01-18,07:42
048 H�tel du D�partement,0,8,8,2022,01-18,07:42
049 Tonnelles,1,7,8,2022,01-18,07:42
050 Parvis Jules Ferry - Gare Saint-Roch,7,1,8,2022,01-18,07:42
051 Pont de Lattes - Gare Saint-Roch,3,9,12,2022,01-18,07:42
053 Deux Ponts - Gare Saint-Roch,3,5,8,2022,01-18,07:42
054 Providence - Ovalie,5,3,8,2022,01-18,07:42
055 P�rols Etang de l'Or,24,44,68,2022,01-18,07:42
056 Albert 1er - Cath�drale,0,12,12,2022,01-18,07:42
057 Saint-Guilhem - Courreau,1,7,8,2022,01-18,07:42
059 Sud De France,1,7,8,2022,01-18,07:42
001 Rue Jules Ferry - Gare Saint-Roch,11,1,12,2022,01-18,07:52
002 Com�die,15,9,24,2022,01-18,07:52
003 Esplanade,18,14,32,2022,01-18,07:52
004 H�tel de Ville,14,2,16,2022,01-18,07:52
005 Corum,6,6,12,2022,01-18,07:52
006 Place Albert 1er - St Charles,9,22,31,2022,01-18,07:52
007 Foch,1,7,8,2022,01-18,07:52
008 Halles Castellane,0,12,12,2022,01-18,07:52
009 Observatoire,4,4,8,2022,01-18,07:52
010 Rondelet,6,10,16,2022,01-18,07:52
011 Plan Cabanes,5,7,12,2022,01-18,07:52
012 Boutonnet,3,9,12,2022,01-18,07:52
013 Emile Combes,3,5,8,2022,01-18,07:52
014 Beaux-Arts,3,5,8,2022,01-18,07:52
015 Les Aubes,6,1,8,2022,01-18,07:52
016 Antigone centre,5,11,16,2022,01-18,07:52
017 M�diath�que Emile Zola,11,5,16,2022,01-18,07:52
018 Nombre d'Or,15,1,16,2022,01-18,07:52
019 Louis Blanc,9,7,16,2022,01-18,07:52
020 Gambetta,3,5,8,2022,01-18,07:52
021 Port Marianne,11,5,16,2022,01-18,07:52
022 Clemenceau,2,10,12,2022,01-18,07:52
023 Les Arceaux,1,15,16,2022,01-18,07:52
024 Cit� Mion,4,4,8,2022,01-18,07:52
025 Nouveau Saint-Roch,4,4,8,2022,01-18,07:52
026 Renouvier,0,8,8,2022,01-18,07:52
027 Odysseum,4,4,8,2022,01-18,07:52
028 Saint-Denis,4,4,8,2022,01-18,07:52
029 Richter,8,8,16,2022,01-18,07:52
030 Charles Flahault,7,1,8,2022,01-18,07:52
031 Voltaire,0,8,8,2022,01-18,07:52
032 Pr�s d'Ar�nes,7,1,8,2022,01-18,07:52
033 Garcia Lorca,7,1,8,2022,01-18,07:52
034 Vert Bois,0,16,16,2022,01-18,07:52
035 Malbosc,1,7,8,2022,01-18,07:52
036 Occitanie,2,30,32,2022,01-18,07:52
037 FacdesSciences,8,16,24,2022,01-18,07:52
038 Fac de Lettres,7,9,16,2022,01-18,07:52
039 Aiguelongue,3,5,8,2022,01-18,07:52
040 Jeu de Mail des Abb�s,3,5,8,2022,01-18,07:52
041 Eurom�decine,1,7,8,2022,01-18,07:52
042 Marie Caizergues,3,5,8,2022,01-18,07:52
043 Sabines,3,5,8,2022,01-18,07:52
044 Celleneuve,1,7,8,2022,01-18,07:52
045 Jardin de la Lironde,8,0,8,2022,01-18,07:52
046 P�re Soulas,5,3,8,2022,01-18,07:52
047 Place Viala,4,4,8,2022,01-18,07:52
048 H�tel du D�partement,0,8,8,2022,01-18,07:52
049 Tonnelles,1,7,8,2022,01-18,07:52
050 Parvis Jules Ferry - Gare Saint-Roch,6,2,8,2022,01-18,07:52
051 Pont de Lattes - Gare Saint-Roch,4,8,12,2022,01-18,07:52
053 Deux Ponts - Gare Saint-Roch,3,5,8,2022,01-18,07:52
054 Providence - Ovalie,5,3,8,2022,01-18,07:52
055 P�rols Etang de l'Or,24,44,68,2022,01-18,07:52
056 Albert 1er - Cath�drale,0,12,12,2022,01-18,07:52
057 Saint-Guilhem - Courreau,1,7,8,2022,01-18,07:52
059 Sud De France,1,7,8,2022,01-18,07:52
001 Rue Jules Ferry - Gare Saint-Roch,11,1,12,2022,01-18,08:02
002 Com�die,15,9,24,2022,01-18,08:02
003 Esplanade,18,14,32,2022,01-18,08:02
004 H�tel de Ville,14,2,16,2022,01-18,08:02
005 Corum,6,6,12,2022,01-18,08:02
006 Place Albert 1er - St Charles,10,21,31,2022,01-18,08:02
007 Foch,1,7,8,2022,01-18,08:02
008 Halles Castellane,0,12,12,2022,01-18,08:02
009 Observatoire,4,4,8,2022,01-18,08:02
010 Rondelet,6,10,16,2022,01-18,08:02
011 Plan Cabanes,4,8,12,2022,01-18,08:02
012 Boutonnet,3,9,12,2022,01-18,08:02
013 Emile Combes,3,5,8,2022,01-18,08:02
014 Beaux-Arts,3,5,8,2022,01-18,08:02
015 Les Aubes,6,1,8,2022,01-18,08:02
016 Antigone centre,6,10,16,2022,01-18,08:02
017 M�diath�que Emile Zola,11,5,16,2022,01-18,08:02
018 Nombre d'Or,11,5,16,2022,01-18,08:02
019 Louis Blanc,9,7,16,2022,01-18,08:02
020 Gambetta,3,5,8,2022,01-18,08:02
021 Port Marianne,11,5,16,2022,01-18,08:02
022 Clemenceau,2,10,12,2022,01-18,08:02
023 Les Arceaux,1,15,16,2022,01-18,08:02
024 Cit� Mion,4,4,8,2022,01-18,08:02
025 Nouveau Saint-Roch,4,4,8,2022,01-18,08:02
026 Renouvier,0,8,8,2022,01-18,08:02
027 Odysseum,4,4,8,2022,01-18,08:02
028 Saint-Denis,4,4,8,2022,01-18,08:02
029 Richter,8,8,16,2022,01-18,08:02
030 Charles Flahault,7,1,8,2022,01-18,08:02
031 Voltaire,0,8,8,2022,01-18,08:02
032 Pr�s d'Ar�nes,7,1,8,2022,01-18,08:02
033 Garcia Lorca,7,1,8,2022,01-18,08:02
034 Vert Bois,0,16,16,2022,01-18,08:02
035 Malbosc,1,7,8,2022,01-18,08:02
036 Occitanie,1,31,32,2022,01-18,08:02
037 FacdesSciences,8,16,24,2022,01-18,08:02
038 Fac de Lettres,7,9,16,2022,01-18,08:02
039 Aiguelongue,3,5,8,2022,01-18,08:02
040 Jeu de Mail des Abb�s,3,5,8,2022,01-18,08:02
041 Eurom�decine,1,7,8,2022,01-18,08:02
042 Marie Caizergues,3,5,8,2022,01-18,08:02
043 Sabines,3,5,8,2022,01-18,08:02
044 Celleneuve,1,7,8,2022,01-18,08:02
045 Jardin de la Lironde,8,0,8,2022,01-18,08:02
046 P�re Soulas,5,3,8,2022,01-18,08:02
047 Place Viala,4,4,8,2022,01-18,08:02
048 H�tel du D�partement,0,8,8,2022,01-18,08:02
049 Tonnelles,1,7,8,2022,01-18,08:02
050 Parvis Jules Ferry - Gare Saint-Roch,6,2,8,2022,01-18,08:02
051 Pont de Lattes - Gare Saint-Roch,4,8,12,2022,01-18,08:02
053 Deux Ponts - Gare Saint-Roch,3,5,8,2022,01-18,08:02
054 Providence - Ovalie,5,3,8,2022,01-18,08:02
055 P�rols Etang de l'Or,24,44,68,2022,01-18,08:02
056 Albert 1er - Cath�drale,0,12,12,2022,01-18,08:02
057 Saint-Guilhem - Courreau,0,8,8,2022,01-18,08:02
059 Sud De France,1,7,8,2022,01-18,08:02
001 Rue Jules Ferry - Gare Saint-Roch,11,1,12,2022,01-18,08:12
002 Com�die,16,8,24,2022,01-18,08:12
003 Esplanade,19,13,32,2022,01-18,08:12
004 H�tel de Ville,14,2,16,2022,01-18,08:12
005 Corum,6,6,12,2022,01-18,08:12
006 Place Albert 1er - St Charles,10,21,31,2022,01-18,08:12
007 Foch,1,7,8,2022,01-18,08:12
008 Halles Castellane,0,12,12,2022,01-18,08:12
009 Observatoire,4,4,8,2022,01-18,08:12
010 Rondelet,6,10,16,2022,01-18,08:12
011 Plan Cabanes,4,8,12,2022,01-18,08:12
012 Boutonnet,3,9,12,2022,01-18,08:12
013 Emile Combes,3,5,8,2022,01-18,08:12
014 Beaux-Arts,3,5,8,2022,01-18,08:12
015 Les Aubes,6,1,8,2022,01-18,08:12
016 Antigone centre,6,10,16,2022,01-18,08:12
017 M�diath�que Emile Zola,11,5,16,2022,01-18,08:12
018 Nombre d'Or,5,11,16,2022,01-18,08:12
019 Louis Blanc,9,7,16,2022,01-18,08:12
020 Gambetta,3,5,8,2022,01-18,08:12
021 Port Marianne,11,5,16,2022,01-18,08:12
022 Clemenceau,1,11,12,2022,01-18,08:12
023 Les Arceaux,1,15,16,2022,01-18,08:12
024 Cit� Mion,4,4,8,2022,01-18,08:12
025 Nouveau Saint-Roch,4,4,8,2022,01-18,08:12
026 Renouvier,0,8,8,2022,01-18,08:12
027 Odysseum,4,4,8,2022,01-18,08:12
028 Saint-Denis,4,4,8,2022,01-18,08:12
029 Richter,9,7,16,2022,01-18,08:12
030 Charles Flahault,7,1,8,2022,01-18,08:12
031 Voltaire,0,8,8,2022,01-18,08:12
032 Pr�s d'Ar�nes,7,1,8,2022,01-18,08:12
033 Garcia Lorca,6,2,8,2022,01-18,08:12
034 Vert Bois,0,16,16,2022,01-18,08:12
035 Malbosc,1,7,8,2022,01-18,08:12
036 Occitanie,1,31,32,2022,01-18,08:12
037 FacdesSciences,8,16,24,2022,01-18,08:12
038 Fac de Lettres,7,9,16,2022,01-18,08:12
039 Aiguelongue,3,5,8,2022,01-18,08:12
040 Jeu de Mail des Abb�s,3,5,8,2022,01-18,08:12
041 Eurom�decine,1,7,8,2022,01-18,08:12
042 Marie Caizergues,3,5,8,2022,01-18,08:12
043 Sabines,3,5,8,2022,01-18,08:12
044 Celleneuve,1,7,8,2022,01-18,08:12
045 Jardin de la Lironde,8,0,8,2022,01-18,08:12
046 P�re Soulas,5,3,8,2022,01-18,08:12
047 Place Viala,4,4,8,2022,01-18,08:12
048 H�tel du D�partement,0,8,8,2022,01-18,08:12
049 Tonnelles,1,7,8,2022,01-18,08:12
050 Parvis Jules Ferry - Gare Saint-Roch,6,2,8,2022,01-18,08:12
051 Pont de Lattes - Gare Saint-Roch,4,8,12,2022,01-18,08:12
053 Deux Ponts - Gare Saint-Roch,3,5,8,2022,01-18,08:12
054 Providence - Ovalie,5,3,8,2022,01-18,08:12
055 P�rols Etang de l'Or,24,44,68,2022,01-18,08:12
056 Albert 1er - Cath�drale,0,12,12,2022,01-18,08:12
057 Saint-Guilhem - Courreau,0,8,8,2022,01-18,08:12
059 Sud De France,1,7,8,2022,01-18,08:12
001 Rue Jules Ferry - Gare Saint-Roch,11,1,12,2022,01-18,08:22
002 Com�die,16,8,24,2022,01-18,08:22
003 Esplanade,19,13,32,2022,01-18,08:22
004 H�tel de Ville,14,2,16,2022,01-18,08:22
005 Corum,5,7,12,2022,01-18,08:22
006 Place Albert 1er - St Charles,10,21,31,2022,01-18,08:22
007 Foch,1,7,8,2022,01-18,08:22
008 Halles Castellane,7,5,12,2022,01-18,08:22
009 Observatoire,4,4,8,2022,01-18,08:22
010 Rondelet,6,10,16,2022,01-18,08:22
011 Plan Cabanes,4,8,12,2022,01-18,08:22
012 Boutonnet,3,9,12,2022,01-18,08:22
013 Emile Combes,3,5,8,2022,01-18,08:22
014 Beaux-Arts,3,5,8,2022,01-18,08:22
015 Les Aubes,6,1,8,2022,01-18,08:22
016 Antigone centre,7,9,16,2022,01-18,08:22
017 M�diath�que Emile Zola,11,5,16,2022,01-18,08:22
018 Nombre d'Or,5,11,16,2022,01-18,08:22
019 Louis Blanc,9,7,16,2022,01-18,08:22
020 Gambetta,3,5,8,2022,01-18,08:22
021 Port Marianne,11,5,16,2022,01-18,08:22
022 Clemenceau,1,11,12,2022,01-18,08:22
023 Les Arceaux,1,15,16,2022,01-18,08:22
024 Cit� Mion,4,4,8,2022,01-18,08:22
025 Nouveau Saint-Roch,4,4,8,2022,01-18,08:22
026 Renouvier,0,8,8,2022,01-18,08:22
027 Odysseum,4,4,8,2022,01-18,08:22
028 Saint-Denis,4,4,8,2022,01-18,08:22
029 Richter,9,7,16,2022,01-18,08:22
030 Charles Flahault,7,1,8,2022,01-18,08:22
031 Voltaire,0,8,8,2022,01-18,08:22
032 Pr�s d'Ar�nes,7,1,8,2022,01-18,08:22
033 Garcia Lorca,6,2,8,2022,01-18,08:22
034 Vert Bois,0,16,16,2022,01-18,08:22
035 Malbosc,1,7,8,2022,01-18,08:22
036 Occitanie,1,31,32,2022,01-18,08:22
037 FacdesSciences,8,16,24,2022,01-18,08:22
038 Fac de Lettres,6,10,16,2022,01-18,08:22
039 Aiguelongue,3,5,8,2022,01-18,08:22
040 Jeu de Mail des Abb�s,3,5,8,2022,01-18,08:22
041 Eurom�decine,1,7,8,2022,01-18,08:22
042 Marie Caizergues,3,5,8,2022,01-18,08:22
043 Sabines,3,5,8,2022,01-18,08:22
044 Celleneuve,1,7,8,2022,01-18,08:22
045 Jardin de la Lironde,8,0,8,2022,01-18,08:22
046 P�re Soulas,4,4,8,2022,01-18,08:22
047 Place Viala,4,4,8,2022,01-18,08:22
048 H�tel du D�partement,0,8,8,2022,01-18,08:22
049 Tonnelles,0,8,8,2022,01-18,08:22
050 Parvis Jules Ferry - Gare Saint-Roch,6,2,8,2022,01-18,08:22
051 Pont de Lattes - Gare Saint-Roch,3,9,12,2022,01-18,08:22
053 Deux Ponts - Gare Saint-Roch,3,5,8,2022,01-18,08:22
054 Providence - Ovalie,5,3,8,2022,01-18,08:22
055 P�rols Etang de l'Or,24,44,68,2022,01-18,08:22
056 Albert 1er - Cath�drale,0,12,12,2022,01-18,08:22
057 Saint-Guilhem - Courreau,0,8,8,2022,01-18,08:22
059 Sud De France,1,7,8,2022,01-18,08:22
001 Rue Jules Ferry - Gare Saint-Roch,11,1,12,2022,01-18,08:32
002 Com�die,16,8,24,2022,01-18,08:32
003 Esplanade,19,13,32,2022,01-18,08:32
004 H�tel de Ville,14,2,16,2022,01-18,08:32
005 Corum,5,7,12,2022,01-18,08:32
006 Place Albert 1er - St Charles,10,21,31,2022,01-18,08:32
007 Foch,1,7,8,2022,01-18,08:32
008 Halles Castellane,7,5,12,2022,01-18,08:32
009 Observatoire,4,4,8,2022,01-18,08:32
010 Rondelet,6,10,16,2022,01-18,08:32
011 Plan Cabanes,3,9,12,2022,01-18,08:32
012 Boutonnet,2,10,12,2022,01-18,08:32
013 Emile Combes,3,5,8,2022,01-18,08:32
014 Beaux-Arts,3,5,8,2022,01-18,08:32
015 Les Aubes,6,1,8,2022,01-18,08:32
016 Antigone centre,7,9,16,2022,01-18,08:32
017 M�diath�que Emile Zola,11,5,16,2022,01-18,08:32
018 Nombre d'Or,5,11,16,2022,01-18,08:32
019 Louis Blanc,9,7,16,2022,01-18,08:32
020 Gambetta,3,5,8,2022,01-18,08:32
021 Port Marianne,11,5,16,2022,01-18,08:32
022 Clemenceau,1,11,12,2022,01-18,08:32
023 Les Arceaux,1,15,16,2022,01-18,08:32
024 Cit� Mion,4,4,8,2022,01-18,08:32
025 Nouveau Saint-Roch,4,4,8,2022,01-18,08:32
026 Renouvier,0,8,8,2022,01-18,08:32
027 Odysseum,4,4,8,2022,01-18,08:32
028 Saint-Denis,4,4,8,2022,01-18,08:32
029 Richter,9,7,16,2022,01-18,08:32
030 Charles Flahault,7,1,8,2022,01-18,08:32
031 Voltaire,0,8,8,2022,01-18,08:32
032 Pr�s d'Ar�nes,7,1,8,2022,01-18,08:32
033 Garcia Lorca,6,2,8,2022,01-18,08:32
034 Vert Bois,0,16,16,2022,01-18,08:32
035 Malbosc,1,7,8,2022,01-18,08:32
036 Occitanie,1,31,32,2022,01-18,08:32
037 FacdesSciences,8,16,24,2022,01-18,08:32
038 Fac de Lettres,6,10,16,2022,01-18,08:32
039 Aiguelongue,3,5,8,2022,01-18,08:32
040 Jeu de Mail des Abb�s,3,5,8,2022,01-18,08:32
041 Eurom�decine,1,7,8,2022,01-18,08:32
042 Marie Caizergues,3,5,8,2022,01-18,08:32
043 Sabines,3,5,8,2022,01-18,08:32
044 Celleneuve,1,7,8,2022,01-18,08:32
045 Jardin de la Lironde,8,0,8,2022,01-18,08:32
046 P�re Soulas,4,4,8,2022,01-18,08:32
047 Place Viala,4,4,8,2022,01-18,08:32
048 H�tel du D�partement,0,8,8,2022,01-18,08:32
049 Tonnelles,0,8,8,2022,01-18,08:32
050 Parvis Jules Ferry - Gare Saint-Roch,7,1,8,2022,01-18,08:32
051 Pont de Lattes - Gare Saint-Roch,3,9,12,2022,01-18,08:32
053 Deux Ponts - Gare Saint-Roch,3,5,8,2022,01-18,08:32
054 Providence - Ovalie,5,3,8,2022,01-18,08:32
055 P�rols Etang de l'Or,24,44,68,2022,01-18,08:32
056 Albert 1er - Cath�drale,0,12,12,2022,01-18,08:32
057 Saint-Guilhem - Courreau,0,8,8,2022,01-18,08:32
059 Sud De France,1,7,8,2022,01-18,08:32
001 Rue Jules Ferry - Gare Saint-Roch,10,2,12,2022,01-18,08:43
002 Com�die,16,8,24,2022,01-18,08:43
003 Esplanade,19,13,32,2022,01-18,08:43
004 H�tel de Ville,14,2,16,2022,01-18,08:43
005 Corum,5,7,12,2022,01-18,08:43
006 Place Albert 1er - St Charles,10,21,31,2022,01-18,08:43
007 Foch,6,2,8,2022,01-18,08:43
008 Halles Castellane,7,5,12,2022,01-18,08:43
009 Observatoire,4,4,8,2022,01-18,08:43
010 Rondelet,6,10,16,2022,01-18,08:43
011 Plan Cabanes,3,9,12,2022,01-18,08:43
012 Boutonnet,2,10,12,2022,01-18,08:43
013 Emile Combes,3,5,8,2022,01-18,08:43
014 Beaux-Arts,3,5,8,2022,01-18,08:43
015 Les Aubes,6,1,8,2022,01-18,08:43
016 Antigone centre,7,9,16,2022,01-18,08:43
017 M�diath�que Emile Zola,10,6,16,2022,01-18,08:43
018 Nombre d'Or,5,11,16,2022,01-18,08:43
019 Louis Blanc,9,7,16,2022,01-18,08:43
020 Gambetta,2,6,8,2022,01-18,08:43
021 Port Marianne,11,5,16,2022,01-18,08:43
022 Clemenceau,0,12,12,2022,01-18,08:43
023 Les Arceaux,0,16,16,2022,01-18,08:43
024 Cit� Mion,4,4,8,2022,01-18,08:43
025 Nouveau Saint-Roch,3,5,8,2022,01-18,08:43
026 Renouvier,0,8,8,2022,01-18,08:43
027 Odysseum,4,4,8,2022,01-18,08:43
028 Saint-Denis,4,4,8,2022,01-18,08:43
029 Richter,9,7,16,2022,01-18,08:43
030 Charles Flahault,7,1,8,2022,01-18,08:43
031 Voltaire,0,8,8,2022,01-18,08:43
032 Pr�s d'Ar�nes,7,1,8,2022,01-18,08:43
033 Garcia Lorca,6,2,8,2022,01-18,08:43
034 Vert Bois,0,16,16,2022,01-18,08:43
035 Malbosc,1,7,8,2022,01-18,08:43
036 Occitanie,1,31,32,2022,01-18,08:43
037 FacdesSciences,8,16,24,2022,01-18,08:43
038 Fac de Lettres,6,10,16,2022,01-18,08:43
039 Aiguelongue,2,6,8,2022,01-18,08:43
040 Jeu de Mail des Abb�s,3,5,8,2022,01-18,08:43
041 Eurom�decine,1,7,8,2022,01-18,08:43
042 Marie Caizergues,3,5,8,2022,01-18,08:43
043 Sabines,3,5,8,2022,01-18,08:43
044 Celleneuve,1,7,8,2022,01-18,08:43
045 Jardin de la Lironde,8,0,8,2022,01-18,08:43
046 P�re Soulas,4,4,8,2022,01-18,08:43
047 Place Viala,5,3,8,2022,01-18,08:43
048 H�tel du D�partement,0,8,8,2022,01-18,08:43
049 Tonnelles,0,8,8,2022,01-18,08:43
050 Parvis Jules Ferry - Gare Saint-Roch,7,1,8,2022,01-18,08:43
051 Pont de Lattes - Gare Saint-Roch,3,9,12,2022,01-18,08:43
053 Deux Ponts - Gare Saint-Roch,3,5,8,2022,01-18,08:43
054 Providence - Ovalie,5,3,8,2022,01-18,08:43
055 P�rols Etang de l'Or,24,44,68,2022,01-18,08:43
056 Albert 1er - Cath�drale,0,12,12,2022,01-18,08:43
057 Saint-Guilhem - Courreau,0,8,8,2022,01-18,08:43
059 Sud De France,1,7,8,2022,01-18,08:43
001 Rue Jules Ferry - Gare Saint-Roch,10,2,12,2022,01-18,08:53
002 Com�die,16,8,24,2022,01-18,08:53
003 Esplanade,19,13,32,2022,01-18,08:53
004 H�tel de Ville,14,2,16,2022,01-18,08:53
005 Corum,6,6,12,2022,01-18,08:53
006 Place Albert 1er - St Charles,11,20,31,2022,01-18,08:53
007 Foch,6,2,8,2022,01-18,08:53
008 Halles Castellane,7,5,12,2022,01-18,08:53
009 Observatoire,4,4,8,2022,01-18,08:53
010 Rondelet,6,10,16,2022,01-18,08:53
011 Plan Cabanes,3,9,12,2022,01-18,08:53
012 Boutonnet,2,10,12,2022,01-18,08:53
013 Emile Combes,3,5,8,2022,01-18,08:53
014 Beaux-Arts,3,5,8,2022,01-18,08:53
015 Les Aubes,6,1,8,2022,01-18,08:53
016 Antigone centre,7,9,16,2022,01-18,08:53
017 M�diath�que Emile Zola,13,3,16,2022,01-18,08:53
018 Nombre d'Or,5,11,16,2022,01-18,08:53
019 Louis Blanc,8,8,16,2022,01-18,08:53
020 Gambetta,2,6,8,2022,01-18,08:53
021 Port Marianne,11,5,16,2022,01-18,08:53
022 Clemenceau,0,12,12,2022,01-18,08:53
023 Les Arceaux,0,16,16,2022,01-18,08:53
024 Cit� Mion,4,4,8,2022,01-18,08:53
025 Nouveau Saint-Roch,3,5,8,2022,01-18,08:53
026 Renouvier,0,8,8,2022,01-18,08:53
027 Odysseum,4,4,8,2022,01-18,08:53
028 Saint-Denis,4,4,8,2022,01-18,08:53
029 Richter,9,7,16,2022,01-18,08:53
030 Charles Flahault,6,2,8,2022,01-18,08:53
031 Voltaire,0,8,8,2022,01-18,08:53
032 Pr�s d'Ar�nes,7,1,8,2022,01-18,08:53
033 Garcia Lorca,6,2,8,2022,01-18,08:53
034 Vert Bois,0,16,16,2022,01-18,08:53
035 Malbosc,1,7,8,2022,01-18,08:53
036 Occitanie,1,31,32,2022,01-18,08:53
037 FacdesSciences,9,15,24,2022,01-18,08:53
038 Fac de Lettres,5,11,16,2022,01-18,08:53
039 Aiguelongue,2,6,8,2022,01-18,08:53
040 Jeu de Mail des Abb�s,4,4,8,2022,01-18,08:53
041 Eurom�decine,1,7,8,2022,01-18,08:53
042 Marie Caizergues,3,5,8,2022,01-18,08:53
043 Sabines,3,5,8,2022,01-18,08:53
044 Celleneuve,1,7,8,2022,01-18,08:53
045 Jardin de la Lironde,8,0,8,2022,01-18,08:53
046 P�re Soulas,4,4,8,2022,01-18,08:53
047 Place Viala,5,3,8,2022,01-18,08:53
048 H�tel du D�partement,0,8,8,2022,01-18,08:53
049 Tonnelles,0,8,8,2022,01-18,08:53
050 Parvis Jules Ferry - Gare Saint-Roch,7,1,8,2022,01-18,08:53
051 Pont de Lattes - Gare Saint-Roch,3,9,12,2022,01-18,08:53
053 Deux Ponts - Gare Saint-Roch,3,5,8,2022,01-18,08:53
054 Providence - Ovalie,5,3,8,2022,01-18,08:53
055 P�rols Etang de l'Or,24,44,68,2022,01-18,08:53
056 Albert 1er - Cath�drale,0,12,12,2022,01-18,08:53
057 Saint-Guilhem - Courreau,0,8,8,2022,01-18,08:53
059 Sud De France,1,7,8,2022,01-18,08:53
001 Rue Jules Ferry - Gare Saint-Roch,10,2,12,2022,01-18,09:03
002 Com�die,15,9,24,2022,01-18,09:03
003 Esplanade,19,13,32,2022,01-18,09:03
004 H�tel de Ville,14,2,16,2022,01-18,09:03
005 Corum,6,6,12,2022,01-18,09:03
006 Place Albert 1er - St Charles,11,20,31,2022,01-18,09:03
007 Foch,5,3,8,2022,01-18,09:03
008 Halles Castellane,7,5,12,2022,01-18,09:03
009 Observatoire,4,4,8,2022,01-18,09:03
010 Rondelet,6,10,16,2022,01-18,09:03
011 Plan Cabanes,3,9,12,2022,01-18,09:03
012 Boutonnet,3,9,12,2022,01-18,09:03
013 Emile Combes,3,5,8,2022,01-18,09:03
014 Beaux-Arts,2,6,8,2022,01-18,09:03
015 Les Aubes,6,1,8,2022,01-18,09:03
016 Antigone centre,7,9,16,2022,01-18,09:03
017 M�diath�que Emile Zola,13,3,16,2022,01-18,09:03
018 Nombre d'Or,5,11,16,2022,01-18,09:03
019 Louis Blanc,8,8,16,2022,01-18,09:03
020 Gambetta,2,6,8,2022,01-18,09:03
021 Port Marianne,11,5,16,2022,01-18,09:03
022 Clemenceau,0,12,12,2022,01-18,09:03
023 Les Arceaux,1,15,16,2022,01-18,09:03
024 Cit� Mion,4,4,8,2022,01-18,09:03
025 Nouveau Saint-Roch,3,5,8,2022,01-18,09:03
026 Renouvier,0,8,8,2022,01-18,09:03
027 Odysseum,4,4,8,2022,01-18,09:03
028 Saint-Denis,4,4,8,2022,01-18,09:03
029 Richter,9,7,16,2022,01-18,09:03
030 Charles Flahault,6,2,8,2022,01-18,09:03
031 Voltaire,0,8,8,2022,01-18,09:03
032 Pr�s d'Ar�nes,7,1,8,2022,01-18,09:03
033 Garcia Lorca,6,2,8,2022,01-18,09:03
034 Vert Bois,0,16,16,2022,01-18,09:03
035 Malbosc,1,7,8,2022,01-18,09:03
036 Occitanie,2,30,32,2022,01-18,09:03
037 FacdesSciences,9,15,24,2022,01-18,09:03
038 Fac de Lettres,5,11,16,2022,01-18,09:03
039 Aiguelongue,2,6,8,2022,01-18,09:03
040 Jeu de Mail des Abb�s,4,4,8,2022,01-18,09:03
041 Eurom�decine,1,7,8,2022,01-18,09:03
042 Marie Caizergues,2,6,8,2022,01-18,09:03
043 Sabines,3,5,8,2022,01-18,09:03
044 Celleneuve,1,7,8,2022,01-18,09:03
045 Jardin de la Lironde,8,0,8,2022,01-18,09:03
046 P�re Soulas,4,4,8,2022,01-18,09:03
047 Place Viala,5,3,8,2022,01-18,09:03
048 H�tel du D�partement,0,8,8,2022,01-18,09:03
049 Tonnelles,0,8,8,2022,01-18,09:03
050 Parvis Jules Ferry - Gare Saint-Roch,7,1,8,2022,01-18,09:03
051 Pont de Lattes - Gare Saint-Roch,3,9,12,2022,01-18,09:03
053 Deux Ponts - Gare Saint-Roch,3,5,8,2022,01-18,09:03
054 Providence - Ovalie,5,3,8,2022,01-18,09:03
055 P�rols Etang de l'Or,24,44,68,2022,01-18,09:03
056 Albert 1er - Cath�drale,0,12,12,2022,01-18,09:03
057 Saint-Guilhem - Courreau,0,8,8,2022,01-18,09:03
059 Sud De France,1,7,8,2022,01-18,09:03
001 Rue Jules Ferry - Gare Saint-Roch,10,2,12,2022,01-18,09:13
002 Com�die,16,8,24,2022,01-18,09:13
003 Esplanade,19,13,32,2022,01-18,09:13
004 H�tel de Ville,14,2,16,2022,01-18,09:13
005 Corum,6,6,12,2022,01-18,09:13
006 Place Albert 1er - St Charles,11,20,31,2022,01-18,09:13
007 Foch,5,3,8,2022,01-18,09:13
008 Halles Castellane,7,5,12,2022,01-18,09:13
009 Observatoire,4,4,8,2022,01-18,09:13
010 Rondelet,6,10,16,2022,01-18,09:13
011 Plan Cabanes,3,9,12,2022,01-18,09:13
012 Boutonnet,3,9,12,2022,01-18,09:13
013 Emile Combes,3,5,8,2022,01-18,09:13
014 Beaux-Arts,2,6,8,2022,01-18,09:13
015 Les Aubes,3,5,8,2022,01-18,09:13
016 Antigone centre,7,9,16,2022,01-18,09:13
017 M�diath�que Emile Zola,13,3,16,2022,01-18,09:13
018 Nombre d'Or,5,11,16,2022,01-18,09:13
019 Louis Blanc,8,8,16,2022,01-18,09:13
020 Gambetta,2,6,8,2022,01-18,09:13
021 Port Marianne,11,5,16,2022,01-18,09:13
022 Clemenceau,0,12,12,2022,01-18,09:13
023 Les Arceaux,1,15,16,2022,01-18,09:13
024 Cit� Mion,4,4,8,2022,01-18,09:13
025 Nouveau Saint-Roch,4,4,8,2022,01-18,09:13
026 Renouvier,0,8,8,2022,01-18,09:13
027 Odysseum,4,4,8,2022,01-18,09:13
028 Saint-Denis,4,4,8,2022,01-18,09:13
029 Richter,10,6,16,2022,01-18,09:13
030 Charles Flahault,6,2,8,2022,01-18,09:13
031 Voltaire,0,8,8,2022,01-18,09:13
032 Pr�s d'Ar�nes,7,1,8,2022,01-18,09:13
033 Garcia Lorca,6,2,8,2022,01-18,09:13
034 Vert Bois,0,16,16,2022,01-18,09:13
035 Malbosc,1,7,8,2022,01-18,09:13
036 Occitanie,2,30,32,2022,01-18,09:13
037 FacdesSciences,9,15,24,2022,01-18,09:13
038 Fac de Lettres,5,11,16,2022,01-18,09:13
039 Aiguelongue,2,6,8,2022,01-18,09:13
040 Jeu de Mail des Abb�s,4,4,8,2022,01-18,09:13
041 Eurom�decine,1,7,8,2022,01-18,09:13
042 Marie Caizergues,2,6,8,2022,01-18,09:13
043 Sabines,3,5,8,2022,01-18,09:13
044 Celleneuve,1,7,8,2022,01-18,09:13
045 Jardin de la Lironde,8,0,8,2022,01-18,09:13
046 P�re Soulas,4,4,8,2022,01-18,09:13
047 Place Viala,6,2,8,2022,01-18,09:13
048 H�tel du D�partement,0,8,8,2022,01-18,09:13
049 Tonnelles,0,8,8,2022,01-18,09:13
050 Parvis Jules Ferry - Gare Saint-Roch,7,1,8,2022,01-18,09:13
051 Pont de Lattes - Gare Saint-Roch,3,9,12,2022,01-18,09:13
053 Deux Ponts - Gare Saint-Roch,3,5,8,2022,01-18,09:13
054 Providence - Ovalie,5,3,8,2022,01-18,09:13
055 P�rols Etang de l'Or,24,44,68,2022,01-18,09:13
056 Albert 1er - Cath�drale,0,12,12,2022,01-18,09:13
057 Saint-Guilhem - Courreau,0,8,8,2022,01-18,09:13
059 Sud De France,1,7,8,2022,01-18,09:13
001 Rue Jules Ferry - Gare Saint-Roch,10,2,12,2022,01-18,09:23
002 Com�die,15,9,24,2022,01-18,09:23
003 Esplanade,19,13,32,2022,01-18,09:23
004 H�tel de Ville,14,2,16,2022,01-18,09:23
005 Corum,7,5,12,2022,01-18,09:23
006 Place Albert 1er - St Charles,11,20,31,2022,01-18,09:23
007 Foch,5,3,8,2022,01-18,09:23
008 Halles Castellane,7,5,12,2022,01-18,09:23
009 Observatoire,4,4,8,2022,01-18,09:23
010 Rondelet,6,10,16,2022,01-18,09:23
011 Plan Cabanes,3,9,12,2022,01-18,09:23
012 Boutonnet,3,9,12,2022,01-18,09:23
013 Emile Combes,3,5,8,2022,01-18,09:23
014 Beaux-Arts,2,6,8,2022,01-18,09:23
015 Les Aubes,3,5,8,2022,01-18,09:23
016 Antigone centre,7,9,16,2022,01-18,09:23
017 M�diath�que Emile Zola,13,3,16,2022,01-18,09:23
018 Nombre d'Or,6,10,16,2022,01-18,09:23
019 Louis Blanc,8,8,16,2022,01-18,09:23
020 Gambetta,2,6,8,2022,01-18,09:23
021 Port Marianne,11,5,16,2022,01-18,09:23
022 Clemenceau,0,12,12,2022,01-18,09:23
023 Les Arceaux,0,16,16,2022,01-18,09:23
024 Cit� Mion,4,4,8,2022,01-18,09:23
025 Nouveau Saint-Roch,4,4,8,2022,01-18,09:23
026 Renouvier,0,8,8,2022,01-18,09:23
027 Odysseum,4,4,8,2022,01-18,09:23
028 Saint-Denis,4,4,8,2022,01-18,09:23
029 Richter,10,6,16,2022,01-18,09:23
030 Charles Flahault,6,2,8,2022,01-18,09:23
031 Voltaire,0,8,8,2022,01-18,09:23
032 Pr�s d'Ar�nes,7,1,8,2022,01-18,09:23
033 Garcia Lorca,6,2,8,2022,01-18,09:23
034 Vert Bois,0,16,16,2022,01-18,09:23
035 Malbosc,1,7,8,2022,01-18,09:23
036 Occitanie,2,30,32,2022,01-18,09:23
037 FacdesSciences,9,15,24,2022,01-18,09:23
038 Fac de Lettres,5,11,16,2022,01-18,09:23
039 Aiguelongue,2,6,8,2022,01-18,09:23
040 Jeu de Mail des Abb�s,4,4,8,2022,01-18,09:23
041 Eurom�decine,1,7,8,2022,01-18,09:23
042 Marie Caizergues,2,6,8,2022,01-18,09:23
043 Sabines,3,5,8,2022,01-18,09:23
044 Celleneuve,1,7,8,2022,01-18,09:23
045 Jardin de la Lironde,7,1,8,2022,01-18,09:23
046 P�re Soulas,4,4,8,2022,01-18,09:23
047 Place Viala,6,2,8,2022,01-18,09:23
048 H�tel du D�partement,0,8,8,2022,01-18,09:23
049 Tonnelles,0,8,8,2022,01-18,09:23
050 Parvis Jules Ferry - Gare Saint-Roch,7,1,8,2022,01-18,09:23
051 Pont de Lattes - Gare Saint-Roch,3,9,12,2022,01-18,09:23
053 Deux Ponts - Gare Saint-Roch,3,5,8,2022,01-18,09:23
054 Providence - Ovalie,5,3,8,2022,01-18,09:23
055 P�rols Etang de l'Or,24,44,68,2022,01-18,09:23
056 Albert 1er - Cath�drale,0,12,12,2022,01-18,09:23
057 Saint-Guilhem - Courreau,0,8,8,2022,01-18,09:23
059 Sud De France,1,7,8,2022,01-18,09:23
001 Rue Jules Ferry - Gare Saint-Roch,10,2,12,2022,01-18,09:33
002 Com�die,15,9,24,2022,01-18,09:33
003 Esplanade,17,15,32,2022,01-18,09:33
004 H�tel de Ville,14,2,16,2022,01-18,09:33
005 Corum,7,5,12,2022,01-18,09:33
006 Place Albert 1er - St Charles,11,20,31,2022,01-18,09:33
007 Foch,5,3,8,2022,01-18,09:33
008 Halles Castellane,7,5,12,2022,01-18,09:33
009 Observatoire,4,4,8,2022,01-18,09:33
010 Rondelet,6,10,16,2022,01-18,09:33
011 Plan Cabanes,4,8,12,2022,01-18,09:33
012 Boutonnet,3,9,12,2022,01-18,09:33
013 Emile Combes,3,5,8,2022,01-18,09:33
014 Beaux-Arts,2,6,8,2022,01-18,09:33
015 Les Aubes,3,5,8,2022,01-18,09:33
016 Antigone centre,6,10,16,2022,01-18,09:33
017 M�diath�que Emile Zola,14,2,16,2022,01-18,09:33
018 Nombre d'Or,6,10,16,2022,01-18,09:33
019 Louis Blanc,7,9,16,2022,01-18,09:33
020 Gambetta,2,6,8,2022,01-18,09:33
021 Port Marianne,11,5,16,2022,01-18,09:33
022 Clemenceau,0,12,12,2022,01-18,09:33
023 Les Arceaux,0,16,16,2022,01-18,09:33
024 Cit� Mion,4,4,8,2022,01-18,09:33
025 Nouveau Saint-Roch,4,4,8,2022,01-18,09:33
026 Renouvier,0,8,8,2022,01-18,09:33
027 Odysseum,4,4,8,2022,01-18,09:33
028 Saint-Denis,3,5,8,2022,01-18,09:33
029 Richter,12,4,16,2022,01-18,09:33
030 Charles Flahault,6,2,8,2022,01-18,09:33
031 Voltaire,0,8,8,2022,01-18,09:33
032 Pr�s d'Ar�nes,7,1,8,2022,01-18,09:33
033 Garcia Lorca,6,2,8,2022,01-18,09:33
034 Vert Bois,0,16,16,2022,01-18,09:33
035 Malbosc,1,7,8,2022,01-18,09:33
036 Occitanie,2,30,32,2022,01-18,09:33
037 FacdesSciences,9,15,24,2022,01-18,09:33
038 Fac de Lettres,5,11,16,2022,01-18,09:33
039 Aiguelongue,2,6,8,2022,01-18,09:33
040 Jeu de Mail des Abb�s,4,4,8,2022,01-18,09:33
041 Eurom�decine,1,7,8,2022,01-18,09:33
042 Marie Caizergues,2,6,8,2022,01-18,09:33
043 Sabines,3,5,8,2022,01-18,09:33
044 Celleneuve,1,7,8,2022,01-18,09:33
045 Jardin de la Lironde,3,5,8,2022,01-18,09:33
046 P�re Soulas,4,4,8,2022,01-18,09:33
047 Place Viala,6,2,8,2022,01-18,09:33
048 H�tel du D�partement,0,8,8,2022,01-18,09:33
049 Tonnelles,0,8,8,2022,01-18,09:33
050 Parvis Jules Ferry - Gare Saint-Roch,7,1,8,2022,01-18,09:33
051 Pont de Lattes - Gare Saint-Roch,3,9,12,2022,01-18,09:33
053 Deux Ponts - Gare Saint-Roch,3,5,8,2022,01-18,09:33
054 Providence - Ovalie,5,3,8,2022,01-18,09:33
055 P�rols Etang de l'Or,24,44,68,2022,01-18,09:33
056 Albert 1er - Cath�drale,0,12,12,2022,01-18,09:33
057 Saint-Guilhem - Courreau,0,8,8,2022,01-18,09:33
059 Sud De France,1,7,8,2022,01-18,09:33
001 Rue Jules Ferry - Gare Saint-Roch,10,2,12,2022,01-18,09:44
002 Com�die,15,9,24,2022,01-18,09:44
003 Esplanade,17,15,32,2022,01-18,09:44
004 H�tel de Ville,14,2,16,2022,01-18,09:44
005 Corum,7,5,12,2022,01-18,09:44
006 Place Albert 1er - St Charles,11,20,31,2022,01-18,09:44
007 Foch,5,3,8,2022,01-18,09:44
008 Halles Castellane,7,5,12,2022,01-18,09:44
009 Observatoire,4,4,8,2022,01-18,09:44
010 Rondelet,6,10,16,2022,01-18,09:44
011 Plan Cabanes,4,8,12,2022,01-18,09:44
012 Boutonnet,3,9,12,2022,01-18,09:44
013 Emile Combes,3,5,8,2022,01-18,09:44
014 Beaux-Arts,2,6,8,2022,01-18,09:44
015 Les Aubes,3,5,8,2022,01-18,09:44
016 Antigone centre,7,9,16,2022,01-18,09:44
017 M�diath�que Emile Zola,14,2,16,2022,01-18,09:44
018 Nombre d'Or,6,10,16,2022,01-18,09:44
019 Louis Blanc,7,9,16,2022,01-18,09:44
020 Gambetta,2,6,8,2022,01-18,09:44
021 Port Marianne,11,5,16,2022,01-18,09:44
022 Clemenceau,0,12,12,2022,01-18,09:44
023 Les Arceaux,0,16,16,2022,01-18,09:44
024 Cit� Mion,4,4,8,2022,01-18,09:44
025 Nouveau Saint-Roch,4,4,8,2022,01-18,09:44
026 Renouvier,0,8,8,2022,01-18,09:44
027 Odysseum,4,4,8,2022,01-18,09:44
028 Saint-Denis,3,5,8,2022,01-18,09:44
029 Richter,10,6,16,2022,01-18,09:44
030 Charles Flahault,6,2,8,2022,01-18,09:44
031 Voltaire,0,8,8,2022,01-18,09:44
032 Pr�s d'Ar�nes,7,1,8,2022,01-18,09:44
033 Garcia Lorca,6,2,8,2022,01-18,09:44
034 Vert Bois,0,16,16,2022,01-18,09:44
035 Malbosc,1,7,8,2022,01-18,09:44
036 Occitanie,2,30,32,2022,01-18,09:44
037 FacdesSciences,9,15,24,2022,01-18,09:44
038 Fac de Lettres,5,11,16,2022,01-18,09:44
039 Aiguelongue,1,7,8,2022,01-18,09:44
040 Jeu de Mail des Abb�s,4,4,8,2022,01-18,09:44
041 Eurom�decine,1,7,8,2022,01-18,09:44
042 Marie Caizergues,2,6,8,2022,01-18,09:44
043 Sabines,3,5,8,2022,01-18,09:44
044 Celleneuve,1,7,8,2022,01-18,09:44
045 Jardin de la Lironde,3,5,8,2022,01-18,09:44
046 P�re Soulas,4,4,8,2022,01-18,09:44
047 Place Viala,4,4,8,2022,01-18,09:44
048 H�tel du D�partement,0,8,8,2022,01-18,09:44
049 Tonnelles,0,8,8,2022,01-18,09:44
050 Parvis Jules Ferry - Gare Saint-Roch,7,1,8,2022,01-18,09:44
051 Pont de Lattes - Gare Saint-Roch,3,9,12,2022,01-18,09:44
053 Deux Ponts - Gare Saint-Roch,3,5,8,2022,01-18,09:44
054 Providence - Ovalie,5,3,8,2022,01-18,09:44
055 P�rols Etang de l'Or,24,44,68,2022,01-18,09:44
056 Albert 1er - Cath�drale,0,12,12,2022,01-18,09:44
057 Saint-Guilhem - Courreau,1,7,8,2022,01-18,09:44
059 Sud De France,1,7,8,2022,01-18,09:44
001 Rue Jules Ferry - Gare Saint-Roch,10,2,12,2022,01-18,09:54
002 Com�die,15,9,24,2022,01-18,09:54
003 Esplanade,17,15,32,2022,01-18,09:54
004 H�tel de Ville,14,2,16,2022,01-18,09:54
005 Corum,7,5,12,2022,01-18,09:54
006 Place Albert 1er - St Charles,11,20,31,2022,01-18,09:54
007 Foch,5,3,8,2022,01-18,09:54
008 Halles Castellane,6,6,12,2022,01-18,09:54
009 Observatoire,4,4,8,2022,01-18,09:54
010 Rondelet,6,10,16,2022,01-18,09:54
011 Plan Cabanes,4,8,12,2022,01-18,09:54
012 Boutonnet,3,9,12,2022,01-18,09:54
013 Emile Combes,3,5,8,2022,01-18,09:54
014 Beaux-Arts,2,6,8,2022,01-18,09:54
015 Les Aubes,3,5,8,2022,01-18,09:54
016 Antigone centre,7,9,16,2022,01-18,09:54
017 M�diath�que Emile Zola,14,2,16,2022,01-18,09:54
018 Nombre d'Or,6,10,16,2022,01-18,09:54
019 Louis Blanc,7,9,16,2022,01-18,09:54
020 Gambetta,2,6,8,2022,01-18,09:54
021 Port Marianne,11,5,16,2022,01-18,09:54
022 Clemenceau,0,12,12,2022,01-18,09:54
023 Les Arceaux,0,16,16,2022,01-18,09:54
024 Cit� Mion,4,4,8,2022,01-18,09:54
025 Nouveau Saint-Roch,4,4,8,2022,01-18,09:54
026 Renouvier,0,8,8,2022,01-18,09:54
027 Odysseum,4,4,8,2022,01-18,09:54
028 Saint-Denis,3,5,8,2022,01-18,09:54
029 Richter,9,7,16,2022,01-18,09:54
030 Charles Flahault,5,3,8,2022,01-18,09:54
031 Voltaire,0,8,8,2022,01-18,09:54
032 Pr�s d'Ar�nes,7,1,8,2022,01-18,09:54
033 Garcia Lorca,6,2,8,2022,01-18,09:54
034 Vert Bois,0,16,16,2022,01-18,09:54
035 Malbosc,1,7,8,2022,01-18,09:54
036 Occitanie,2,30,32,2022,01-18,09:54
037 FacdesSciences,10,14,24,2022,01-18,09:54
038 Fac de Lettres,4,12,16,2022,01-18,09:54
039 Aiguelongue,2,6,8,2022,01-18,09:54
040 Jeu de Mail des Abb�s,4,4,8,2022,01-18,09:54
041 Eurom�decine,1,7,8,2022,01-18,09:54
042 Marie Caizergues,2,6,8,2022,01-18,09:54
043 Sabines,3,5,8,2022,01-18,09:54
044 Celleneuve,1,7,8,2022,01-18,09:54
045 Jardin de la Lironde,3,5,8,2022,01-18,09:54
046 P�re Soulas,3,5,8,2022,01-18,09:54
047 Place Viala,4,4,8,2022,01-18,09:54
048 H�tel du D�partement,0,8,8,2022,01-18,09:54
049 Tonnelles,0,8,8,2022,01-18,09:54
050 Parvis Jules Ferry - Gare Saint-Roch,7,1,8,2022,01-18,09:54
051 Pont de Lattes - Gare Saint-Roch,3,9,12,2022,01-18,09:54
053 Deux Ponts - Gare Saint-Roch,3,5,8,2022,01-18,09:54
054 Providence - Ovalie,5,3,8,2022,01-18,09:54
055 P�rols Etang de l'Or,24,44,68,2022,01-18,09:54
056 Albert 1er - Cath�drale,0,12,12,2022,01-18,09:54
057 Saint-Guilhem - Courreau,1,7,8,2022,01-18,09:54
059 Sud De France,1,7,8,2022,01-18,09:54
001 Rue Jules Ferry - Gare Saint-Roch,10,2,12,2022,01-18,10:04
002 Com�die,15,9,24,2022,01-18,10:04
003 Esplanade,17,15,32,2022,01-18,10:04
004 H�tel de Ville,14,2,16,2022,01-18,10:04
005 Corum,7,5,12,2022,01-18,10:04
006 Place Albert 1er - St Charles,11,20,31,2022,01-18,10:04
007 Foch,5,3,8,2022,01-18,10:04
008 Halles Castellane,6,6,12,2022,01-18,10:04
009 Observatoire,5,3,8,2022,01-18,10:04
010 Rondelet,6,10,16,2022,01-18,10:04
011 Plan Cabanes,4,8,12,2022,01-18,10:04
012 Boutonnet,3,9,12,2022,01-18,10:04
013 Emile Combes,3,5,8,2022,01-18,10:04
014 Beaux-Arts,2,6,8,2022,01-18,10:04
015 Les Aubes,3,5,8,2022,01-18,10:04
016 Antigone centre,7,9,16,2022,01-18,10:04
017 M�diath�que Emile Zola,14,2,16,2022,01-18,10:04
018 Nombre d'Or,6,10,16,2022,01-18,10:04
019 Louis Blanc,7,9,16,2022,01-18,10:04
020 Gambetta,1,7,8,2022,01-18,10:04
021 Port Marianne,10,6,16,2022,01-18,10:04
022 Clemenceau,0,12,12,2022,01-18,10:04
023 Les Arceaux,0,16,16,2022,01-18,10:04
024 Cit� Mion,4,4,8,2022,01-18,10:04
025 Nouveau Saint-Roch,4,4,8,2022,01-18,10:04
026 Renouvier,0,8,8,2022,01-18,10:04
027 Odysseum,4,4,8,2022,01-18,10:04
028 Saint-Denis,3,5,8,2022,01-18,10:04
029 Richter,10,6,16,2022,01-18,10:04
030 Charles Flahault,5,3,8,2022,01-18,10:04
031 Voltaire,0,8,8,2022,01-18,10:04
032 Pr�s d'Ar�nes,7,1,8,2022,01-18,10:04
033 Garcia Lorca,6,2,8,2022,01-18,10:04
034 Vert Bois,0,16,16,2022,01-18,10:04
035 Malbosc,2,6,8,2022,01-18,10:04
036 Occitanie,1,31,32,2022,01-18,10:04
037 FacdesSciences,8,16,24,2022,01-18,10:04
038 Fac de Lettres,5,11,16,2022,01-18,10:04
039 Aiguelongue,2,6,8,2022,01-18,10:04
040 Jeu de Mail des Abb�s,4,4,8,2022,01-18,10:04
041 Eurom�decine,1,7,8,2022,01-18,10:04
042 Marie Caizergues,2,6,8,2022,01-18,10:04
043 Sabines,3,5,8,2022,01-18,10:04
044 Celleneuve,1,7,8,2022,01-18,10:04
045 Jardin de la Lironde,3,5,8,2022,01-18,10:04
046 P�re Soulas,3,5,8,2022,01-18,10:04
047 Place Viala,4,4,8,2022,01-18,10:04
048 H�tel du D�partement,0,8,8,2022,01-18,10:04
049 Tonnelles,0,8,8,2022,01-18,10:04
050 Parvis Jules Ferry - Gare Saint-Roch,7,1,8,2022,01-18,10:04
051 Pont de Lattes - Gare Saint-Roch,3,9,12,2022,01-18,10:04
053 Deux Ponts - Gare Saint-Roch,3,5,8,2022,01-18,10:04
054 Providence - Ovalie,5,3,8,2022,01-18,10:04
055 P�rols Etang de l'Or,24,44,68,2022,01-18,10:04
056 Albert 1er - Cath�drale,0,12,12,2022,01-18,10:04
057 Saint-Guilhem - Courreau,1,7,8,2022,01-18,10:04
059 Sud De France,1,7,8,2022,01-18,10:04
001 Rue Jules Ferry - Gare Saint-Roch,10,2,12,2022,01-18,10:14
002 Com�die,15,9,24,2022,01-18,10:14
003 Esplanade,17,15,32,2022,01-18,10:14
004 H�tel de Ville,14,2,16,2022,01-18,10:14
005 Corum,7,5,12,2022,01-18,10:14
006 Place Albert 1er - St Charles,12,19,31,2022,01-18,10:14
007 Foch,5,3,8,2022,01-18,10:14
008 Halles Castellane,6,6,12,2022,01-18,10:14
009 Observatoire,5,3,8,2022,01-18,10:14
010 Rondelet,6,10,16,2022,01-18,10:14
011 Plan Cabanes,4,8,12,2022,01-18,10:14
012 Boutonnet,3,9,12,2022,01-18,10:14
013 Emile Combes,3,5,8,2022,01-18,10:14
014 Beaux-Arts,2,6,8,2022,01-18,10:14
015 Les Aubes,3,5,8,2022,01-18,10:14
016 Antigone centre,7,9,16,2022,01-18,10:14
017 M�diath�que Emile Zola,14,2,16,2022,01-18,10:14
018 Nombre d'Or,6,10,16,2022,01-18,10:14
019 Louis Blanc,7,9,16,2022,01-18,10:14
020 Gambetta,1,7,8,2022,01-18,10:14
021 Port Marianne,10,6,16,2022,01-18,10:14
022 Clemenceau,0,12,12,2022,01-18,10:14
023 Les Arceaux,1,15,16,2022,01-18,10:14
024 Cit� Mion,4,4,8,2022,01-18,10:14
025 Nouveau Saint-Roch,4,4,8,2022,01-18,10:14
026 Renouvier,0,8,8,2022,01-18,10:14
027 Odysseum,5,3,8,2022,01-18,10:14
028 Saint-Denis,3,5,8,2022,01-18,10:14
029 Richter,10,6,16,2022,01-18,10:14
030 Charles Flahault,5,3,8,2022,01-18,10:14
031 Voltaire,1,7,8,2022,01-18,10:14
032 Pr�s d'Ar�nes,7,1,8,2022,01-18,10:14
033 Garcia Lorca,6,2,8,2022,01-18,10:14
034 Vert Bois,0,16,16,2022,01-18,10:14
035 Malbosc,2,6,8,2022,01-18,10:14
036 Occitanie,1,31,32,2022,01-18,10:14
037 FacdesSciences,8,16,24,2022,01-18,10:14
038 Fac de Lettres,4,12,16,2022,01-18,10:14
039 Aiguelongue,2,6,8,2022,01-18,10:14
040 Jeu de Mail des Abb�s,4,4,8,2022,01-18,10:14
041 Eurom�decine,1,7,8,2022,01-18,10:14
042 Marie Caizergues,2,6,8,2022,01-18,10:14
043 Sabines,3,5,8,2022,01-18,10:14
044 Celleneuve,1,7,8,2022,01-18,10:14
045 Jardin de la Lironde,3,5,8,2022,01-18,10:14
046 P�re Soulas,3,5,8,2022,01-18,10:14
047 Place Viala,4,4,8,2022,01-18,10:14
048 H�tel du D�partement,0,8,8,2022,01-18,10:14
049 Tonnelles,0,8,8,2022,01-18,10:14
050 Parvis Jules Ferry - Gare Saint-Roch,7,1,8,2022,01-18,10:14
051 Pont de Lattes - Gare Saint-Roch,3,9,12,2022,01-18,10:14
053 Deux Ponts - Gare Saint-Roch,3,5,8,2022,01-18,10:14
054 Providence - Ovalie,5,3,8,2022,01-18,10:14
055 P�rols Etang de l'Or,24,44,68,2022,01-18,10:14
056 Albert 1er - Cath�drale,0,12,12,2022,01-18,10:14
057 Saint-Guilhem - Courreau,1,7,8,2022,01-18,10:14
059 Sud De France,1,7,8,2022,01-18,10:14
001 Rue Jules Ferry - Gare Saint-Roch,10,2,12,2022,01-18,10:24
002 Com�die,15,9,24,2022,01-18,10:24
003 Esplanade,15,17,32,2022,01-18,10:24
004 H�tel de Ville,14,2,16,2022,01-18,10:24
005 Corum,7,5,12,2022,01-18,10:24
006 Place Albert 1er - St Charles,12,19,31,2022,01-18,10:24
007 Foch,5,3,8,2022,01-18,10:24
008 Halles Castellane,6,6,12,2022,01-18,10:24
009 Observatoire,5,3,8,2022,01-18,10:24
010 Rondelet,6,10,16,2022,01-18,10:24
011 Plan Cabanes,4,8,12,2022,01-18,10:24
012 Boutonnet,3,9,12,2022,01-18,10:24
013 Emile Combes,3,5,8,2022,01-18,10:24
014 Beaux-Arts,2,6,8,2022,01-18,10:24
015 Les Aubes,3,5,8,2022,01-18,10:24
016 Antigone centre,7,9,16,2022,01-18,10:24
017 M�diath�que Emile Zola,14,2,16,2022,01-18,10:24
018 Nombre d'Or,6,10,16,2022,01-18,10:24
019 Louis Blanc,7,9,16,2022,01-18,10:24
020 Gambetta,1,7,8,2022,01-18,10:24
021 Port Marianne,10,6,16,2022,01-18,10:24
022 Clemenceau,0,12,12,2022,01-18,10:24
023 Les Arceaux,1,15,16,2022,01-18,10:24
024 Cit� Mion,4,4,8,2022,01-18,10:24
025 Nouveau Saint-Roch,4,4,8,2022,01-18,10:24
026 Renouvier,0,8,8,2022,01-18,10:24
027 Odysseum,5,3,8,2022,01-18,10:24
028 Saint-Denis,3,5,8,2022,01-18,10:24
029 Richter,10,6,16,2022,01-18,10:24
030 Charles Flahault,5,3,8,2022,01-18,10:24
031 Voltaire,1,7,8,2022,01-18,10:24
032 Pr�s d'Ar�nes,7,1,8,2022,01-18,10:24
033 Garcia Lorca,6,2,8,2022,01-18,10:24
034 Vert Bois,0,16,16,2022,01-18,10:24
035 Malbosc,2,6,8,2022,01-18,10:24
036 Occitanie,2,30,32,2022,01-18,10:24
037 FacdesSciences,9,15,24,2022,01-18,10:24
038 Fac de Lettres,3,13,16,2022,01-18,10:24
039 Aiguelongue,2,6,8,2022,01-18,10:24
040 Jeu de Mail des Abb�s,4,4,8,2022,01-18,10:24
041 Eurom�decine,1,7,8,2022,01-18,10:24
042 Marie Caizergues,2,6,8,2022,01-18,10:24
043 Sabines,3,5,8,2022,01-18,10:24
044 Celleneuve,1,7,8,2022,01-18,10:24
045 Jardin de la Lironde,3,5,8,2022,01-18,10:24
046 P�re Soulas,3,5,8,2022,01-18,10:24
047 Place Viala,4,4,8,2022,01-18,10:24
048 H�tel du D�partement,0,8,8,2022,01-18,10:24
049 Tonnelles,0,8,8,2022,01-18,10:24
050 Parvis Jules Ferry - Gare Saint-Roch,7,1,8,2022,01-18,10:24
051 Pont de Lattes - Gare Saint-Roch,3,9,12,2022,01-18,10:24
053 Deux Ponts - Gare Saint-Roch,3,5,8,2022,01-18,10:24
054 Providence - Ovalie,5,3,8,2022,01-18,10:24
055 P�rols Etang de l'Or,24,44,68,2022,01-18,10:24
056 Albert 1er - Cath�drale,0,12,12,2022,01-18,10:24
057 Saint-Guilhem - Courreau,1,7,8,2022,01-18,10:24
059 Sud De France,1,7,8,2022,01-18,10:24
001 Rue Jules Ferry - Gare Saint-Roch,10,2,12,2022,01-18,10:34
002 Com�die,15,9,24,2022,01-18,10:34
003 Esplanade,15,17,32,2022,01-18,10:34
004 H�tel de Ville,14,2,16,2022,01-18,10:34
005 Corum,7,5,12,2022,01-18,10:34
006 Place Albert 1er - St Charles,12,19,31,2022,01-18,10:34
007 Foch,5,3,8,2022,01-18,10:34
008 Halles Castellane,6,6,12,2022,01-18,10:34
009 Observatoire,5,3,8,2022,01-18,10:34
010 Rondelet,6,10,16,2022,01-18,10:34
011 Plan Cabanes,4,8,12,2022,01-18,10:34
012 Boutonnet,3,9,12,2022,01-18,10:34
013 Emile Combes,3,5,8,2022,01-18,10:34
014 Beaux-Arts,2,6,8,2022,01-18,10:34
015 Les Aubes,3,5,8,2022,01-18,10:34
016 Antigone centre,7,9,16,2022,01-18,10:34
017 M�diath�que Emile Zola,13,3,16,2022,01-18,10:34
018 Nombre d'Or,6,10,16,2022,01-18,10:34
019 Louis Blanc,7,9,16,2022,01-18,10:34
020 Gambetta,1,7,8,2022,01-18,10:34
021 Port Marianne,10,6,16,2022,01-18,10:34
022 Clemenceau,0,12,12,2022,01-18,10:34
023 Les Arceaux,1,15,16,2022,01-18,10:34
024 Cit� Mion,4,4,8,2022,01-18,10:34
025 Nouveau Saint-Roch,4,4,8,2022,01-18,10:34
026 Renouvier,0,8,8,2022,01-18,10:34
027 Odysseum,5,3,8,2022,01-18,10:34
028 Saint-Denis,3,5,8,2022,01-18,10:34
029 Richter,10,6,16,2022,01-18,10:34
030 Charles Flahault,5,3,8,2022,01-18,10:34
031 Voltaire,1,7,8,2022,01-18,10:34
032 Pr�s d'Ar�nes,7,1,8,2022,01-18,10:34
033 Garcia Lorca,6,2,8,2022,01-18,10:34
034 Vert Bois,0,16,16,2022,01-18,10:34
035 Malbosc,2,6,8,2022,01-18,10:34
036 Occitanie,2,30,32,2022,01-18,10:34
037 FacdesSciences,9,15,24,2022,01-18,10:34
038 Fac de Lettres,3,13,16,2022,01-18,10:34
039 Aiguelongue,4,4,8,2022,01-18,10:34
040 Jeu de Mail des Abb�s,4,4,8,2022,01-18,10:34
041 Eurom�decine,1,7,8,2022,01-18,10:34
042 Marie Caizergues,2,6,8,2022,01-18,10:34
043 Sabines,3,5,8,2022,01-18,10:34
044 Celleneuve,1,7,8,2022,01-18,10:34
045 Jardin de la Lironde,3,5,8,2022,01-18,10:34
046 P�re Soulas,3,5,8,2022,01-18,10:34
047 Place Viala,4,4,8,2022,01-18,10:34
048 H�tel du D�partement,0,8,8,2022,01-18,10:34
049 Tonnelles,0,8,8,2022,01-18,10:34
050 Parvis Jules Ferry - Gare Saint-Roch,7,1,8,2022,01-18,10:34
051 Pont de Lattes - Gare Saint-Roch,3,9,12,2022,01-18,10:34
053 Deux Ponts - Gare Saint-Roch,3,5,8,2022,01-18,10:34
054 Providence - Ovalie,5,3,8,2022,01-18,10:34
055 P�rols Etang de l'Or,24,44,68,2022,01-18,10:34
056 Albert 1er - Cath�drale,0,12,12,2022,01-18,10:34
057 Saint-Guilhem - Courreau,1,7,8,2022,01-18,10:34
059 Sud De France,1,7,8,2022,01-18,10:34
001 Rue Jules Ferry - Gare Saint-Roch,10,2,12,2022,01-18,10:45
002 Com�die,15,9,24,2022,01-18,10:45
003 Esplanade,15,17,32,2022,01-18,10:45
004 H�tel de Ville,14,2,16,2022,01-18,10:45
005 Corum,7,5,12,2022,01-18,10:45
006 Place Albert 1er - St Charles,12,19,31,2022,01-18,10:45
007 Foch,5,3,8,2022,01-18,10:45
008 Halles Castellane,6,6,12,2022,01-18,10:45
009 Observatoire,5,3,8,2022,01-18,10:45
010 Rondelet,6,10,16,2022,01-18,10:45
011 Plan Cabanes,4,8,12,2022,01-18,10:45
012 Boutonnet,3,9,12,2022,01-18,10:45
013 Emile Combes,3,5,8,2022,01-18,10:45
014 Beaux-Arts,2,6,8,2022,01-18,10:45
015 Les Aubes,3,5,8,2022,01-18,10:45
016 Antigone centre,7,9,16,2022,01-18,10:45
017 M�diath�que Emile Zola,13,3,16,2022,01-18,10:45
018 Nombre d'Or,6,10,16,2022,01-18,10:45
019 Louis Blanc,7,9,16,2022,01-18,10:45
020 Gambetta,1,7,8,2022,01-18,10:45
021 Port Marianne,10,6,16,2022,01-18,10:45
022 Clemenceau,5,7,12,2022,01-18,10:45
023 Les Arceaux,1,15,16,2022,01-18,10:45
024 Cit� Mion,3,5,8,2022,01-18,10:45
025 Nouveau Saint-Roch,4,4,8,2022,01-18,10:45
026 Renouvier,0,8,8,2022,01-18,10:45
027 Odysseum,5,3,8,2022,01-18,10:45
028 Saint-Denis,3,5,8,2022,01-18,10:45
029 Richter,10,6,16,2022,01-18,10:45
030 Charles Flahault,5,3,8,2022,01-18,10:45
031 Voltaire,1,7,8,2022,01-18,10:45
032 Pr�s d'Ar�nes,7,1,8,2022,01-18,10:45
033 Garcia Lorca,6,2,8,2022,01-18,10:45
034 Vert Bois,0,16,16,2022,01-18,10:45
035 Malbosc,2,6,8,2022,01-18,10:45
036 Occitanie,2,30,32,2022,01-18,10:45
037 FacdesSciences,9,15,24,2022,01-18,10:45
038 Fac de Lettres,3,13,16,2022,01-18,10:45
039 Aiguelongue,4,4,8,2022,01-18,10:45
040 Jeu de Mail des Abb�s,4,4,8,2022,01-18,10:45
041 Eurom�decine,1,7,8,2022,01-18,10:45
042 Marie Caizergues,2,6,8,2022,01-18,10:45
043 Sabines,3,5,8,2022,01-18,10:45
044 Celleneuve,1,7,8,2022,01-18,10:45
045 Jardin de la Lironde,3,5,8,2022,01-18,10:45
046 P�re Soulas,3,5,8,2022,01-18,10:45
047 Place Viala,4,4,8,2022,01-18,10:45
048 H�tel du D�partement,0,8,8,2022,01-18,10:45
049 Tonnelles,0,8,8,2022,01-18,10:45
050 Parvis Jules Ferry - Gare Saint-Roch,7,1,8,2022,01-18,10:45
051 Pont de Lattes - Gare Saint-Roch,3,9,12,2022,01-18,10:45
053 Deux Ponts - Gare Saint-Roch,3,5,8,2022,01-18,10:45
054 Providence - Ovalie,5,3,8,2022,01-18,10:45
055 P�rols Etang de l'Or,24,44,68,2022,01-18,10:45
056 Albert 1er - Cath�drale,6,6,12,2022,01-18,10:45
057 Saint-Guilhem - Courreau,1,7,8,2022,01-18,10:45
059 Sud De France,1,7,8,2022,01-18,10:45
001 Rue Jules Ferry - Gare Saint-Roch,10,2,12,2022,01-18,10:55
002 Com�die,16,8,24,2022,01-18,10:55
003 Esplanade,15,17,32,2022,01-18,10:55
004 H�tel de Ville,14,2,16,2022,01-18,10:55
005 Corum,7,5,12,2022,01-18,10:55
006 Place Albert 1er - St Charles,12,19,31,2022,01-18,10:55
007 Foch,5,3,8,2022,01-18,10:55
008 Halles Castellane,6,6,12,2022,01-18,10:55
009 Observatoire,5,3,8,2022,01-18,10:55
010 Rondelet,6,10,16,2022,01-18,10:55
011 Plan Cabanes,4,8,12,2022,01-18,10:55
012 Boutonnet,3,9,12,2022,01-18,10:55
013 Emile Combes,3,5,8,2022,01-18,10:55
014 Beaux-Arts,2,6,8,2022,01-18,10:55
015 Les Aubes,3,5,8,2022,01-18,10:55
016 Antigone centre,7,9,16,2022,01-18,10:55
017 M�diath�que Emile Zola,13,3,16,2022,01-18,10:55
018 Nombre d'Or,5,11,16,2022,01-18,10:55
019 Louis Blanc,7,9,16,2022,01-18,10:55
020 Gambetta,1,7,8,2022,01-18,10:55
021 Port Marianne,10,6,16,2022,01-18,10:55
022 Clemenceau,5,7,12,2022,01-18,10:55
023 Les Arceaux,1,15,16,2022,01-18,10:55
024 Cit� Mion,3,5,8,2022,01-18,10:55
025 Nouveau Saint-Roch,4,4,8,2022,01-18,10:55
026 Renouvier,0,8,8,2022,01-18,10:55
027 Odysseum,5,3,8,2022,01-18,10:55
028 Saint-Denis,3,5,8,2022,01-18,10:55
029 Richter,10,6,16,2022,01-18,10:55
030 Charles Flahault,5,3,8,2022,01-18,10:55
031 Voltaire,2,6,8,2022,01-18,10:55
032 Pr�s d'Ar�nes,7,1,8,2022,01-18,10:55
033 Garcia Lorca,6,2,8,2022,01-18,10:55
034 Vert Bois,0,16,16,2022,01-18,10:55
035 Malbosc,2,6,8,2022,01-18,10:55
036 Occitanie,2,30,32,2022,01-18,10:55
037 FacdesSciences,9,15,24,2022,01-18,10:55
038 Fac de Lettres,3,13,16,2022,01-18,10:55
039 Aiguelongue,4,4,8,2022,01-18,10:55
040 Jeu de Mail des Abb�s,4,4,8,2022,01-18,10:55
041 Eurom�decine,1,7,8,2022,01-18,10:55
042 Marie Caizergues,2,6,8,2022,01-18,10:55
043 Sabines,3,5,8,2022,01-18,10:55
044 Celleneuve,1,7,8,2022,01-18,10:55
045 Jardin de la Lironde,3,5,8,2022,01-18,10:55
046 P�re Soulas,2,6,8,2022,01-18,10:55
047 Place Viala,4,4,8,2022,01-18,10:55
048 H�tel du D�partement,0,8,8,2022,01-18,10:55
049 Tonnelles,0,8,8,2022,01-18,10:55
050 Parvis Jules Ferry - Gare Saint-Roch,7,1,8,2022,01-18,10:55
051 Pont de Lattes - Gare Saint-Roch,3,9,12,2022,01-18,10:55
053 Deux Ponts - Gare Saint-Roch,3,5,8,2022,01-18,10:55
054 Providence - Ovalie,5,3,8,2022,01-18,10:55
055 P�rols Etang de l'Or,24,44,68,2022,01-18,10:55
056 Albert 1er - Cath�drale,7,5,12,2022,01-18,10:55
057 Saint-Guilhem - Courreau,1,7,8,2022,01-18,10:55
059 Sud De France,1,7,8,2022,01-18,10:55
001 Rue Jules Ferry - Gare Saint-Roch,10,2,12,2022,01-18,11:05
002 Com�die,16,8,24,2022,01-18,11:05
003 Esplanade,16,16,32,2022,01-18,11:05
004 H�tel de Ville,14,2,16,2022,01-18,11:05
005 Corum,7,5,12,2022,01-18,11:05
006 Place Albert 1er - St Charles,12,19,31,2022,01-18,11:05
007 Foch,5,3,8,2022,01-18,11:05
008 Halles Castellane,6,6,12,2022,01-18,11:05
009 Observatoire,5,3,8,2022,01-18,11:05
010 Rondelet,6,10,16,2022,01-18,11:05
011 Plan Cabanes,4,8,12,2022,01-18,11:05
012 Boutonnet,3,9,12,2022,01-18,11:05
013 Emile Combes,3,5,8,2022,01-18,11:05
014 Beaux-Arts,2,6,8,2022,01-18,11:05
015 Les Aubes,3,5,8,2022,01-18,11:05
016 Antigone centre,7,9,16,2022,01-18,11:05
017 M�diath�que Emile Zola,13,3,16,2022,01-18,11:05
018 Nombre d'Or,5,11,16,2022,01-18,11:05
019 Louis Blanc,6,10,16,2022,01-18,11:05
020 Gambetta,1,7,8,2022,01-18,11:05
021 Port Marianne,10,6,16,2022,01-18,11:05
022 Clemenceau,5,7,12,2022,01-18,11:05
023 Les Arceaux,1,15,16,2022,01-18,11:05
024 Cit� Mion,3,5,8,2022,01-18,11:05
025 Nouveau Saint-Roch,4,4,8,2022,01-18,11:05
026 Renouvier,0,8,8,2022,01-18,11:05
027 Odysseum,5,3,8,2022,01-18,11:05
028 Saint-Denis,3,5,8,2022,01-18,11:05
029 Richter,10,6,16,2022,01-18,11:05
030 Charles Flahault,5,3,8,2022,01-18,11:05
031 Voltaire,2,6,8,2022,01-18,11:05
032 Pr�s d'Ar�nes,7,1,8,2022,01-18,11:05
033 Garcia Lorca,6,2,8,2022,01-18,11:05
034 Vert Bois,0,16,16,2022,01-18,11:05
035 Malbosc,2,6,8,2022,01-18,11:05
036 Occitanie,2,30,32,2022,01-18,11:05
037 FacdesSciences,11,13,24,2022,01-18,11:05
038 Fac de Lettres,3,13,16,2022,01-18,11:05
039 Aiguelongue,4,4,8,2022,01-18,11:05
040 Jeu de Mail des Abb�s,4,4,8,2022,01-18,11:05
041 Eurom�decine,1,7,8,2022,01-18,11:05
042 Marie Caizergues,2,6,8,2022,01-18,11:05
043 Sabines,3,5,8,2022,01-18,11:05
044 Celleneuve,0,8,8,2022,01-18,11:05
045 Jardin de la Lironde,3,5,8,2022,01-18,11:05
046 P�re Soulas,2,6,8,2022,01-18,11:05
047 Place Viala,4,4,8,2022,01-18,11:05
048 H�tel du D�partement,0,8,8,2022,01-18,11:05
049 Tonnelles,0,8,8,2022,01-18,11:05
050 Parvis Jules Ferry - Gare Saint-Roch,7,1,8,2022,01-18,11:05
051 Pont de Lattes - Gare Saint-Roch,3,9,12,2022,01-18,11:05
053 Deux Ponts - Gare Saint-Roch,3,5,8,2022,01-18,11:05
054 Providence - Ovalie,5,3,8,2022,01-18,11:05
055 P�rols Etang de l'Or,24,44,68,2022,01-18,11:05
056 Albert 1er - Cath�drale,7,5,12,2022,01-18,11:05
057 Saint-Guilhem - Courreau,1,7,8,2022,01-18,11:05
059 Sud De France,1,7,8,2022,01-18,11:05
001 Rue Jules Ferry - Gare Saint-Roch,10,2,12,2022,01-18,11:15
002 Com�die,16,8,24,2022,01-18,11:15
003 Esplanade,16,16,32,2022,01-18,11:15
004 H�tel de Ville,14,2,16,2022,01-18,11:15
005 Corum,7,5,12,2022,01-18,11:15
006 Place Albert 1er - St Charles,12,19,31,2022,01-18,11:15
007 Foch,5,3,8,2022,01-18,11:15
008 Halles Castellane,6,6,12,2022,01-18,11:15
009 Observatoire,5,3,8,2022,01-18,11:15
010 Rondelet,6,10,16,2022,01-18,11:15
011 Plan Cabanes,5,7,12,2022,01-18,11:15
012 Boutonnet,3,9,12,2022,01-18,11:15
013 Emile Combes,3,5,8,2022,01-18,11:15
014 Beaux-Arts,2,6,8,2022,01-18,11:15
015 Les Aubes,3,5,8,2022,01-18,11:15
016 Antigone centre,7,9,16,2022,01-18,11:15
017 M�diath�que Emile Zola,13,3,16,2022,01-18,11:15
018 Nombre d'Or,5,11,16,2022,01-18,11:15
019 Louis Blanc,6,10,16,2022,01-18,11:15
020 Gambetta,1,7,8,2022,01-18,11:15
021 Port Marianne,10,6,16,2022,01-18,11:15
022 Clemenceau,5,7,12,2022,01-18,11:15
023 Les Arceaux,1,15,16,2022,01-18,11:15
024 Cit� Mion,3,5,8,2022,01-18,11:15
025 Nouveau Saint-Roch,3,5,8,2022,01-18,11:15
026 Renouvier,0,8,8,2022,01-18,11:15
027 Odysseum,5,3,8,2022,01-18,11:15
028 Saint-Denis,4,4,8,2022,01-18,11:15
029 Richter,10,6,16,2022,01-18,11:15
030 Charles Flahault,5,3,8,2022,01-18,11:15
031 Voltaire,2,6,8,2022,01-18,11:15
032 Pr�s d'Ar�nes,7,1,8,2022,01-18,11:15
033 Garcia Lorca,6,2,8,2022,01-18,11:15
034 Vert Bois,0,16,16,2022,01-18,11:15
035 Malbosc,2,6,8,2022,01-18,11:15
036 Occitanie,2,30,32,2022,01-18,11:15
037 FacdesSciences,8,16,24,2022,01-18,11:15
038 Fac de Lettres,3,13,16,2022,01-18,11:15
039 Aiguelongue,4,4,8,2022,01-18,11:15
040 Jeu de Mail des Abb�s,4,4,8,2022,01-18,11:15
041 Eurom�decine,1,7,8,2022,01-18,11:15
042 Marie Caizergues,2,6,8,2022,01-18,11:15
043 Sabines,3,5,8,2022,01-18,11:15
044 Celleneuve,0,8,8,2022,01-18,11:15
045 Jardin de la Lironde,3,5,8,2022,01-18,11:15
046 P�re Soulas,2,6,8,2022,01-18,11:15
047 Place Viala,4,4,8,2022,01-18,11:15
048 H�tel du D�partement,0,8,8,2022,01-18,11:15
049 Tonnelles,0,8,8,2022,01-18,11:15
050 Parvis Jules Ferry - Gare Saint-Roch,7,1,8,2022,01-18,11:15
051 Pont de Lattes - Gare Saint-Roch,4,8,12,2022,01-18,11:15
053 Deux Ponts - Gare Saint-Roch,3,5,8,2022,01-18,11:15
054 Providence - Ovalie,5,3,8,2022,01-18,11:15
055 P�rols Etang de l'Or,24,44,68,2022,01-18,11:15
056 Albert 1er - Cath�drale,7,5,12,2022,01-18,11:15
057 Saint-Guilhem - Courreau,1,7,8,2022,01-18,11:15
059 Sud De France,1,7,8,2022,01-18,11:15
001 Rue Jules Ferry - Gare Saint-Roch,10,2,12,2022,01-18,11:25
002 Com�die,16,8,24,2022,01-18,11:25
003 Esplanade,16,16,32,2022,01-18,11:25
004 H�tel de Ville,14,2,16,2022,01-18,11:25
005 Corum,7,5,12,2022,01-18,11:25
006 Place Albert 1er - St Charles,12,19,31,2022,01-18,11:25
007 Foch,5,3,8,2022,01-18,11:25
008 Halles Castellane,6,6,12,2022,01-18,11:25
009 Observatoire,3,5,8,2022,01-18,11:25
010 Rondelet,6,10,16,2022,01-18,11:25
011 Plan Cabanes,5,7,12,2022,01-18,11:25
012 Boutonnet,3,9,12,2022,01-18,11:25
013 Emile Combes,3,5,8,2022,01-18,11:25
014 Beaux-Arts,2,6,8,2022,01-18,11:25
015 Les Aubes,3,5,8,2022,01-18,11:25
016 Antigone centre,7,9,16,2022,01-18,11:25
017 M�diath�que Emile Zola,13,3,16,2022,01-18,11:25
018 Nombre d'Or,5,11,16,2022,01-18,11:25
019 Louis Blanc,6,10,16,2022,01-18,11:25
020 Gambetta,1,7,8,2022,01-18,11:25
021 Port Marianne,10,6,16,2022,01-18,11:25
022 Clemenceau,5,7,12,2022,01-18,11:25
023 Les Arceaux,1,15,16,2022,01-18,11:25
024 Cit� Mion,3,5,8,2022,01-18,11:25
025 Nouveau Saint-Roch,3,5,8,2022,01-18,11:25
026 Renouvier,0,8,8,2022,01-18,11:25
027 Odysseum,5,3,8,2022,01-18,11:25
028 Saint-Denis,4,4,8,2022,01-18,11:25
029 Richter,9,7,16,2022,01-18,11:25
030 Charles Flahault,5,3,8,2022,01-18,11:25
031 Voltaire,2,6,8,2022,01-18,11:25
032 Pr�s d'Ar�nes,7,1,8,2022,01-18,11:25
033 Garcia Lorca,6,2,8,2022,01-18,11:25
034 Vert Bois,0,16,16,2022,01-18,11:25
035 Malbosc,2,6,8,2022,01-18,11:25
036 Occitanie,2,30,32,2022,01-18,11:25
037 FacdesSciences,8,16,24,2022,01-18,11:25
038 Fac de Lettres,3,13,16,2022,01-18,11:25
039 Aiguelongue,4,4,8,2022,01-18,11:25
040 Jeu de Mail des Abb�s,4,4,8,2022,01-18,11:25
041 Eurom�decine,1,7,8,2022,01-18,11:25
042 Marie Caizergues,2,6,8,2022,01-18,11:25
043 Sabines,3,5,8,2022,01-18,11:25
044 Celleneuve,0,8,8,2022,01-18,11:25
045 Jardin de la Lironde,3,5,8,2022,01-18,11:25
046 P�re Soulas,3,5,8,2022,01-18,11:25
047 Place Viala,4,4,8,2022,01-18,11:25
048 H�tel du D�partement,0,8,8,2022,01-18,11:25
049 Tonnelles,0,8,8,2022,01-18,11:25
050 Parvis Jules Ferry - Gare Saint-Roch,7,1,8,2022,01-18,11:25
051 Pont de Lattes - Gare Saint-Roch,4,8,12,2022,01-18,11:25
053 Deux Ponts - Gare Saint-Roch,3,5,8,2022,01-18,11:25
054 Providence - Ovalie,5,3,8,2022,01-18,11:25
055 P�rols Etang de l'Or,24,44,68,2022,01-18,11:25
056 Albert 1er - Cath�drale,7,5,12,2022,01-18,11:25
057 Saint-Guilhem - Courreau,1,7,8,2022,01-18,11:25
059 Sud De France,1,7,8,2022,01-18,11:25
001 Rue Jules Ferry - Gare Saint-Roch,10,2,12,2022,01-18,11:35
002 Com�die,16,8,24,2022,01-18,11:35
003 Esplanade,16,16,32,2022,01-18,11:35
004 H�tel de Ville,14,2,16,2022,01-18,11:35
005 Corum,7,5,12,2022,01-18,11:35
006 Place Albert 1er - St Charles,12,19,31,2022,01-18,11:35
007 Foch,5,3,8,2022,01-18,11:35
008 Halles Castellane,6,6,12,2022,01-18,11:35
009 Observatoire,3,5,8,2022,01-18,11:35
010 Rondelet,6,10,16,2022,01-18,11:35
011 Plan Cabanes,5,7,12,2022,01-18,11:35
012 Boutonnet,3,9,12,2022,01-18,11:35
013 Emile Combes,3,5,8,2022,01-18,11:35
014 Beaux-Arts,2,6,8,2022,01-18,11:35
015 Les Aubes,3,5,8,2022,01-18,11:35
016 Antigone centre,7,9,16,2022,01-18,11:35
017 M�diath�que Emile Zola,13,3,16,2022,01-18,11:35
018 Nombre d'Or,5,11,16,2022,01-18,11:35
019 Louis Blanc,6,10,16,2022,01-18,11:35
020 Gambetta,1,7,8,2022,01-18,11:35
021 Port Marianne,10,6,16,2022,01-18,11:35
022 Clemenceau,5,7,12,2022,01-18,11:35
023 Les Arceaux,1,15,16,2022,01-18,11:35
024 Cit� Mion,3,5,8,2022,01-18,11:35
025 Nouveau Saint-Roch,3,5,8,2022,01-18,11:35
026 Renouvier,0,8,8,2022,01-18,11:35
027 Odysseum,5,3,8,2022,01-18,11:35
028 Saint-Denis,4,4,8,2022,01-18,11:35
029 Richter,8,8,16,2022,01-18,11:35
030 Charles Flahault,5,3,8,2022,01-18,11:35
031 Voltaire,2,6,8,2022,01-18,11:35
032 Pr�s d'Ar�nes,7,1,8,2022,01-18,11:35
033 Garcia Lorca,6,2,8,2022,01-18,11:35
034 Vert Bois,0,16,16,2022,01-18,11:35
035 Malbosc,2,6,8,2022,01-18,11:35
036 Occitanie,2,30,32,2022,01-18,11:35
037 FacdesSciences,9,15,24,2022,01-18,11:35
038 Fac de Lettres,3,13,16,2022,01-18,11:35
039 Aiguelongue,4,4,8,2022,01-18,11:35
040 Jeu de Mail des Abb�s,4,4,8,2022,01-18,11:35
041 Eurom�decine,1,7,8,2022,01-18,11:35
042 Marie Caizergues,2,6,8,2022,01-18,11:35
043 Sabines,3,5,8,2022,01-18,11:35
044 Celleneuve,0,8,8,2022,01-18,11:35
045 Jardin de la Lironde,3,5,8,2022,01-18,11:35
046 P�re Soulas,4,4,8,2022,01-18,11:35
047 Place Viala,4,4,8,2022,01-18,11:35
048 H�tel du D�partement,0,8,8,2022,01-18,11:35
049 Tonnelles,0,8,8,2022,01-18,11:35
050 Parvis Jules Ferry - Gare Saint-Roch,7,1,8,2022,01-18,11:35
051 Pont de Lattes - Gare Saint-Roch,4,8,12,2022,01-18,11:35
053 Deux Ponts - Gare Saint-Roch,3,5,8,2022,01-18,11:35
054 Providence - Ovalie,5,3,8,2022,01-18,11:35
055 P�rols Etang de l'Or,22,46,68,2022,01-18,11:35
056 Albert 1er - Cath�drale,7,5,12,2022,01-18,11:35
057 Saint-Guilhem - Courreau,1,7,8,2022,01-18,11:35
059 Sud De France,1,7,8,2022,01-18,11:35
001 Rue Jules Ferry - Gare Saint-Roch,10,2,12,2022,01-18,11:46
002 Com�die,16,8,24,2022,01-18,11:46
003 Esplanade,16,16,32,2022,01-18,11:46
004 H�tel de Ville,14,2,16,2022,01-18,11:46
005 Corum,7,5,12,2022,01-18,11:46
006 Place Albert 1er - St Charles,11,20,31,2022,01-18,11:46
007 Foch,5,3,8,2022,01-18,11:46
008 Halles Castellane,4,8,12,2022,01-18,11:46
009 Observatoire,3,5,8,2022,01-18,11:46
010 Rondelet,6,10,16,2022,01-18,11:46
011 Plan Cabanes,5,7,12,2022,01-18,11:46
012 Boutonnet,3,9,12,2022,01-18,11:46
013 Emile Combes,3,5,8,2022,01-18,11:46
014 Beaux-Arts,2,6,8,2022,01-18,11:46
015 Les Aubes,3,5,8,2022,01-18,11:46
016 Antigone centre,7,9,16,2022,01-18,11:46
017 M�diath�que Emile Zola,13,3,16,2022,01-18,11:46
018 Nombre d'Or,5,11,16,2022,01-18,11:46
019 Louis Blanc,6,10,16,2022,01-18,11:46
020 Gambetta,1,7,8,2022,01-18,11:46
021 Port Marianne,10,6,16,2022,01-18,11:46
022 Clemenceau,5,7,12,2022,01-18,11:46
023 Les Arceaux,1,15,16,2022,01-18,11:46
024 Cit� Mion,3,5,8,2022,01-18,11:46
025 Nouveau Saint-Roch,3,5,8,2022,01-18,11:46
026 Renouvier,0,8,8,2022,01-18,11:46
027 Odysseum,5,3,8,2022,01-18,11:46
028 Saint-Denis,4,4,8,2022,01-18,11:46
029 Richter,8,8,16,2022,01-18,11:46
030 Charles Flahault,5,3,8,2022,01-18,11:46
031 Voltaire,2,6,8,2022,01-18,11:46
032 Pr�s d'Ar�nes,7,1,8,2022,01-18,11:46
033 Garcia Lorca,6,2,8,2022,01-18,11:46
034 Vert Bois,0,16,16,2022,01-18,11:46
035 Malbosc,2,6,8,2022,01-18,11:46
036 Occitanie,2,30,32,2022,01-18,11:46
037 FacdesSciences,9,15,24,2022,01-18,11:46
038 Fac de Lettres,3,13,16,2022,01-18,11:46
039 Aiguelongue,4,4,8,2022,01-18,11:46
040 Jeu de Mail des Abb�s,4,4,8,2022,01-18,11:46
041 Eurom�decine,1,7,8,2022,01-18,11:46
042 Marie Caizergues,2,6,8,2022,01-18,11:46
043 Sabines,3,5,8,2022,01-18,11:46
044 Celleneuve,0,8,8,2022,01-18,11:46
045 Jardin de la Lironde,3,5,8,2022,01-18,11:46
046 P�re Soulas,4,4,8,2022,01-18,11:46
047 Place Viala,4,4,8,2022,01-18,11:46
048 H�tel du D�partement,0,8,8,2022,01-18,11:46
049 Tonnelles,0,8,8,2022,01-18,11:46
050 Parvis Jules Ferry - Gare Saint-Roch,7,1,8,2022,01-18,11:46
051 Pont de Lattes - Gare Saint-Roch,4,8,12,2022,01-18,11:46
053 Deux Ponts - Gare Saint-Roch,3,5,8,2022,01-18,11:46
054 Providence - Ovalie,5,3,8,2022,01-18,11:46
055 P�rols Etang de l'Or,22,46,68,2022,01-18,11:46
056 Albert 1er - Cath�drale,7,5,12,2022,01-18,11:46
057 Saint-Guilhem - Courreau,0,8,8,2022,01-18,11:46
059 Sud De France,1,7,8,2022,01-18,11:46
001 Rue Jules Ferry - Gare Saint-Roch,10,2,12,2022,01-18,11:56
002 Com�die,16,8,24,2022,01-18,11:56
003 Esplanade,16,16,32,2022,01-18,11:56
004 H�tel de Ville,14,2,16,2022,01-18,11:56
005 Corum,7,5,12,2022,01-18,11:56
006 Place Albert 1er - St Charles,11,20,31,2022,01-18,11:56
007 Foch,5,3,8,2022,01-18,11:56
008 Halles Castellane,4,8,12,2022,01-18,11:56
009 Observatoire,3,5,8,2022,01-18,11:56
010 Rondelet,6,10,16,2022,01-18,11:56
011 Plan Cabanes,6,6,12,2022,01-18,11:56
012 Boutonnet,4,8,12,2022,01-18,11:56
013 Emile Combes,3,5,8,2022,01-18,11:56
014 Beaux-Arts,2,6,8,2022,01-18,11:56
015 Les Aubes,3,5,8,2022,01-18,11:56
016 Antigone centre,10,6,16,2022,01-18,11:56
017 M�diath�que Emile Zola,13,3,16,2022,01-18,11:56
018 Nombre d'Or,5,11,16,2022,01-18,11:56
019 Louis Blanc,6,10,16,2022,01-18,11:56
020 Gambetta,1,7,8,2022,01-18,11:56
021 Port Marianne,10,6,16,2022,01-18,11:56
022 Clemenceau,5,7,12,2022,01-18,11:56
023 Les Arceaux,1,15,16,2022,01-18,11:56
024 Cit� Mion,3,5,8,2022,01-18,11:56
025 Nouveau Saint-Roch,3,5,8,2022,01-18,11:56
026 Renouvier,2,5,8,2022,01-18,11:56
027 Odysseum,5,3,8,2022,01-18,11:56
028 Saint-Denis,4,4,8,2022,01-18,11:56
029 Richter,8,8,16,2022,01-18,11:56
030 Charles Flahault,5,3,8,2022,01-18,11:56
031 Voltaire,2,6,8,2022,01-18,11:56
032 Pr�s d'Ar�nes,7,1,8,2022,01-18,11:56
033 Garcia Lorca,6,2,8,2022,01-18,11:56
034 Vert Bois,0,16,16,2022,01-18,11:56
035 Malbosc,2,6,8,2022,01-18,11:56
036 Occitanie,1,31,32,2022,01-18,11:56
037 FacdesSciences,9,15,24,2022,01-18,11:56
038 Fac de Lettres,3,13,16,2022,01-18,11:56
039 Aiguelongue,4,4,8,2022,01-18,11:56
040 Jeu de Mail des Abb�s,4,4,8,2022,01-18,11:56
041 Eurom�decine,1,7,8,2022,01-18,11:56
042 Marie Caizergues,2,6,8,2022,01-18,11:56
043 Sabines,3,5,8,2022,01-18,11:56
044 Celleneuve,0,8,8,2022,01-18,11:56
045 Jardin de la Lironde,3,5,8,2022,01-18,11:56
046 P�re Soulas,4,4,8,2022,01-18,11:56
047 Place Viala,4,4,8,2022,01-18,11:56
048 H�tel du D�partement,0,8,8,2022,01-18,11:56
049 Tonnelles,0,8,8,2022,01-18,11:56
050 Parvis Jules Ferry - Gare Saint-Roch,7,1,8,2022,01-18,11:56
051 Pont de Lattes - Gare Saint-Roch,4,8,12,2022,01-18,11:56
053 Deux Ponts - Gare Saint-Roch,3,5,8,2022,01-18,11:56
054 Providence - Ovalie,5,3,8,2022,01-18,11:56
055 P�rols Etang de l'Or,22,46,68,2022,01-18,11:56
056 Albert 1er - Cath�drale,7,5,12,2022,01-18,11:56
057 Saint-Guilhem - Courreau,0,8,8,2022,01-18,11:56
059 Sud De France,1,7,8,2022,01-18,11:56
001 Rue Jules Ferry - Gare Saint-Roch,10,2,12,2022,01-18,12:06
002 Com�die,16,8,24,2022,01-18,12:06
003 Esplanade,16,16,32,2022,01-18,12:06
004 H�tel de Ville,14,2,16,2022,01-18,12:06
005 Corum,7,5,12,2022,01-18,12:06
006 Place Albert 1er - St Charles,11,20,31,2022,01-18,12:06
007 Foch,5,3,8,2022,01-18,12:06
008 Halles Castellane,4,8,12,2022,01-18,12:06
009 Observatoire,3,5,8,2022,01-18,12:06
010 Rondelet,6,10,16,2022,01-18,12:06
011 Plan Cabanes,6,6,12,2022,01-18,12:06
012 Boutonnet,4,8,12,2022,01-18,12:06
013 Emile Combes,3,5,8,2022,01-18,12:06
014 Beaux-Arts,2,6,8,2022,01-18,12:06
015 Les Aubes,3,5,8,2022,01-18,12:06
016 Antigone centre,10,6,16,2022,01-18,12:06
017 M�diath�que Emile Zola,13,3,16,2022,01-18,12:06
018 Nombre d'Or,4,12,16,2022,01-18,12:06
019 Louis Blanc,6,10,16,2022,01-18,12:06
020 Gambetta,1,7,8,2022,01-18,12:06
021 Port Marianne,11,5,16,2022,01-18,12:06
022 Clemenceau,5,7,12,2022,01-18,12:06
023 Les Arceaux,1,15,16,2022,01-18,12:06
024 Cit� Mion,3,5,8,2022,01-18,12:06
025 Nouveau Saint-Roch,3,5,8,2022,01-18,12:06
026 Renouvier,2,5,8,2022,01-18,12:06
027 Odysseum,5,3,8,2022,01-18,12:06
028 Saint-Denis,4,4,8,2022,01-18,12:06
029 Richter,8,8,16,2022,01-18,12:06
030 Charles Flahault,4,4,8,2022,01-18,12:06
031 Voltaire,2,6,8,2022,01-18,12:06
032 Pr�s d'Ar�nes,7,1,8,2022,01-18,12:06
033 Garcia Lorca,6,2,8,2022,01-18,12:06
034 Vert Bois,0,16,16,2022,01-18,12:06
035 Malbosc,2,6,8,2022,01-18,12:06
036 Occitanie,1,31,32,2022,01-18,12:06
037 FacdesSciences,10,14,24,2022,01-18,12:06
038 Fac de Lettres,2,14,16,2022,01-18,12:06
039 Aiguelongue,4,4,8,2022,01-18,12:06
040 Jeu de Mail des Abb�s,4,4,8,2022,01-18,12:06
041 Eurom�decine,1,7,8,2022,01-18,12:06
042 Marie Caizergues,2,6,8,2022,01-18,12:06
043 Sabines,3,5,8,2022,01-18,12:06
044 Celleneuve,0,8,8,2022,01-18,12:06
045 Jardin de la Lironde,3,5,8,2022,01-18,12:06
046 P�re Soulas,4,4,8,2022,01-18,12:06
047 Place Viala,4,4,8,2022,01-18,12:06
048 H�tel du D�partement,0,8,8,2022,01-18,12:06
049 Tonnelles,0,8,8,2022,01-18,12:06
050 Parvis Jules Ferry - Gare Saint-Roch,7,1,8,2022,01-18,12:06
051 Pont de Lattes - Gare Saint-Roch,4,8,12,2022,01-18,12:06
053 Deux Ponts - Gare Saint-Roch,3,5,8,2022,01-18,12:06
054 Providence - Ovalie,5,3,8,2022,01-18,12:06
055 P�rols Etang de l'Or,22,46,68,2022,01-18,12:06
056 Albert 1er - Cath�drale,7,5,12,2022,01-18,12:06
057 Saint-Guilhem - Courreau,0,8,8,2022,01-18,12:06
059 Sud De France,1,7,8,2022,01-18,12:06
001 Rue Jules Ferry - Gare Saint-Roch,10,2,12,2022,01-18,12:16
002 Com�die,16,8,24,2022,01-18,12:16
003 Esplanade,16,16,32,2022,01-18,12:16
004 H�tel de Ville,14,2,16,2022,01-18,12:16
005 Corum,7,5,12,2022,01-18,12:16
006 Place Albert 1er - St Charles,11,20,31,2022,01-18,12:16
007 Foch,5,3,8,2022,01-18,12:16
008 Halles Castellane,4,8,12,2022,01-18,12:16
009 Observatoire,3,5,8,2022,01-18,12:16
010 Rondelet,6,10,16,2022,01-18,12:16
011 Plan Cabanes,7,5,12,2022,01-18,12:16
012 Boutonnet,5,7,12,2022,01-18,12:16
013 Emile Combes,3,5,8,2022,01-18,12:16
014 Beaux-Arts,2,6,8,2022,01-18,12:16
015 Les Aubes,3,5,8,2022,01-18,12:16
016 Antigone centre,10,6,16,2022,01-18,12:16
017 M�diath�que Emile Zola,13,3,16,2022,01-18,12:16
018 Nombre d'Or,4,12,16,2022,01-18,12:16
019 Louis Blanc,4,12,16,2022,01-18,12:16
020 Gambetta,1,7,8,2022,01-18,12:16
021 Port Marianne,8,8,16,2022,01-18,12:16
022 Clemenceau,5,7,12,2022,01-18,12:16
023 Les Arceaux,1,15,16,2022,01-18,12:16
024 Cit� Mion,3,5,8,2022,01-18,12:16
025 Nouveau Saint-Roch,3,5,8,2022,01-18,12:16
026 Renouvier,2,5,8,2022,01-18,12:16
027 Odysseum,5,3,8,2022,01-18,12:16
028 Saint-Denis,4,4,8,2022,01-18,12:16
029 Richter,7,9,16,2022,01-18,12:16
030 Charles Flahault,4,4,8,2022,01-18,12:16
031 Voltaire,2,6,8,2022,01-18,12:16
032 Pr�s d'Ar�nes,7,1,8,2022,01-18,12:16
033 Garcia Lorca,6,2,8,2022,01-18,12:16
034 Vert Bois,0,16,16,2022,01-18,12:16
035 Malbosc,2,6,8,2022,01-18,12:16
036 Occitanie,1,31,32,2022,01-18,12:16
037 FacdesSciences,10,14,24,2022,01-18,12:16
038 Fac de Lettres,2,14,16,2022,01-18,12:16
039 Aiguelongue,4,4,8,2022,01-18,12:16
040 Jeu de Mail des Abb�s,4,4,8,2022,01-18,12:16
041 Eurom�decine,1,7,8,2022,01-18,12:16
042 Marie Caizergues,2,6,8,2022,01-18,12:16
043 Sabines,3,5,8,2022,01-18,12:16
044 Celleneuve,0,8,8,2022,01-18,12:16
045 Jardin de la Lironde,3,5,8,2022,01-18,12:16
046 P�re Soulas,4,4,8,2022,01-18,12:16
047 Place Viala,5,3,8,2022,01-18,12:16
048 H�tel du D�partement,0,8,8,2022,01-18,12:16
049 Tonnelles,0,8,8,2022,01-18,12:16
050 Parvis Jules Ferry - Gare Saint-Roch,5,3,8,2022,01-18,12:16
051 Pont de Lattes - Gare Saint-Roch,4,8,12,2022,01-18,12:16
053 Deux Ponts - Gare Saint-Roch,3,5,8,2022,01-18,12:16
054 Providence - Ovalie,5,3,8,2022,01-18,12:16
055 P�rols Etang de l'Or,22,46,68,2022,01-18,12:16
056 Albert 1er - Cath�drale,7,5,12,2022,01-18,12:16
057 Saint-Guilhem - Courreau,0,8,8,2022,01-18,12:16
059 Sud De France,1,7,8,2022,01-18,12:16
001 Rue Jules Ferry - Gare Saint-Roch,10,2,12,2022,01-18,12:26
002 Com�die,16,8,24,2022,01-18,12:26
003 Esplanade,16,16,32,2022,01-18,12:26
004 H�tel de Ville,14,2,16,2022,01-18,12:26
005 Corum,7,5,12,2022,01-18,12:26
006 Place Albert 1er - St Charles,11,20,31,2022,01-18,12:26
007 Foch,5,3,8,2022,01-18,12:26
008 Halles Castellane,4,8,12,2022,01-18,12:26
009 Observatoire,3,5,8,2022,01-18,12:26
010 Rondelet,6,10,16,2022,01-18,12:26
011 Plan Cabanes,6,6,12,2022,01-18,12:26
012 Boutonnet,5,7,12,2022,01-18,12:26
013 Emile Combes,3,5,8,2022,01-18,12:26
014 Beaux-Arts,2,6,8,2022,01-18,12:26
015 Les Aubes,3,5,8,2022,01-18,12:26
016 Antigone centre,11,5,16,2022,01-18,12:26
017 M�diath�que Emile Zola,12,4,16,2022,01-18,12:26
018 Nombre d'Or,5,11,16,2022,01-18,12:26
019 Louis Blanc,4,12,16,2022,01-18,12:26
020 Gambetta,1,7,8,2022,01-18,12:26
021 Port Marianne,7,9,16,2022,01-18,12:26
022 Clemenceau,5,7,12,2022,01-18,12:26
023 Les Arceaux,1,15,16,2022,01-18,12:26
024 Cit� Mion,3,5,8,2022,01-18,12:26
025 Nouveau Saint-Roch,3,5,8,2022,01-18,12:26
026 Renouvier,2,5,8,2022,01-18,12:26
027 Odysseum,5,3,8,2022,01-18,12:26
028 Saint-Denis,4,4,8,2022,01-18,12:26
029 Richter,7,9,16,2022,01-18,12:26
030 Charles Flahault,4,4,8,2022,01-18,12:26
031 Voltaire,2,6,8,2022,01-18,12:26
032 Pr�s d'Ar�nes,7,1,8,2022,01-18,12:26
033 Garcia Lorca,6,2,8,2022,01-18,12:26
034 Vert Bois,0,16,16,2022,01-18,12:26
035 Malbosc,2,6,8,2022,01-18,12:26
036 Occitanie,1,31,32,2022,01-18,12:26
037 FacdesSciences,10,14,24,2022,01-18,12:26
038 Fac de Lettres,2,14,16,2022,01-18,12:26
039 Aiguelongue,4,4,8,2022,01-18,12:26
040 Jeu de Mail des Abb�s,4,4,8,2022,01-18,12:26
041 Eurom�decine,1,7,8,2022,01-18,12:26
042 Marie Caizergues,2,6,8,2022,01-18,12:26
043 Sabines,3,5,8,2022,01-18,12:26
044 Celleneuve,0,8,8,2022,01-18,12:26
045 Jardin de la Lironde,3,5,8,2022,01-18,12:26
046 P�re Soulas,5,3,8,2022,01-18,12:26
047 Place Viala,5,3,8,2022,01-18,12:26
048 H�tel du D�partement,0,8,8,2022,01-18,12:26
049 Tonnelles,0,8,8,2022,01-18,12:26
050 Parvis Jules Ferry - Gare Saint-Roch,5,3,8,2022,01-18,12:26
051 Pont de Lattes - Gare Saint-Roch,3,9,12,2022,01-18,12:26
053 Deux Ponts - Gare Saint-Roch,3,5,8,2022,01-18,12:26
054 Providence - Ovalie,5,3,8,2022,01-18,12:26
055 P�rols Etang de l'Or,22,46,68,2022,01-18,12:26
056 Albert 1er - Cath�drale,7,5,12,2022,01-18,12:26
057 Saint-Guilhem - Courreau,0,8,8,2022,01-18,12:26
059 Sud De France,1,7,8,2022,01-18,12:26
001 Rue Jules Ferry - Gare Saint-Roch,10,2,12,2022,01-18,12:36
002 Com�die,15,9,24,2022,01-18,12:36
003 Esplanade,16,16,32,2022,01-18,12:36
004 H�tel de Ville,14,2,16,2022,01-18,12:36
005 Corum,7,5,12,2022,01-18,12:36
006 Place Albert 1er - St Charles,12,19,31,2022,01-18,12:36
007 Foch,4,4,8,2022,01-18,12:36
008 Halles Castellane,4,8,12,2022,01-18,12:36
009 Observatoire,3,5,8,2022,01-18,12:36
010 Rondelet,6,10,16,2022,01-18,12:36
011 Plan Cabanes,6,6,12,2022,01-18,12:36
012 Boutonnet,4,8,12,2022,01-18,12:36
013 Emile Combes,3,5,8,2022,01-18,12:36
014 Beaux-Arts,2,6,8,2022,01-18,12:36
015 Les Aubes,3,5,8,2022,01-18,12:36
016 Antigone centre,11,5,16,2022,01-18,12:36
017 M�diath�que Emile Zola,12,4,16,2022,01-18,12:36
018 Nombre d'Or,5,11,16,2022,01-18,12:36
019 Louis Blanc,4,12,16,2022,01-18,12:36
020 Gambetta,1,7,8,2022,01-18,12:36
021 Port Marianne,7,9,16,2022,01-18,12:36
022 Clemenceau,5,7,12,2022,01-18,12:36
023 Les Arceaux,1,15,16,2022,01-18,12:36
024 Cit� Mion,3,5,8,2022,01-18,12:36
025 Nouveau Saint-Roch,3,5,8,2022,01-18,12:36
026 Renouvier,3,5,8,2022,01-18,12:36
027 Odysseum,5,3,8,2022,01-18,12:36
028 Saint-Denis,4,4,8,2022,01-18,12:36
029 Richter,9,7,16,2022,01-18,12:36
030 Charles Flahault,4,4,8,2022,01-18,12:36
031 Voltaire,2,6,8,2022,01-18,12:36
032 Pr�s d'Ar�nes,7,1,8,2022,01-18,12:36
033 Garcia Lorca,6,2,8,2022,01-18,12:36
034 Vert Bois,0,16,16,2022,01-18,12:36
035 Malbosc,2,6,8,2022,01-18,12:36
036 Occitanie,1,31,32,2022,01-18,12:36
037 FacdesSciences,11,13,24,2022,01-18,12:36
038 Fac de Lettres,2,14,16,2022,01-18,12:36
039 Aiguelongue,4,4,8,2022,01-18,12:36
040 Jeu de Mail des Abb�s,4,4,8,2022,01-18,12:36
041 Eurom�decine,1,7,8,2022,01-18,12:36
042 Marie Caizergues,2,6,8,2022,01-18,12:36
043 Sabines,3,5,8,2022,01-18,12:36
044 Celleneuve,0,8,8,2022,01-18,12:36
045 Jardin de la Lironde,3,5,8,2022,01-18,12:36
046 P�re Soulas,5,3,8,2022,01-18,12:36
047 Place Viala,5,3,8,2022,01-18,12:36
048 H�tel du D�partement,0,8,8,2022,01-18,12:36
049 Tonnelles,0,8,8,2022,01-18,12:36
050 Parvis Jules Ferry - Gare Saint-Roch,5,3,8,2022,01-18,12:36
051 Pont de Lattes - Gare Saint-Roch,3,9,12,2022,01-18,12:36
053 Deux Ponts - Gare Saint-Roch,2,6,8,2022,01-18,12:36
054 Providence - Ovalie,5,3,8,2022,01-18,12:36
055 P�rols Etang de l'Or,20,48,68,2022,01-18,12:36
056 Albert 1er - Cath�drale,7,5,12,2022,01-18,12:36
057 Saint-Guilhem - Courreau,0,8,8,2022,01-18,12:36
059 Sud De France,1,7,8,2022,01-18,12:36
001 Rue Jules Ferry - Gare Saint-Roch,10,2,12,2022,01-18,12:47
002 Com�die,15,9,24,2022,01-18,12:47
003 Esplanade,14,18,32,2022,01-18,12:47
004 H�tel de Ville,15,1,16,2022,01-18,12:47
005 Corum,7,5,12,2022,01-18,12:47
006 Place Albert 1er - St Charles,12,19,31,2022,01-18,12:47
007 Foch,3,5,8,2022,01-18,12:47
008 Halles Castellane,4,8,12,2022,01-18,12:47
009 Observatoire,3,5,8,2022,01-18,12:47
010 Rondelet,6,10,16,2022,01-18,12:47
011 Plan Cabanes,6,6,12,2022,01-18,12:47
012 Boutonnet,4,8,12,2022,01-18,12:47
013 Emile Combes,4,4,8,2022,01-18,12:47
014 Beaux-Arts,2,6,8,2022,01-18,12:47
015 Les Aubes,3,5,8,2022,01-18,12:47
016 Antigone centre,11,5,16,2022,01-18,12:47
017 M�diath�que Emile Zola,12,4,16,2022,01-18,12:47
018 Nombre d'Or,4,12,16,2022,01-18,12:47
019 Louis Blanc,4,12,16,2022,01-18,12:47
020 Gambetta,1,7,8,2022,01-18,12:47
021 Port Marianne,7,9,16,2022,01-18,12:47
022 Clemenceau,5,7,12,2022,01-18,12:47
023 Les Arceaux,0,16,16,2022,01-18,12:47
024 Cit� Mion,3,5,8,2022,01-18,12:47
025 Nouveau Saint-Roch,3,5,8,2022,01-18,12:47
026 Renouvier,3,5,8,2022,01-18,12:47
027 Odysseum,5,3,8,2022,01-18,12:47
028 Saint-Denis,4,4,8,2022,01-18,12:47
029 Richter,9,7,16,2022,01-18,12:47
030 Charles Flahault,4,4,8,2022,01-18,12:47
031 Voltaire,2,6,8,2022,01-18,12:47
032 Pr�s d'Ar�nes,7,1,8,2022,01-18,12:47
033 Garcia Lorca,6,2,8,2022,01-18,12:47
034 Vert Bois,0,16,16,2022,01-18,12:47
035 Malbosc,2,6,8,2022,01-18,12:47
036 Occitanie,1,31,32,2022,01-18,12:47
037 FacdesSciences,11,13,24,2022,01-18,12:47
038 Fac de Lettres,2,14,16,2022,01-18,12:47
039 Aiguelongue,4,4,8,2022,01-18,12:47
040 Jeu de Mail des Abb�s,4,4,8,2022,01-18,12:47
041 Eurom�decine,1,7,8,2022,01-18,12:47
042 Marie Caizergues,2,6,8,2022,01-18,12:47
043 Sabines,3,5,8,2022,01-18,12:47
044 Celleneuve,0,8,8,2022,01-18,12:47
045 Jardin de la Lironde,3,5,8,2022,01-18,12:47
046 P�re Soulas,6,2,8,2022,01-18,12:47
047 Place Viala,5,3,8,2022,01-18,12:47
048 H�tel du D�partement,0,8,8,2022,01-18,12:47
049 Tonnelles,0,8,8,2022,01-18,12:47
050 Parvis Jules Ferry - Gare Saint-Roch,5,3,8,2022,01-18,12:47
051 Pont de Lattes - Gare Saint-Roch,3,9,12,2022,01-18,12:47
053 Deux Ponts - Gare Saint-Roch,2,6,8,2022,01-18,12:47
054 Providence - Ovalie,5,3,8,2022,01-18,12:47
055 P�rols Etang de l'Or,20,48,68,2022,01-18,12:47
056 Albert 1er - Cath�drale,7,5,12,2022,01-18,12:47
057 Saint-Guilhem - Courreau,0,8,8,2022,01-18,12:47
059 Sud De France,1,7,8,2022,01-18,12:47
001 Rue Jules Ferry - Gare Saint-Roch,10,2,12,2022,01-18,12:57
002 Com�die,16,8,24,2022,01-18,12:57
003 Esplanade,14,18,32,2022,01-18,12:57
004 H�tel de Ville,14,2,16,2022,01-18,12:57
005 Corum,6,6,12,2022,01-18,12:57
006 Place Albert 1er - St Charles,13,18,31,2022,01-18,12:57
007 Foch,2,6,8,2022,01-18,12:57
008 Halles Castellane,4,8,12,2022,01-18,12:57
009 Observatoire,3,5,8,2022,01-18,12:57
010 Rondelet,6,10,16,2022,01-18,12:57
011 Plan Cabanes,6,6,12,2022,01-18,12:57
012 Boutonnet,4,8,12,2022,01-18,12:57
013 Emile Combes,5,3,8,2022,01-18,12:57
014 Beaux-Arts,2,6,8,2022,01-18,12:57
015 Les Aubes,3,5,8,2022,01-18,12:57
016 Antigone centre,11,5,16,2022,01-18,12:57
017 M�diath�que Emile Zola,13,3,16,2022,01-18,12:57
018 Nombre d'Or,4,12,16,2022,01-18,12:57
019 Louis Blanc,4,12,16,2022,01-18,12:57
020 Gambetta,1,7,8,2022,01-18,12:57
021 Port Marianne,8,8,16,2022,01-18,12:57
022 Clemenceau,5,7,12,2022,01-18,12:57
023 Les Arceaux,0,16,16,2022,01-18,12:57
024 Cit� Mion,3,5,8,2022,01-18,12:57
025 Nouveau Saint-Roch,3,5,8,2022,01-18,12:57
026 Renouvier,4,4,8,2022,01-18,12:57
027 Odysseum,5,3,8,2022,01-18,12:57
028 Saint-Denis,4,4,8,2022,01-18,12:57
029 Richter,10,6,16,2022,01-18,12:57
030 Charles Flahault,4,4,8,2022,01-18,12:57
031 Voltaire,2,6,8,2022,01-18,12:57
032 Pr�s d'Ar�nes,7,1,8,2022,01-18,12:57
033 Garcia Lorca,6,2,8,2022,01-18,12:57
034 Vert Bois,0,16,16,2022,01-18,12:57
035 Malbosc,2,6,8,2022,01-18,12:57
036 Occitanie,1,31,32,2022,01-18,12:57
037 FacdesSciences,12,12,24,2022,01-18,12:57
038 Fac de Lettres,1,15,16,2022,01-18,12:57
039 Aiguelongue,5,3,8,2022,01-18,12:57
040 Jeu de Mail des Abb�s,4,4,8,2022,01-18,12:57
041 Eurom�decine,1,7,8,2022,01-18,12:57
042 Marie Caizergues,2,6,8,2022,01-18,12:57
043 Sabines,3,5,8,2022,01-18,12:57
044 Celleneuve,0,8,8,2022,01-18,12:57
045 Jardin de la Lironde,3,5,8,2022,01-18,12:57
046 P�re Soulas,5,3,8,2022,01-18,12:57
047 Place Viala,4,4,8,2022,01-18,12:57
048 H�tel du D�partement,0,8,8,2022,01-18,12:57
049 Tonnelles,0,8,8,2022,01-18,12:57
050 Parvis Jules Ferry - Gare Saint-Roch,5,3,8,2022,01-18,12:57
051 Pont de Lattes - Gare Saint-Roch,3,9,12,2022,01-18,12:57
053 Deux Ponts - Gare Saint-Roch,2,6,8,2022,01-18,12:57
054 Providence - Ovalie,5,3,8,2022,01-18,12:57
055 P�rols Etang de l'Or,20,48,68,2022,01-18,12:57
056 Albert 1er - Cath�drale,7,5,12,2022,01-18,12:57
057 Saint-Guilhem - Courreau,0,8,8,2022,01-18,12:57
059 Sud De France,1,7,8,2022,01-18,12:57
001 Rue Jules Ferry - Gare Saint-Roch,10,2,12,2022,01-18,13:07
002 Com�die,15,9,24,2022,01-18,13:07
003 Esplanade,14,18,32,2022,01-18,13:07
004 H�tel de Ville,14,2,16,2022,01-18,13:07
005 Corum,6,6,12,2022,01-18,13:07
006 Place Albert 1er - St Charles,14,17,31,2022,01-18,13:07
007 Foch,2,6,8,2022,01-18,13:07
008 Halles Castellane,4,8,12,2022,01-18,13:07
009 Observatoire,3,5,8,2022,01-18,13:07
010 Rondelet,6,10,16,2022,01-18,13:07
011 Plan Cabanes,6,6,12,2022,01-18,13:07
012 Boutonnet,4,8,12,2022,01-18,13:07
013 Emile Combes,5,3,8,2022,01-18,13:07
014 Beaux-Arts,2,6,8,2022,01-18,13:07
015 Les Aubes,3,5,8,2022,01-18,13:07
016 Antigone centre,11,5,16,2022,01-18,13:07
017 M�diath�que Emile Zola,12,4,16,2022,01-18,13:07
018 Nombre d'Or,4,12,16,2022,01-18,13:07
019 Louis Blanc,5,11,16,2022,01-18,13:07
020 Gambetta,1,7,8,2022,01-18,13:07
021 Port Marianne,9,7,16,2022,01-18,13:07
022 Clemenceau,5,7,12,2022,01-18,13:07
023 Les Arceaux,0,16,16,2022,01-18,13:07
024 Cit� Mion,3,5,8,2022,01-18,13:07
025 Nouveau Saint-Roch,3,5,8,2022,01-18,13:07
026 Renouvier,4,4,8,2022,01-18,13:07
027 Odysseum,5,3,8,2022,01-18,13:07
028 Saint-Denis,4,4,8,2022,01-18,13:07
029 Richter,10,6,16,2022,01-18,13:07
030 Charles Flahault,4,4,8,2022,01-18,13:07
031 Voltaire,2,6,8,2022,01-18,13:07
032 Pr�s d'Ar�nes,7,1,8,2022,01-18,13:07
033 Garcia Lorca,6,2,8,2022,01-18,13:07
034 Vert Bois,0,16,16,2022,01-18,13:07
035 Malbosc,2,6,8,2022,01-18,13:07
036 Occitanie,1,31,32,2022,01-18,13:07
037 FacdesSciences,13,11,24,2022,01-18,13:07
038 Fac de Lettres,1,15,16,2022,01-18,13:07
039 Aiguelongue,5,3,8,2022,01-18,13:07
040 Jeu de Mail des Abb�s,4,4,8,2022,01-18,13:07
041 Eurom�decine,1,7,8,2022,01-18,13:07
042 Marie Caizergues,2,6,8,2022,01-18,13:07
043 Sabines,3,5,8,2022,01-18,13:07
044 Celleneuve,0,8,8,2022,01-18,13:07
045 Jardin de la Lironde,3,5,8,2022,01-18,13:07
046 P�re Soulas,5,3,8,2022,01-18,13:07
047 Place Viala,4,4,8,2022,01-18,13:07
048 H�tel du D�partement,0,8,8,2022,01-18,13:07
049 Tonnelles,0,8,8,2022,01-18,13:07
050 Parvis Jules Ferry - Gare Saint-Roch,5,3,8,2022,01-18,13:07
051 Pont de Lattes - Gare Saint-Roch,3,9,12,2022,01-18,13:07
053 Deux Ponts - Gare Saint-Roch,2,6,8,2022,01-18,13:07
054 Providence - Ovalie,5,3,8,2022,01-18,13:07
055 P�rols Etang de l'Or,20,48,68,2022,01-18,13:07
056 Albert 1er - Cath�drale,7,5,12,2022,01-18,13:07
057 Saint-Guilhem - Courreau,0,8,8,2022,01-18,13:07
059 Sud De France,1,7,8,2022,01-18,13:07
001 Rue Jules Ferry - Gare Saint-Roch,7,5,12,2022,01-18,13:17
002 Com�die,15,9,24,2022,01-18,13:17
003 Esplanade,14,18,32,2022,01-18,13:17
004 H�tel de Ville,14,2,16,2022,01-18,13:17
005 Corum,6,6,12,2022,01-18,13:17
006 Place Albert 1er - St Charles,14,17,31,2022,01-18,13:17
007 Foch,2,6,8,2022,01-18,13:17
008 Halles Castellane,4,8,12,2022,01-18,13:17
009 Observatoire,3,5,8,2022,01-18,13:17
010 Rondelet,6,10,16,2022,01-18,13:17
011 Plan Cabanes,6,6,12,2022,01-18,13:17
012 Boutonnet,4,8,12,2022,01-18,13:17
013 Emile Combes,5,3,8,2022,01-18,13:17
014 Beaux-Arts,2,6,8,2022,01-18,13:17
015 Les Aubes,3,5,8,2022,01-18,13:17
016 Antigone centre,11,5,16,2022,01-18,13:17
017 M�diath�que Emile Zola,12,4,16,2022,01-18,13:17
018 Nombre d'Or,4,12,16,2022,01-18,13:17
019 Louis Blanc,5,11,16,2022,01-18,13:17
020 Gambetta,1,7,8,2022,01-18,13:17
021 Port Marianne,9,7,16,2022,01-18,13:17
022 Clemenceau,5,7,12,2022,01-18,13:17
023 Les Arceaux,0,16,16,2022,01-18,13:17
024 Cit� Mion,3,5,8,2022,01-18,13:17
025 Nouveau Saint-Roch,3,5,8,2022,01-18,13:17
026 Renouvier,4,4,8,2022,01-18,13:17
027 Odysseum,5,3,8,2022,01-18,13:17
028 Saint-Denis,3,5,8,2022,01-18,13:17
029 Richter,10,6,16,2022,01-18,13:17
030 Charles Flahault,4,4,8,2022,01-18,13:17
031 Voltaire,3,5,8,2022,01-18,13:17
032 Pr�s d'Ar�nes,7,1,8,2022,01-18,13:17
033 Garcia Lorca,6,2,8,2022,01-18,13:17
034 Vert Bois,0,16,16,2022,01-18,13:17
035 Malbosc,2,6,8,2022,01-18,13:17
036 Occitanie,1,31,32,2022,01-18,13:17
037 FacdesSciences,13,11,24,2022,01-18,13:17
038 Fac de Lettres,1,15,16,2022,01-18,13:17
039 Aiguelongue,5,3,8,2022,01-18,13:17
040 Jeu de Mail des Abb�s,4,4,8,2022,01-18,13:17
041 Eurom�decine,1,7,8,2022,01-18,13:17
042 Marie Caizergues,2,6,8,2022,01-18,13:17
043 Sabines,3,5,8,2022,01-18,13:17
044 Celleneuve,0,8,8,2022,01-18,13:17
045 Jardin de la Lironde,3,5,8,2022,01-18,13:17
046 P�re Soulas,5,3,8,2022,01-18,13:17
047 Place Viala,4,4,8,2022,01-18,13:17
048 H�tel du D�partement,0,8,8,2022,01-18,13:17
049 Tonnelles,0,8,8,2022,01-18,13:17
050 Parvis Jules Ferry - Gare Saint-Roch,5,3,8,2022,01-18,13:17
051 Pont de Lattes - Gare Saint-Roch,3,9,12,2022,01-18,13:17
053 Deux Ponts - Gare Saint-Roch,2,6,8,2022,01-18,13:17
054 Providence - Ovalie,5,3,8,2022,01-18,13:17
055 P�rols Etang de l'Or,20,48,68,2022,01-18,13:17
056 Albert 1er - Cath�drale,7,5,12,2022,01-18,13:17
057 Saint-Guilhem - Courreau,0,8,8,2022,01-18,13:17
059 Sud De France,1,7,8,2022,01-18,13:17
001 Rue Jules Ferry - Gare Saint-Roch,6,6,12,2022,01-18,13:27
002 Com�die,13,11,24,2022,01-18,13:27
003 Esplanade,14,18,32,2022,01-18,13:27
004 H�tel de Ville,14,2,16,2022,01-18,13:27
005 Corum,7,5,12,2022,01-18,13:27
006 Place Albert 1er - St Charles,14,17,31,2022,01-18,13:27
007 Foch,3,5,8,2022,01-18,13:27
008 Halles Castellane,4,8,12,2022,01-18,13:27
009 Observatoire,3,5,8,2022,01-18,13:27
010 Rondelet,6,10,16,2022,01-18,13:27
011 Plan Cabanes,6,6,12,2022,01-18,13:27
012 Boutonnet,4,8,12,2022,01-18,13:27
013 Emile Combes,3,5,8,2022,01-18,13:27
014 Beaux-Arts,2,6,8,2022,01-18,13:27
015 Les Aubes,3,5,8,2022,01-18,13:27
016 Antigone centre,11,5,16,2022,01-18,13:27
017 M�diath�que Emile Zola,12,4,16,2022,01-18,13:27
018 Nombre d'Or,4,12,16,2022,01-18,13:27
019 Louis Blanc,5,11,16,2022,01-18,13:27
020 Gambetta,1,7,8,2022,01-18,13:27
021 Port Marianne,9,7,16,2022,01-18,13:27
022 Clemenceau,5,7,12,2022,01-18,13:27
023 Les Arceaux,0,16,16,2022,01-18,13:27
024 Cit� Mion,3,5,8,2022,01-18,13:27
025 Nouveau Saint-Roch,3,5,8,2022,01-18,13:27
026 Renouvier,4,4,8,2022,01-18,13:27
027 Odysseum,5,3,8,2022,01-18,13:27
028 Saint-Denis,3,5,8,2022,01-18,13:27
029 Richter,12,4,16,2022,01-18,13:27
030 Charles Flahault,4,4,8,2022,01-18,13:27
031 Voltaire,3,5,8,2022,01-18,13:27
032 Pr�s d'Ar�nes,7,1,8,2022,01-18,13:27
033 Garcia Lorca,6,2,8,2022,01-18,13:27
034 Vert Bois,0,16,16,2022,01-18,13:27
035 Malbosc,2,6,8,2022,01-18,13:27
036 Occitanie,1,31,32,2022,01-18,13:27
037 FacdesSciences,12,12,24,2022,01-18,13:27
038 Fac de Lettres,1,15,16,2022,01-18,13:27
039 Aiguelongue,5,3,8,2022,01-18,13:27
040 Jeu de Mail des Abb�s,4,4,8,2022,01-18,13:27
041 Eurom�decine,1,7,8,2022,01-18,13:27
042 Marie Caizergues,2,6,8,2022,01-18,13:27
043 Sabines,3,5,8,2022,01-18,13:27
044 Celleneuve,0,8,8,2022,01-18,13:27
045 Jardin de la Lironde,3,5,8,2022,01-18,13:27
046 P�re Soulas,5,3,8,2022,01-18,13:27
047 Place Viala,4,4,8,2022,01-18,13:27
048 H�tel du D�partement,0,8,8,2022,01-18,13:27
049 Tonnelles,0,8,8,2022,01-18,13:27
050 Parvis Jules Ferry - Gare Saint-Roch,5,3,8,2022,01-18,13:27
051 Pont de Lattes - Gare Saint-Roch,3,9,12,2022,01-18,13:27
053 Deux Ponts - Gare Saint-Roch,2,6,8,2022,01-18,13:27
054 Providence - Ovalie,5,3,8,2022,01-18,13:27
055 P�rols Etang de l'Or,17,51,68,2022,01-18,13:27
056 Albert 1er - Cath�drale,7,5,12,2022,01-18,13:27
057 Saint-Guilhem - Courreau,1,7,8,2022,01-18,13:27
059 Sud De France,1,7,8,2022,01-18,13:27
001 Rue Jules Ferry - Gare Saint-Roch,6,6,12,2022,01-18,13:37
002 Com�die,13,11,24,2022,01-18,13:37
003 Esplanade,14,18,32,2022,01-18,13:37
004 H�tel de Ville,14,2,16,2022,01-18,13:37
005 Corum,7,5,12,2022,01-18,13:37
006 Place Albert 1er - St Charles,14,17,31,2022,01-18,13:37
007 Foch,3,5,8,2022,01-18,13:37
008 Halles Castellane,4,8,12,2022,01-18,13:37
009 Observatoire,3,5,8,2022,01-18,13:37
010 Rondelet,6,10,16,2022,01-18,13:37
011 Plan Cabanes,4,8,12,2022,01-18,13:37
012 Boutonnet,4,8,12,2022,01-18,13:37
013 Emile Combes,3,5,8,2022,01-18,13:37
014 Beaux-Arts,2,6,8,2022,01-18,13:37
015 Les Aubes,3,5,8,2022,01-18,13:37
016 Antigone centre,10,6,16,2022,01-18,13:37
017 M�diath�que Emile Zola,12,4,16,2022,01-18,13:37
018 Nombre d'Or,5,11,16,2022,01-18,13:37
019 Louis Blanc,4,12,16,2022,01-18,13:37
020 Gambetta,1,7,8,2022,01-18,13:37
021 Port Marianne,9,7,16,2022,01-18,13:37
022 Clemenceau,5,7,12,2022,01-18,13:37
023 Les Arceaux,0,16,16,2022,01-18,13:37
024 Cit� Mion,3,5,8,2022,01-18,13:37
025 Nouveau Saint-Roch,3,5,8,2022,01-18,13:37
026 Renouvier,4,4,8,2022,01-18,13:37
027 Odysseum,5,3,8,2022,01-18,13:37
028 Saint-Denis,3,5,8,2022,01-18,13:37
029 Richter,13,3,16,2022,01-18,13:37
030 Charles Flahault,4,4,8,2022,01-18,13:37
031 Voltaire,3,5,8,2022,01-18,13:37
032 Pr�s d'Ar�nes,7,1,8,2022,01-18,13:37
033 Garcia Lorca,6,2,8,2022,01-18,13:37
034 Vert Bois,0,16,16,2022,01-18,13:37
035 Malbosc,2,6,8,2022,01-18,13:37
036 Occitanie,1,31,32,2022,01-18,13:37
037 FacdesSciences,12,12,24,2022,01-18,13:37
038 Fac de Lettres,1,15,16,2022,01-18,13:37
039 Aiguelongue,6,2,8,2022,01-18,13:37
040 Jeu de Mail des Abb�s,4,4,8,2022,01-18,13:37
041 Eurom�decine,1,7,8,2022,01-18,13:37
042 Marie Caizergues,2,6,8,2022,01-18,13:37
043 Sabines,3,5,8,2022,01-18,13:37
044 Celleneuve,0,8,8,2022,01-18,13:37
045 Jardin de la Lironde,3,5,8,2022,01-18,13:37
046 P�re Soulas,6,2,8,2022,01-18,13:37
047 Place Viala,4,4,8,2022,01-18,13:37
048 H�tel du D�partement,0,8,8,2022,01-18,13:37
049 Tonnelles,0,8,8,2022,01-18,13:37
050 Parvis Jules Ferry - Gare Saint-Roch,5,3,8,2022,01-18,13:37
051 Pont de Lattes - Gare Saint-Roch,3,9,12,2022,01-18,13:37
053 Deux Ponts - Gare Saint-Roch,2,6,8,2022,01-18,13:37
054 Providence - Ovalie,5,3,8,2022,01-18,13:37
055 P�rols Etang de l'Or,17,51,68,2022,01-18,13:37
056 Albert 1er - Cath�drale,7,5,12,2022,01-18,13:37
057 Saint-Guilhem - Courreau,1,7,8,2022,01-18,13:37
059 Sud De France,1,7,8,2022,01-18,13:37
001 Rue Jules Ferry - Gare Saint-Roch,6,6,12,2022,01-18,13:48
002 Com�die,13,11,24,2022,01-18,13:48
003 Esplanade,14,18,32,2022,01-18,13:48
004 H�tel de Ville,14,2,16,2022,01-18,13:48
005 Corum,7,5,12,2022,01-18,13:48
006 Place Albert 1er - St Charles,14,17,31,2022,01-18,13:48
007 Foch,3,5,8,2022,01-18,13:48
008 Halles Castellane,4,8,12,2022,01-18,13:48
009 Observatoire,3,5,8,2022,01-18,13:48
010 Rondelet,6,10,16,2022,01-18,13:48
011 Plan Cabanes,3,9,12,2022,01-18,13:48
012 Boutonnet,4,8,12,2022,01-18,13:48
013 Emile Combes,3,5,8,2022,01-18,13:48
014 Beaux-Arts,2,6,8,2022,01-18,13:48
015 Les Aubes,4,4,8,2022,01-18,13:48
016 Antigone centre,10,6,16,2022,01-18,13:48
017 M�diath�que Emile Zola,12,4,16,2022,01-18,13:48
018 Nombre d'Or,6,10,16,2022,01-18,13:48
019 Louis Blanc,4,12,16,2022,01-18,13:48
020 Gambetta,1,7,8,2022,01-18,13:48
021 Port Marianne,9,7,16,2022,01-18,13:48
022 Clemenceau,5,7,12,2022,01-18,13:48
023 Les Arceaux,0,16,16,2022,01-18,13:48
024 Cit� Mion,3,5,8,2022,01-18,13:48
025 Nouveau Saint-Roch,3,5,8,2022,01-18,13:48
026 Renouvier,4,4,8,2022,01-18,13:48
027 Odysseum,5,3,8,2022,01-18,13:48
028 Saint-Denis,3,5,8,2022,01-18,13:48
029 Richter,13,3,16,2022,01-18,13:48
030 Charles Flahault,5,3,8,2022,01-18,13:48
031 Voltaire,3,5,8,2022,01-18,13:48
032 Pr�s d'Ar�nes,7,1,8,2022,01-18,13:48
033 Garcia Lorca,6,2,8,2022,01-18,13:48
034 Vert Bois,0,16,16,2022,01-18,13:48
035 Malbosc,2,6,8,2022,01-18,13:48
036 Occitanie,1,31,32,2022,01-18,13:48
037 FacdesSciences,11,13,24,2022,01-18,13:48
038 Fac de Lettres,1,15,16,2022,01-18,13:48
039 Aiguelongue,6,2,8,2022,01-18,13:48
040 Jeu de Mail des Abb�s,4,4,8,2022,01-18,13:48
041 Eurom�decine,1,7,8,2022,01-18,13:48
042 Marie Caizergues,2,6,8,2022,01-18,13:48
043 Sabines,3,5,8,2022,01-18,13:48
044 Celleneuve,0,8,8,2022,01-18,13:48
045 Jardin de la Lironde,3,5,8,2022,01-18,13:48
046 P�re Soulas,6,2,8,2022,01-18,13:48
047 Place Viala,4,4,8,2022,01-18,13:48
048 H�tel du D�partement,0,8,8,2022,01-18,13:48
049 Tonnelles,0,8,8,2022,01-18,13:48
050 Parvis Jules Ferry - Gare Saint-Roch,5,3,8,2022,01-18,13:48
051 Pont de Lattes - Gare Saint-Roch,3,9,12,2022,01-18,13:48
053 Deux Ponts - Gare Saint-Roch,2,6,8,2022,01-18,13:48
054 Providence - Ovalie,5,3,8,2022,01-18,13:48
055 P�rols Etang de l'Or,17,51,68,2022,01-18,13:48
056 Albert 1er - Cath�drale,7,5,12,2022,01-18,13:48
057 Saint-Guilhem - Courreau,1,7,8,2022,01-18,13:48
059 Sud De France,1,7,8,2022,01-18,13:48
001 Rue Jules Ferry - Gare Saint-Roch,6,6,12,2022,01-18,13:58
002 Com�die,13,11,24,2022,01-18,13:58
003 Esplanade,14,18,32,2022,01-18,13:58
004 H�tel de Ville,14,2,16,2022,01-18,13:58
005 Corum,7,5,12,2022,01-18,13:58
006 Place Albert 1er - St Charles,14,17,31,2022,01-18,13:58
007 Foch,3,5,8,2022,01-18,13:58
008 Halles Castellane,4,8,12,2022,01-18,13:58
009 Observatoire,2,6,8,2022,01-18,13:58
010 Rondelet,6,10,16,2022,01-18,13:58
011 Plan Cabanes,2,10,12,2022,01-18,13:58
012 Boutonnet,4,8,12,2022,01-18,13:58
013 Emile Combes,3,5,8,2022,01-18,13:58
014 Beaux-Arts,2,6,8,2022,01-18,13:58
015 Les Aubes,4,4,8,2022,01-18,13:58
016 Antigone centre,11,5,16,2022,01-18,13:58
017 M�diath�que Emile Zola,11,5,16,2022,01-18,13:58
018 Nombre d'Or,6,10,16,2022,01-18,13:58
019 Louis Blanc,4,12,16,2022,01-18,13:58
020 Gambetta,1,7,8,2022,01-18,13:58
021 Port Marianne,9,7,16,2022,01-18,13:58
022 Clemenceau,5,7,12,2022,01-18,13:58
023 Les Arceaux,0,16,16,2022,01-18,13:58
024 Cit� Mion,3,5,8,2022,01-18,13:58
025 Nouveau Saint-Roch,3,5,8,2022,01-18,13:58
026 Renouvier,4,4,8,2022,01-18,13:58
027 Odysseum,5,3,8,2022,01-18,13:58
028 Saint-Denis,3,5,8,2022,01-18,13:58
029 Richter,12,4,16,2022,01-18,13:58
030 Charles Flahault,5,3,8,2022,01-18,13:58
031 Voltaire,3,5,8,2022,01-18,13:58
032 Pr�s d'Ar�nes,7,1,8,2022,01-18,13:58
033 Garcia Lorca,6,2,8,2022,01-18,13:58
034 Vert Bois,0,16,16,2022,01-18,13:58
035 Malbosc,2,6,8,2022,01-18,13:58
036 Occitanie,1,31,32,2022,01-18,13:58
037 FacdesSciences,10,14,24,2022,01-18,13:58
038 Fac de Lettres,1,15,16,2022,01-18,13:58
039 Aiguelongue,5,3,8,2022,01-18,13:58
040 Jeu de Mail des Abb�s,4,4,8,2022,01-18,13:58
041 Eurom�decine,1,7,8,2022,01-18,13:58
042 Marie Caizergues,2,6,8,2022,01-18,13:58
043 Sabines,3,5,8,2022,01-18,13:58
044 Celleneuve,0,8,8,2022,01-18,13:58
045 Jardin de la Lironde,3,5,8,2022,01-18,13:58
046 P�re Soulas,6,2,8,2022,01-18,13:58
047 Place Viala,3,5,8,2022,01-18,13:58
048 H�tel du D�partement,0,8,8,2022,01-18,13:58
049 Tonnelles,0,8,8,2022,01-18,13:58
050 Parvis Jules Ferry - Gare Saint-Roch,6,2,8,2022,01-18,13:58
051 Pont de Lattes - Gare Saint-Roch,3,9,12,2022,01-18,13:58
053 Deux Ponts - Gare Saint-Roch,2,6,8,2022,01-18,13:58
054 Providence - Ovalie,5,3,8,2022,01-18,13:58
055 P�rols Etang de l'Or,17,51,68,2022,01-18,13:58
056 Albert 1er - Cath�drale,7,5,12,2022,01-18,13:58
057 Saint-Guilhem - Courreau,1,7,8,2022,01-18,13:58
059 Sud De France,1,7,8,2022,01-18,13:58
001 Rue Jules Ferry - Gare Saint-Roch,6,6,12,2022,01-18,14:08
002 Com�die,13,11,24,2022,01-18,14:08
003 Esplanade,14,18,32,2022,01-18,14:08
004 H�tel de Ville,14,2,16,2022,01-18,14:08
005 Corum,9,3,12,2022,01-18,14:08
006 Place Albert 1er - St Charles,14,17,31,2022,01-18,14:08
007 Foch,3,5,8,2022,01-18,14:08
008 Halles Castellane,4,8,12,2022,01-18,14:08
009 Observatoire,2,6,8,2022,01-18,14:08
010 Rondelet,6,10,16,2022,01-18,14:08
011 Plan Cabanes,3,9,12,2022,01-18,14:08
012 Boutonnet,5,7,12,2022,01-18,14:08
013 Emile Combes,3,5,8,2022,01-18,14:08
014 Beaux-Arts,2,6,8,2022,01-18,14:08
015 Les Aubes,4,4,8,2022,01-18,14:08
016 Antigone centre,11,5,16,2022,01-18,14:08
017 M�diath�que Emile Zola,10,6,16,2022,01-18,14:08
018 Nombre d'Or,6,10,16,2022,01-18,14:08
019 Louis Blanc,5,11,16,2022,01-18,14:08
020 Gambetta,1,7,8,2022,01-18,14:08
021 Port Marianne,8,8,16,2022,01-18,14:08
022 Clemenceau,4,8,12,2022,01-18,14:08
023 Les Arceaux,0,16,16,2022,01-18,14:08
024 Cit� Mion,3,5,8,2022,01-18,14:08
025 Nouveau Saint-Roch,3,5,8,2022,01-18,14:08
026 Renouvier,4,4,8,2022,01-18,14:08
027 Odysseum,5,3,8,2022,01-18,14:08
028 Saint-Denis,3,5,8,2022,01-18,14:08
029 Richter,12,4,16,2022,01-18,14:08
030 Charles Flahault,5,3,8,2022,01-18,14:08
031 Voltaire,3,5,8,2022,01-18,14:08
032 Pr�s d'Ar�nes,7,1,8,2022,01-18,14:08
033 Garcia Lorca,6,2,8,2022,01-18,14:08
034 Vert Bois,0,16,16,2022,01-18,14:08
035 Malbosc,2,6,8,2022,01-18,14:08
036 Occitanie,1,31,32,2022,01-18,14:08
037 FacdesSciences,9,15,24,2022,01-18,14:08
038 Fac de Lettres,1,15,16,2022,01-18,14:08
039 Aiguelongue,5,3,8,2022,01-18,14:08
040 Jeu de Mail des Abb�s,4,4,8,2022,01-18,14:08
041 Eurom�decine,1,7,8,2022,01-18,14:08
042 Marie Caizergues,2,6,8,2022,01-18,14:08
043 Sabines,3,5,8,2022,01-18,14:08
044 Celleneuve,0,8,8,2022,01-18,14:08
045 Jardin de la Lironde,3,5,8,2022,01-18,14:08
046 P�re Soulas,6,2,8,2022,01-18,14:08
047 Place Viala,3,5,8,2022,01-18,14:08
048 H�tel du D�partement,0,8,8,2022,01-18,14:08
049 Tonnelles,0,8,8,2022,01-18,14:08
050 Parvis Jules Ferry - Gare Saint-Roch,6,2,8,2022,01-18,14:08
051 Pont de Lattes - Gare Saint-Roch,3,9,12,2022,01-18,14:08
053 Deux Ponts - Gare Saint-Roch,2,6,8,2022,01-18,14:08
054 Providence - Ovalie,5,3,8,2022,01-18,14:08
055 P�rols Etang de l'Or,17,51,68,2022,01-18,14:08
056 Albert 1er - Cath�drale,7,5,12,2022,01-18,14:08
057 Saint-Guilhem - Courreau,1,7,8,2022,01-18,14:08
059 Sud De France,1,7,8,2022,01-18,14:08
001 Rue Jules Ferry - Gare Saint-Roch,6,6,12,2022,01-18,14:18
002 Com�die,13,11,24,2022,01-18,14:18
003 Esplanade,14,18,32,2022,01-18,14:18
004 H�tel de Ville,14,2,16,2022,01-18,14:18
005 Corum,9,3,12,2022,01-18,14:18
006 Place Albert 1er - St Charles,14,17,31,2022,01-18,14:18
007 Foch,3,5,8,2022,01-18,14:18
008 Halles Castellane,4,8,12,2022,01-18,14:18
009 Observatoire,2,6,8,2022,01-18,14:18
010 Rondelet,6,10,16,2022,01-18,14:18
011 Plan Cabanes,4,8,12,2022,01-18,14:18
012 Boutonnet,5,7,12,2022,01-18,14:18
013 Emile Combes,3,5,8,2022,01-18,14:18
014 Beaux-Arts,2,6,8,2022,01-18,14:18
015 Les Aubes,4,4,8,2022,01-18,14:18
016 Antigone centre,11,5,16,2022,01-18,14:18
017 M�diath�que Emile Zola,10,6,16,2022,01-18,14:18
018 Nombre d'Or,8,8,16,2022,01-18,14:18
019 Louis Blanc,4,12,16,2022,01-18,14:18
020 Gambetta,1,7,8,2022,01-18,14:18
021 Port Marianne,8,8,16,2022,01-18,14:18
022 Clemenceau,4,8,12,2022,01-18,14:18
023 Les Arceaux,0,16,16,2022,01-18,14:18
024 Cit� Mion,3,5,8,2022,01-18,14:18
025 Nouveau Saint-Roch,3,5,8,2022,01-18,14:18
026 Renouvier,4,4,8,2022,01-18,14:18
027 Odysseum,5,3,8,2022,01-18,14:18
028 Saint-Denis,3,5,8,2022,01-18,14:18
029 Richter,13,3,16,2022,01-18,14:18
030 Charles Flahault,5,3,8,2022,01-18,14:18
031 Voltaire,3,5,8,2022,01-18,14:18
032 Pr�s d'Ar�nes,7,1,8,2022,01-18,14:18
033 Garcia Lorca,6,2,8,2022,01-18,14:18
034 Vert Bois,0,16,16,2022,01-18,14:18
035 Malbosc,2,6,8,2022,01-18,14:18
036 Occitanie,1,31,32,2022,01-18,14:18
037 FacdesSciences,9,15,24,2022,01-18,14:18
038 Fac de Lettres,1,15,16,2022,01-18,14:18
039 Aiguelongue,5,3,8,2022,01-18,14:18
040 Jeu de Mail des Abb�s,4,4,8,2022,01-18,14:18
041 Eurom�decine,1,7,8,2022,01-18,14:18
042 Marie Caizergues,2,6,8,2022,01-18,14:18
043 Sabines,3,5,8,2022,01-18,14:18
044 Celleneuve,1,7,8,2022,01-18,14:18
045 Jardin de la Lironde,3,5,8,2022,01-18,14:18
046 P�re Soulas,6,2,8,2022,01-18,14:18
047 Place Viala,3,5,8,2022,01-18,14:18
048 H�tel du D�partement,0,8,8,2022,01-18,14:18
049 Tonnelles,0,8,8,2022,01-18,14:18
050 Parvis Jules Ferry - Gare Saint-Roch,6,2,8,2022,01-18,14:18
051 Pont de Lattes - Gare Saint-Roch,3,9,12,2022,01-18,14:18
053 Deux Ponts - Gare Saint-Roch,2,6,8,2022,01-18,14:18
054 Providence - Ovalie,5,3,8,2022,01-18,14:18
055 P�rols Etang de l'Or,17,51,68,2022,01-18,14:18
056 Albert 1er - Cath�drale,7,5,12,2022,01-18,14:18
057 Saint-Guilhem - Courreau,1,7,8,2022,01-18,14:18
059 Sud De France,1,7,8,2022,01-18,14:18
001 Rue Jules Ferry - Gare Saint-Roch,6,6,12,2022,01-18,14:28
002 Com�die,13,11,24,2022,01-18,14:28
003 Esplanade,14,18,32,2022,01-18,14:28
004 H�tel de Ville,14,2,16,2022,01-18,14:28
005 Corum,10,2,12,2022,01-18,14:28
006 Place Albert 1er - St Charles,15,16,31,2022,01-18,14:28
007 Foch,2,6,8,2022,01-18,14:28
008 Halles Castellane,4,8,12,2022,01-18,14:28
009 Observatoire,2,6,8,2022,01-18,14:28
010 Rondelet,6,10,16,2022,01-18,14:28
011 Plan Cabanes,4,8,12,2022,01-18,14:28
012 Boutonnet,5,7,12,2022,01-18,14:28
013 Emile Combes,3,5,8,2022,01-18,14:28
014 Beaux-Arts,2,6,8,2022,01-18,14:28
015 Les Aubes,4,4,8,2022,01-18,14:28
016 Antigone centre,10,6,16,2022,01-18,14:28
017 M�diath�que Emile Zola,10,6,16,2022,01-18,14:28
018 Nombre d'Or,8,8,16,2022,01-18,14:28
019 Louis Blanc,4,12,16,2022,01-18,14:28
020 Gambetta,1,7,8,2022,01-18,14:28
021 Port Marianne,8,8,16,2022,01-18,14:28
022 Clemenceau,4,8,12,2022,01-18,14:28
023 Les Arceaux,0,16,16,2022,01-18,14:28
024 Cit� Mion,3,5,8,2022,01-18,14:28
025 Nouveau Saint-Roch,3,5,8,2022,01-18,14:28
026 Renouvier,3,5,8,2022,01-18,14:28
027 Odysseum,5,3,8,2022,01-18,14:28
028 Saint-Denis,3,5,8,2022,01-18,14:28
029 Richter,13,3,16,2022,01-18,14:28
030 Charles Flahault,5,3,8,2022,01-18,14:28
031 Voltaire,3,5,8,2022,01-18,14:28
032 Pr�s d'Ar�nes,7,1,8,2022,01-18,14:28
033 Garcia Lorca,6,2,8,2022,01-18,14:28
034 Vert Bois,0,16,16,2022,01-18,14:28
035 Malbosc,1,7,8,2022,01-18,14:28
036 Occitanie,1,31,32,2022,01-18,14:28
037 FacdesSciences,9,15,24,2022,01-18,14:28
038 Fac de Lettres,0,16,16,2022,01-18,14:28
039 Aiguelongue,5,3,8,2022,01-18,14:28
040 Jeu de Mail des Abb�s,4,4,8,2022,01-18,14:28
041 Eurom�decine,0,8,8,2022,01-18,14:28
042 Marie Caizergues,2,6,8,2022,01-18,14:28
043 Sabines,3,5,8,2022,01-18,14:28
044 Celleneuve,1,7,8,2022,01-18,14:28
045 Jardin de la Lironde,3,5,8,2022,01-18,14:28
046 P�re Soulas,6,2,8,2022,01-18,14:28
047 Place Viala,3,5,8,2022,01-18,14:28
048 H�tel du D�partement,0,8,8,2022,01-18,14:28
049 Tonnelles,0,8,8,2022,01-18,14:28
050 Parvis Jules Ferry - Gare Saint-Roch,6,2,8,2022,01-18,14:28
051 Pont de Lattes - Gare Saint-Roch,3,9,12,2022,01-18,14:28
053 Deux Ponts - Gare Saint-Roch,2,6,8,2022,01-18,14:28
054 Providence - Ovalie,5,3,8,2022,01-18,14:28
055 P�rols Etang de l'Or,17,51,68,2022,01-18,14:28
056 Albert 1er - Cath�drale,7,5,12,2022,01-18,14:28
057 Saint-Guilhem - Courreau,1,7,8,2022,01-18,14:28
059 Sud De France,1,7,8,2022,01-18,14:28
001 Rue Jules Ferry - Gare Saint-Roch,6,6,12,2022,01-18,14:38
002 Com�die,13,11,24,2022,01-18,14:38
003 Esplanade,14,18,32,2022,01-18,14:38
004 H�tel de Ville,15,1,16,2022,01-18,14:38
005 Corum,10,2,12,2022,01-18,14:38
006 Place Albert 1er - St Charles,16,15,31,2022,01-18,14:38
007 Foch,2,6,8,2022,01-18,14:38
008 Halles Castellane,4,8,12,2022,01-18,14:38
009 Observatoire,2,6,8,2022,01-18,14:38
010 Rondelet,6,10,16,2022,01-18,14:38
011 Plan Cabanes,4,8,12,2022,01-18,14:38
012 Boutonnet,5,7,12,2022,01-18,14:38
013 Emile Combes,3,5,8,2022,01-18,14:38
014 Beaux-Arts,2,6,8,2022,01-18,14:38
015 Les Aubes,4,4,8,2022,01-18,14:38
016 Antigone centre,10,6,16,2022,01-18,14:38
017 M�diath�que Emile Zola,10,6,16,2022,01-18,14:38
018 Nombre d'Or,9,7,16,2022,01-18,14:38
019 Louis Blanc,4,12,16,2022,01-18,14:38
020 Gambetta,1,7,8,2022,01-18,14:38
021 Port Marianne,8,8,16,2022,01-18,14:38
022 Clemenceau,4,8,12,2022,01-18,14:38
023 Les Arceaux,0,16,16,2022,01-18,14:38
024 Cit� Mion,3,5,8,2022,01-18,14:38
025 Nouveau Saint-Roch,3,5,8,2022,01-18,14:38
026 Renouvier,3,5,8,2022,01-18,14:38
027 Odysseum,5,3,8,2022,01-18,14:38
028 Saint-Denis,3,5,8,2022,01-18,14:38
029 Richter,13,3,16,2022,01-18,14:38
030 Charles Flahault,6,2,8,2022,01-18,14:38
031 Voltaire,3,5,8,2022,01-18,14:38
032 Pr�s d'Ar�nes,7,1,8,2022,01-18,14:38
033 Garcia Lorca,6,2,8,2022,01-18,14:38
034 Vert Bois,0,16,16,2022,01-18,14:38
035 Malbosc,1,7,8,2022,01-18,14:38
036 Occitanie,1,31,32,2022,01-18,14:38
037 FacdesSciences,10,14,24,2022,01-18,14:38
038 Fac de Lettres,0,16,16,2022,01-18,14:38
039 Aiguelongue,5,3,8,2022,01-18,14:38
040 Jeu de Mail des Abb�s,4,4,8,2022,01-18,14:38
041 Eurom�decine,0,8,8,2022,01-18,14:38
042 Marie Caizergues,2,6,8,2022,01-18,14:38
043 Sabines,3,5,8,2022,01-18,14:38
044 Celleneuve,1,7,8,2022,01-18,14:38
045 Jardin de la Lironde,3,5,8,2022,01-18,14:38
046 P�re Soulas,6,2,8,2022,01-18,14:38
047 Place Viala,2,6,8,2022,01-18,14:38
048 H�tel du D�partement,0,8,8,2022,01-18,14:38
049 Tonnelles,1,7,8,2022,01-18,14:38
050 Parvis Jules Ferry - Gare Saint-Roch,7,1,8,2022,01-18,14:38
051 Pont de Lattes - Gare Saint-Roch,3,9,12,2022,01-18,14:38
053 Deux Ponts - Gare Saint-Roch,2,6,8,2022,01-18,14:38
054 Providence - Ovalie,5,3,8,2022,01-18,14:38
055 P�rols Etang de l'Or,17,51,68,2022,01-18,14:38
056 Albert 1er - Cath�drale,7,5,12,2022,01-18,14:38
057 Saint-Guilhem - Courreau,1,7,8,2022,01-18,14:38
059 Sud De France,1,7,8,2022,01-18,14:38
001 Rue Jules Ferry - Gare Saint-Roch,6,6,12,2022,01-18,14:49
002 Com�die,13,11,24,2022,01-18,14:49
003 Esplanade,14,18,32,2022,01-18,14:49
004 H�tel de Ville,15,1,16,2022,01-18,14:49
005 Corum,10,2,12,2022,01-18,14:49
006 Place Albert 1er - St Charles,16,15,31,2022,01-18,14:49
007 Foch,2,6,8,2022,01-18,14:49
008 Halles Castellane,4,8,12,2022,01-18,14:49
009 Observatoire,2,6,8,2022,01-18,14:49
010 Rondelet,6,10,16,2022,01-18,14:49
011 Plan Cabanes,4,8,12,2022,01-18,14:49
012 Boutonnet,5,7,12,2022,01-18,14:49
013 Emile Combes,3,5,8,2022,01-18,14:49
014 Beaux-Arts,2,6,8,2022,01-18,14:49
015 Les Aubes,3,5,8,2022,01-18,14:49
016 Antigone centre,10,6,16,2022,01-18,14:49
017 M�diath�que Emile Zola,10,6,16,2022,01-18,14:49
018 Nombre d'Or,9,7,16,2022,01-18,14:49
019 Louis Blanc,5,11,16,2022,01-18,14:49
020 Gambetta,1,7,8,2022,01-18,14:49
021 Port Marianne,7,9,16,2022,01-18,14:49
022 Clemenceau,4,8,12,2022,01-18,14:49
023 Les Arceaux,0,16,16,2022,01-18,14:49
024 Cit� Mion,3,5,8,2022,01-18,14:49
025 Nouveau Saint-Roch,2,6,8,2022,01-18,14:49
026 Renouvier,3,5,8,2022,01-18,14:49
027 Odysseum,5,3,8,2022,01-18,14:49
028 Saint-Denis,3,5,8,2022,01-18,14:49
029 Richter,13,3,16,2022,01-18,14:49
030 Charles Flahault,4,4,8,2022,01-18,14:49
031 Voltaire,3,5,8,2022,01-18,14:49
032 Pr�s d'Ar�nes,7,1,8,2022,01-18,14:49
033 Garcia Lorca,6,2,8,2022,01-18,14:49
034 Vert Bois,0,16,16,2022,01-18,14:49
035 Malbosc,1,7,8,2022,01-18,14:49
036 Occitanie,1,31,32,2022,01-18,14:49
037 FacdesSciences,10,14,24,2022,01-18,14:49
038 Fac de Lettres,0,16,16,2022,01-18,14:49
039 Aiguelongue,5,3,8,2022,01-18,14:49
040 Jeu de Mail des Abb�s,4,4,8,2022,01-18,14:49
041 Eurom�decine,0,8,8,2022,01-18,14:49
042 Marie Caizergues,2,6,8,2022,01-18,14:49
043 Sabines,3,5,8,2022,01-18,14:49
044 Celleneuve,1,7,8,2022,01-18,14:49
045 Jardin de la Lironde,3,5,8,2022,01-18,14:49
046 P�re Soulas,6,2,8,2022,01-18,14:49
047 Place Viala,2,6,8,2022,01-18,14:49
048 H�tel du D�partement,2,6,8,2022,01-18,14:49
049 Tonnelles,1,7,8,2022,01-18,14:49
050 Parvis Jules Ferry - Gare Saint-Roch,7,1,8,2022,01-18,14:49
051 Pont de Lattes - Gare Saint-Roch,3,9,12,2022,01-18,14:49
053 Deux Ponts - Gare Saint-Roch,2,6,8,2022,01-18,14:49
054 Providence - Ovalie,5,3,8,2022,01-18,14:49
055 P�rols Etang de l'Or,16,52,68,2022,01-18,14:49
056 Albert 1er - Cath�drale,7,5,12,2022,01-18,14:49
057 Saint-Guilhem - Courreau,1,7,8,2022,01-18,14:49
059 Sud De France,1,7,8,2022,01-18,14:49
001 Rue Jules Ferry - Gare Saint-Roch,6,6,12,2022,01-18,14:59
002 Com�die,13,11,24,2022,01-18,14:59
003 Esplanade,14,18,32,2022,01-18,14:59
004 H�tel de Ville,15,1,16,2022,01-18,14:59
005 Corum,10,2,12,2022,01-18,14:59
006 Place Albert 1er - St Charles,16,15,31,2022,01-18,14:59
007 Foch,2,6,8,2022,01-18,14:59
008 Halles Castellane,4,8,12,2022,01-18,14:59
009 Observatoire,2,6,8,2022,01-18,14:59
010 Rondelet,6,10,16,2022,01-18,14:59
011 Plan Cabanes,4,8,12,2022,01-18,14:59
012 Boutonnet,4,8,12,2022,01-18,14:59
013 Emile Combes,3,5,8,2022,01-18,14:59
014 Beaux-Arts,2,6,8,2022,01-18,14:59
015 Les Aubes,3,5,8,2022,01-18,14:59
016 Antigone centre,10,6,16,2022,01-18,14:59
017 M�diath�que Emile Zola,10,6,16,2022,01-18,14:59
018 Nombre d'Or,9,7,16,2022,01-18,14:59
019 Louis Blanc,6,10,16,2022,01-18,14:59
020 Gambetta,1,7,8,2022,01-18,14:59
021 Port Marianne,7,9,16,2022,01-18,14:59
022 Clemenceau,3,9,12,2022,01-18,14:59
023 Les Arceaux,0,16,16,2022,01-18,14:59
024 Cit� Mion,3,5,8,2022,01-18,14:59
025 Nouveau Saint-Roch,2,6,8,2022,01-18,14:59
026 Renouvier,3,5,8,2022,01-18,14:59
027 Odysseum,5,3,8,2022,01-18,14:59
028 Saint-Denis,3,5,8,2022,01-18,14:59
029 Richter,13,3,16,2022,01-18,14:59
030 Charles Flahault,4,4,8,2022,01-18,14:59
031 Voltaire,3,5,8,2022,01-18,14:59
032 Pr�s d'Ar�nes,7,1,8,2022,01-18,14:59
033 Garcia Lorca,6,2,8,2022,01-18,14:59
034 Vert Bois,0,16,16,2022,01-18,14:59
035 Malbosc,1,7,8,2022,01-18,14:59
036 Occitanie,1,31,32,2022,01-18,14:59
037 FacdesSciences,9,15,24,2022,01-18,14:59
038 Fac de Lettres,0,16,16,2022,01-18,14:59
039 Aiguelongue,4,4,8,2022,01-18,14:59
040 Jeu de Mail des Abb�s,4,4,8,2022,01-18,14:59
041 Eurom�decine,0,8,8,2022,01-18,14:59
042 Marie Caizergues,2,6,8,2022,01-18,14:59
043 Sabines,3,5,8,2022,01-18,14:59
044 Celleneuve,1,7,8,2022,01-18,14:59
045 Jardin de la Lironde,3,5,8,2022,01-18,14:59
046 P�re Soulas,6,2,8,2022,01-18,14:59
047 Place Viala,2,6,8,2022,01-18,14:59
048 H�tel du D�partement,2,6,8,2022,01-18,14:59
049 Tonnelles,1,7,8,2022,01-18,14:59
050 Parvis Jules Ferry - Gare Saint-Roch,7,1,8,2022,01-18,14:59
051 Pont de Lattes - Gare Saint-Roch,3,9,12,2022,01-18,14:59
053 Deux Ponts - Gare Saint-Roch,2,6,8,2022,01-18,14:59
054 Providence - Ovalie,5,3,8,2022,01-18,14:59
055 P�rols Etang de l'Or,15,53,68,2022,01-18,14:59
056 Albert 1er - Cath�drale,7,5,12,2022,01-18,14:59
057 Saint-Guilhem - Courreau,1,7,8,2022,01-18,14:59
059 Sud De France,1,7,8,2022,01-18,14:59
001 Rue Jules Ferry - Gare Saint-Roch,5,7,12,2022,01-18,15:09
002 Com�die,13,11,24,2022,01-18,15:09
003 Esplanade,14,18,32,2022,01-18,15:09
004 H�tel de Ville,14,2,16,2022,01-18,15:09
005 Corum,10,2,12,2022,01-18,15:09
006 Place Albert 1er - St Charles,17,14,31,2022,01-18,15:09
007 Foch,2,6,8,2022,01-18,15:09
008 Halles Castellane,4,8,12,2022,01-18,15:09
009 Observatoire,3,5,8,2022,01-18,15:09
010 Rondelet,6,10,16,2022,01-18,15:09
011 Plan Cabanes,5,7,12,2022,01-18,15:09
012 Boutonnet,4,8,12,2022,01-18,15:09
013 Emile Combes,3,5,8,2022,01-18,15:09
014 Beaux-Arts,2,6,8,2022,01-18,15:09
015 Les Aubes,3,5,8,2022,01-18,15:09
016 Antigone centre,10,6,16,2022,01-18,15:09
017 M�diath�que Emile Zola,10,6,16,2022,01-18,15:09
018 Nombre d'Or,9,7,16,2022,01-18,15:09
019 Louis Blanc,6,10,16,2022,01-18,15:09
020 Gambetta,1,7,8,2022,01-18,15:09
021 Port Marianne,7,9,16,2022,01-18,15:09
022 Clemenceau,3,9,12,2022,01-18,15:09
023 Les Arceaux,0,16,16,2022,01-18,15:09
024 Cit� Mion,3,5,8,2022,01-18,15:09
025 Nouveau Saint-Roch,2,6,8,2022,01-18,15:09
026 Renouvier,3,5,8,2022,01-18,15:09
027 Odysseum,5,3,8,2022,01-18,15:09
028 Saint-Denis,3,5,8,2022,01-18,15:09
029 Richter,13,3,16,2022,01-18,15:09
030 Charles Flahault,4,4,8,2022,01-18,15:09
031 Voltaire,3,5,8,2022,01-18,15:09
032 Pr�s d'Ar�nes,7,1,8,2022,01-18,15:09
033 Garcia Lorca,8,0,8,2022,01-18,15:09
034 Vert Bois,0,16,16,2022,01-18,15:09
035 Malbosc,1,7,8,2022,01-18,15:09
036 Occitanie,1,31,32,2022,01-18,15:09
037 FacdesSciences,8,16,24,2022,01-18,15:09
038 Fac de Lettres,0,16,16,2022,01-18,15:09
039 Aiguelongue,4,4,8,2022,01-18,15:09
040 Jeu de Mail des Abb�s,4,4,8,2022,01-18,15:09
041 Eurom�decine,0,8,8,2022,01-18,15:09
042 Marie Caizergues,2,6,8,2022,01-18,15:09
043 Sabines,3,5,8,2022,01-18,15:09
044 Celleneuve,1,7,8,2022,01-18,15:09
045 Jardin de la Lironde,3,5,8,2022,01-18,15:09
046 P�re Soulas,6,2,8,2022,01-18,15:09
047 Place Viala,1,7,8,2022,01-18,15:09
048 H�tel du D�partement,2,6,8,2022,01-18,15:09
049 Tonnelles,1,7,8,2022,01-18,15:09
050 Parvis Jules Ferry - Gare Saint-Roch,7,1,8,2022,01-18,15:09
051 Pont de Lattes - Gare Saint-Roch,3,9,12,2022,01-18,15:09
053 Deux Ponts - Gare Saint-Roch,2,6,8,2022,01-18,15:09
054 Providence - Ovalie,5,3,8,2022,01-18,15:09
055 P�rols Etang de l'Or,15,53,68,2022,01-18,15:09
056 Albert 1er - Cath�drale,7,5,12,2022,01-18,15:09
057 Saint-Guilhem - Courreau,0,8,8,2022,01-18,15:09
059 Sud De France,1,7,8,2022,01-18,15:09
001 Rue Jules Ferry - Gare Saint-Roch,5,7,12,2022,01-18,15:19
002 Com�die,13,11,24,2022,01-18,15:19
003 Esplanade,14,18,32,2022,01-18,15:19
004 H�tel de Ville,14,2,16,2022,01-18,15:19
005 Corum,11,1,12,2022,01-18,15:19
006 Place Albert 1er - St Charles,17,14,31,2022,01-18,15:19
007 Foch,2,6,8,2022,01-18,15:19
008 Halles Castellane,4,8,12,2022,01-18,15:19
009 Observatoire,3,5,8,2022,01-18,15:19
010 Rondelet,6,10,16,2022,01-18,15:19
011 Plan Cabanes,5,7,12,2022,01-18,15:19
012 Boutonnet,4,8,12,2022,01-18,15:19
013 Emile Combes,3,5,8,2022,01-18,15:19
014 Beaux-Arts,2,6,8,2022,01-18,15:19
015 Les Aubes,3,5,8,2022,01-18,15:19
016 Antigone centre,10,6,16,2022,01-18,15:19
017 M�diath�que Emile Zola,10,6,16,2022,01-18,15:19
018 Nombre d'Or,9,7,16,2022,01-18,15:19
019 Louis Blanc,6,10,16,2022,01-18,15:19
020 Gambetta,1,7,8,2022,01-18,15:19
021 Port Marianne,6,10,16,2022,01-18,15:19
022 Clemenceau,3,9,12,2022,01-18,15:19
023 Les Arceaux,0,16,16,2022,01-18,15:19
024 Cit� Mion,3,5,8,2022,01-18,15:19
025 Nouveau Saint-Roch,2,6,8,2022,01-18,15:19
026 Renouvier,3,5,8,2022,01-18,15:19
027 Odysseum,5,3,8,2022,01-18,15:19
028 Saint-Denis,4,4,8,2022,01-18,15:19
029 Richter,13,3,16,2022,01-18,15:19
030 Charles Flahault,4,4,8,2022,01-18,15:19
031 Voltaire,3,5,8,2022,01-18,15:19
032 Pr�s d'Ar�nes,7,1,8,2022,01-18,15:19
033 Garcia Lorca,8,0,8,2022,01-18,15:19
034 Vert Bois,0,16,16,2022,01-18,15:19
035 Malbosc,1,7,8,2022,01-18,15:19
036 Occitanie,1,31,32,2022,01-18,15:19
037 FacdesSciences,9,15,24,2022,01-18,15:19
038 Fac de Lettres,0,16,16,2022,01-18,15:19
039 Aiguelongue,4,4,8,2022,01-18,15:19
040 Jeu de Mail des Abb�s,4,4,8,2022,01-18,15:19
041 Eurom�decine,0,8,8,2022,01-18,15:19
042 Marie Caizergues,2,6,8,2022,01-18,15:19
043 Sabines,3,5,8,2022,01-18,15:19
044 Celleneuve,1,7,8,2022,01-18,15:19
045 Jardin de la Lironde,3,5,8,2022,01-18,15:19
046 P�re Soulas,6,2,8,2022,01-18,15:19
047 Place Viala,1,7,8,2022,01-18,15:19
048 H�tel du D�partement,2,6,8,2022,01-18,15:19
049 Tonnelles,1,7,8,2022,01-18,15:19
050 Parvis Jules Ferry - Gare Saint-Roch,7,1,8,2022,01-18,15:19
051 Pont de Lattes - Gare Saint-Roch,3,9,12,2022,01-18,15:19
053 Deux Ponts - Gare Saint-Roch,2,6,8,2022,01-18,15:19
054 Providence - Ovalie,5,3,8,2022,01-18,15:19
055 P�rols Etang de l'Or,18,50,68,2022,01-18,15:19
056 Albert 1er - Cath�drale,7,5,12,2022,01-18,15:19
057 Saint-Guilhem - Courreau,0,8,8,2022,01-18,15:19
059 Sud De France,1,7,8,2022,01-18,15:19
001 Rue Jules Ferry - Gare Saint-Roch,4,8,12,2022,01-18,15:29
002 Com�die,13,11,24,2022,01-18,15:29
003 Esplanade,14,18,32,2022,01-18,15:29
004 H�tel de Ville,14,2,16,2022,01-18,15:29
005 Corum,11,1,12,2022,01-18,15:29
006 Place Albert 1er - St Charles,17,14,31,2022,01-18,15:29
007 Foch,2,6,8,2022,01-18,15:29
008 Halles Castellane,4,8,12,2022,01-18,15:29
009 Observatoire,3,5,8,2022,01-18,15:29
010 Rondelet,6,10,16,2022,01-18,15:29
011 Plan Cabanes,5,7,12,2022,01-18,15:29
012 Boutonnet,4,8,12,2022,01-18,15:29
013 Emile Combes,3,5,8,2022,01-18,15:29
014 Beaux-Arts,2,6,8,2022,01-18,15:29
015 Les Aubes,3,5,8,2022,01-18,15:29
016 Antigone centre,10,6,16,2022,01-18,15:29
017 M�diath�que Emile Zola,10,6,16,2022,01-18,15:29
018 Nombre d'Or,9,7,16,2022,01-18,15:29
019 Louis Blanc,5,11,16,2022,01-18,15:29
020 Gambetta,1,7,8,2022,01-18,15:29
021 Port Marianne,6,10,16,2022,01-18,15:29
022 Clemenceau,3,9,12,2022,01-18,15:29
023 Les Arceaux,0,16,16,2022,01-18,15:29
024 Cit� Mion,3,5,8,2022,01-18,15:29
025 Nouveau Saint-Roch,2,6,8,2022,01-18,15:29
026 Renouvier,3,5,8,2022,01-18,15:29
027 Odysseum,5,3,8,2022,01-18,15:29
028 Saint-Denis,5,3,8,2022,01-18,15:29
029 Richter,12,4,16,2022,01-18,15:29
030 Charles Flahault,4,4,8,2022,01-18,15:29
031 Voltaire,3,5,8,2022,01-18,15:29
032 Pr�s d'Ar�nes,7,1,8,2022,01-18,15:29
033 Garcia Lorca,8,0,8,2022,01-18,15:29
034 Vert Bois,0,16,16,2022,01-18,15:29
035 Malbosc,1,7,8,2022,01-18,15:29
036 Occitanie,2,30,32,2022,01-18,15:29
037 FacdesSciences,8,16,24,2022,01-18,15:29
038 Fac de Lettres,0,16,16,2022,01-18,15:29
039 Aiguelongue,4,4,8,2022,01-18,15:29
040 Jeu de Mail des Abb�s,4,4,8,2022,01-18,15:29
041 Eurom�decine,0,8,8,2022,01-18,15:29
042 Marie Caizergues,2,6,8,2022,01-18,15:29
043 Sabines,3,5,8,2022,01-18,15:29
044 Celleneuve,1,7,8,2022,01-18,15:29
045 Jardin de la Lironde,3,5,8,2022,01-18,15:29
046 P�re Soulas,6,2,8,2022,01-18,15:29
047 Place Viala,1,7,8,2022,01-18,15:29
048 H�tel du D�partement,2,6,8,2022,01-18,15:29
049 Tonnelles,1,7,8,2022,01-18,15:29
050 Parvis Jules Ferry - Gare Saint-Roch,7,1,8,2022,01-18,15:29
051 Pont de Lattes - Gare Saint-Roch,3,9,12,2022,01-18,15:29
053 Deux Ponts - Gare Saint-Roch,2,6,8,2022,01-18,15:29
054 Providence - Ovalie,5,3,8,2022,01-18,15:29
055 P�rols Etang de l'Or,18,50,68,2022,01-18,15:29
056 Albert 1er - Cath�drale,6,6,12,2022,01-18,15:29
057 Saint-Guilhem - Courreau,0,8,8,2022,01-18,15:29
059 Sud De France,1,7,8,2022,01-18,15:29
001 Rue Jules Ferry - Gare Saint-Roch,4,8,12,2022,01-18,15:39
002 Com�die,13,11,24,2022,01-18,15:39
003 Esplanade,15,17,32,2022,01-18,15:39
004 H�tel de Ville,14,2,16,2022,01-18,15:39
005 Corum,11,1,12,2022,01-18,15:39
006 Place Albert 1er - St Charles,17,14,31,2022,01-18,15:39
007 Foch,2,6,8,2022,01-18,15:39
008 Halles Castellane,4,8,12,2022,01-18,15:39
009 Observatoire,3,5,8,2022,01-18,15:39
010 Rondelet,6,10,16,2022,01-18,15:39
011 Plan Cabanes,5,7,12,2022,01-18,15:39
012 Boutonnet,5,7,12,2022,01-18,15:39
013 Emile Combes,3,5,8,2022,01-18,15:39
014 Beaux-Arts,2,6,8,2022,01-18,15:39
015 Les Aubes,3,5,8,2022,01-18,15:39
016 Antigone centre,10,6,16,2022,01-18,15:39
017 M�diath�que Emile Zola,10,6,16,2022,01-18,15:39
018 Nombre d'Or,10,6,16,2022,01-18,15:39
019 Louis Blanc,4,12,16,2022,01-18,15:39
020 Gambetta,1,7,8,2022,01-18,15:39
021 Port Marianne,8,8,16,2022,01-18,15:39
022 Clemenceau,3,9,12,2022,01-18,15:39
023 Les Arceaux,0,16,16,2022,01-18,15:39
024 Cit� Mion,3,5,8,2022,01-18,15:39
025 Nouveau Saint-Roch,2,6,8,2022,01-18,15:39
026 Renouvier,3,5,8,2022,01-18,15:39
027 Odysseum,5,3,8,2022,01-18,15:39
028 Saint-Denis,6,2,8,2022,01-18,15:39
029 Richter,12,4,16,2022,01-18,15:39
030 Charles Flahault,5,3,8,2022,01-18,15:39
031 Voltaire,3,5,8,2022,01-18,15:39
032 Pr�s d'Ar�nes,7,1,8,2022,01-18,15:39
033 Garcia Lorca,8,0,8,2022,01-18,15:39
034 Vert Bois,0,16,16,2022,01-18,15:39
035 Malbosc,1,7,8,2022,01-18,15:39
036 Occitanie,2,30,32,2022,01-18,15:39
037 FacdesSciences,9,15,24,2022,01-18,15:39
038 Fac de Lettres,0,16,16,2022,01-18,15:39
039 Aiguelongue,4,4,8,2022,01-18,15:39
040 Jeu de Mail des Abb�s,4,4,8,2022,01-18,15:39
041 Eurom�decine,0,8,8,2022,01-18,15:39
042 Marie Caizergues,2,6,8,2022,01-18,15:39
043 Sabines,3,5,8,2022,01-18,15:39
044 Celleneuve,1,7,8,2022,01-18,15:39
045 Jardin de la Lironde,3,5,8,2022,01-18,15:39
046 P�re Soulas,6,2,8,2022,01-18,15:39
047 Place Viala,1,7,8,2022,01-18,15:39
048 H�tel du D�partement,2,6,8,2022,01-18,15:39
049 Tonnelles,1,7,8,2022,01-18,15:39
050 Parvis Jules Ferry - Gare Saint-Roch,7,1,8,2022,01-18,15:39
051 Pont de Lattes - Gare Saint-Roch,3,9,12,2022,01-18,15:39
053 Deux Ponts - Gare Saint-Roch,2,6,8,2022,01-18,15:39
054 Providence - Ovalie,5,3,8,2022,01-18,15:39
055 P�rols Etang de l'Or,18,50,68,2022,01-18,15:39
056 Albert 1er - Cath�drale,6,6,12,2022,01-18,15:39
057 Saint-Guilhem - Courreau,0,8,8,2022,01-18,15:39
059 Sud De France,1,7,8,2022,01-18,15:39
001 Rue Jules Ferry - Gare Saint-Roch,4,8,12,2022,01-18,15:50
002 Com�die,13,11,24,2022,01-18,15:50
003 Esplanade,15,17,32,2022,01-18,15:50
004 H�tel de Ville,14,2,16,2022,01-18,15:50
005 Corum,9,3,12,2022,01-18,15:50
006 Place Albert 1er - St Charles,17,14,31,2022,01-18,15:50
007 Foch,1,7,8,2022,01-18,15:50
008 Halles Castellane,3,9,12,2022,01-18,15:50
009 Observatoire,3,5,8,2022,01-18,15:50
010 Rondelet,6,10,16,2022,01-18,15:50
011 Plan Cabanes,5,7,12,2022,01-18,15:50
012 Boutonnet,5,7,12,2022,01-18,15:50
013 Emile Combes,3,5,8,2022,01-18,15:50
014 Beaux-Arts,2,6,8,2022,01-18,15:50
015 Les Aubes,3,5,8,2022,01-18,15:50
016 Antigone centre,10,6,16,2022,01-18,15:50
017 M�diath�que Emile Zola,10,6,16,2022,01-18,15:50
018 Nombre d'Or,12,4,16,2022,01-18,15:50
019 Louis Blanc,4,12,16,2022,01-18,15:50
020 Gambetta,1,7,8,2022,01-18,15:50
021 Port Marianne,9,7,16,2022,01-18,15:50
022 Clemenceau,3,9,12,2022,01-18,15:50
023 Les Arceaux,0,16,16,2022,01-18,15:50
024 Cit� Mion,2,6,8,2022,01-18,15:50
025 Nouveau Saint-Roch,2,6,8,2022,01-18,15:50
026 Renouvier,3,5,8,2022,01-18,15:50
027 Odysseum,5,3,8,2022,01-18,15:50
028 Saint-Denis,6,2,8,2022,01-18,15:50
029 Richter,11,5,16,2022,01-18,15:50
030 Charles Flahault,6,2,8,2022,01-18,15:50
031 Voltaire,3,5,8,2022,01-18,15:50
032 Pr�s d'Ar�nes,7,1,8,2022,01-18,15:50
033 Garcia Lorca,8,0,8,2022,01-18,15:50
034 Vert Bois,0,16,16,2022,01-18,15:50
035 Malbosc,1,7,8,2022,01-18,15:50
036 Occitanie,2,30,32,2022,01-18,15:50
037 FacdesSciences,9,15,24,2022,01-18,15:50
038 Fac de Lettres,0,16,16,2022,01-18,15:50
039 Aiguelongue,4,4,8,2022,01-18,15:50
040 Jeu de Mail des Abb�s,4,4,8,2022,01-18,15:50
041 Eurom�decine,0,8,8,2022,01-18,15:50
042 Marie Caizergues,2,6,8,2022,01-18,15:50
043 Sabines,3,5,8,2022,01-18,15:50
044 Celleneuve,1,7,8,2022,01-18,15:50
045 Jardin de la Lironde,3,5,8,2022,01-18,15:50
046 P�re Soulas,6,2,8,2022,01-18,15:50
047 Place Viala,1,7,8,2022,01-18,15:50
048 H�tel du D�partement,2,6,8,2022,01-18,15:50
049 Tonnelles,1,7,8,2022,01-18,15:50
050 Parvis Jules Ferry - Gare Saint-Roch,7,1,8,2022,01-18,15:50
051 Pont de Lattes - Gare Saint-Roch,3,9,12,2022,01-18,15:50
053 Deux Ponts - Gare Saint-Roch,2,6,8,2022,01-18,15:50
054 Providence - Ovalie,5,3,8,2022,01-18,15:50
055 P�rols Etang de l'Or,18,50,68,2022,01-18,15:50
056 Albert 1er - Cath�drale,6,6,12,2022,01-18,15:50
057 Saint-Guilhem - Courreau,0,8,8,2022,01-18,15:50
059 Sud De France,1,7,8,2022,01-18,15:50
001 Rue Jules Ferry - Gare Saint-Roch,4,8,12,2022,01-18,16:00
002 Com�die,14,10,24,2022,01-18,16:00
003 Esplanade,14,18,32,2022,01-18,16:00
004 H�tel de Ville,14,2,16,2022,01-18,16:00
005 Corum,9,3,12,2022,01-18,16:00
006 Place Albert 1er - St Charles,17,14,31,2022,01-18,16:00
007 Foch,1,7,8,2022,01-18,16:00
008 Halles Castellane,2,10,12,2022,01-18,16:00
009 Observatoire,3,5,8,2022,01-18,16:00
010 Rondelet,6,10,16,2022,01-18,16:00
011 Plan Cabanes,5,7,12,2022,01-18,16:00
012 Boutonnet,5,7,12,2022,01-18,16:00
013 Emile Combes,3,5,8,2022,01-18,16:00
014 Beaux-Arts,2,6,8,2022,01-18,16:00
015 Les Aubes,3,5,8,2022,01-18,16:00
016 Antigone centre,10,6,16,2022,01-18,16:00
017 M�diath�que Emile Zola,11,5,16,2022,01-18,16:00
018 Nombre d'Or,12,4,16,2022,01-18,16:00
019 Louis Blanc,4,12,16,2022,01-18,16:00
020 Gambetta,1,7,8,2022,01-18,16:00
021 Port Marianne,9,7,16,2022,01-18,16:00
022 Clemenceau,3,9,12,2022,01-18,16:00
023 Les Arceaux,0,16,16,2022,01-18,16:00
024 Cit� Mion,3,5,8,2022,01-18,16:00
025 Nouveau Saint-Roch,2,6,8,2022,01-18,16:00
026 Renouvier,3,5,8,2022,01-18,16:00
027 Odysseum,5,3,8,2022,01-18,16:00
028 Saint-Denis,6,2,8,2022,01-18,16:00
029 Richter,11,5,16,2022,01-18,16:00
030 Charles Flahault,6,2,8,2022,01-18,16:00
031 Voltaire,3,5,8,2022,01-18,16:00
032 Pr�s d'Ar�nes,7,1,8,2022,01-18,16:00
033 Garcia Lorca,8,0,8,2022,01-18,16:00
034 Vert Bois,0,16,16,2022,01-18,16:00
035 Malbosc,1,7,8,2022,01-18,16:00
036 Occitanie,2,30,32,2022,01-18,16:00
037 FacdesSciences,9,15,24,2022,01-18,16:00
038 Fac de Lettres,0,16,16,2022,01-18,16:00
039 Aiguelongue,6,2,8,2022,01-18,16:00
040 Jeu de Mail des Abb�s,4,4,8,2022,01-18,16:00
041 Eurom�decine,0,8,8,2022,01-18,16:00
042 Marie Caizergues,2,6,8,2022,01-18,16:00
043 Sabines,3,5,8,2022,01-18,16:00
044 Celleneuve,0,8,8,2022,01-18,16:00
045 Jardin de la Lironde,3,5,8,2022,01-18,16:00
046 P�re Soulas,6,2,8,2022,01-18,16:00
047 Place Viala,1,7,8,2022,01-18,16:00
048 H�tel du D�partement,2,6,8,2022,01-18,16:00
049 Tonnelles,1,7,8,2022,01-18,16:00
050 Parvis Jules Ferry - Gare Saint-Roch,7,1,8,2022,01-18,16:00
051 Pont de Lattes - Gare Saint-Roch,3,9,12,2022,01-18,16:00
053 Deux Ponts - Gare Saint-Roch,2,6,8,2022,01-18,16:00
054 Providence - Ovalie,5,3,8,2022,01-18,16:00
055 P�rols Etang de l'Or,18,50,68,2022,01-18,16:00
056 Albert 1er - Cath�drale,6,6,12,2022,01-18,16:00
057 Saint-Guilhem - Courreau,0,8,8,2022,01-18,16:00
059 Sud De France,1,7,8,2022,01-18,16:00
001 Rue Jules Ferry - Gare Saint-Roch,4,8,12,2022,01-18,16:10
002 Com�die,14,10,24,2022,01-18,16:10
003 Esplanade,14,18,32,2022,01-18,16:10
004 H�tel de Ville,14,2,16,2022,01-18,16:10
005 Corum,9,3,12,2022,01-18,16:10
006 Place Albert 1er - St Charles,16,15,31,2022,01-18,16:10
007 Foch,1,7,8,2022,01-18,16:10
008 Halles Castellane,2,10,12,2022,01-18,16:10
009 Observatoire,4,4,8,2022,01-18,16:10
010 Rondelet,5,11,16,2022,01-18,16:10
011 Plan Cabanes,5,7,12,2022,01-18,16:10
012 Boutonnet,5,7,12,2022,01-18,16:10
013 Emile Combes,3,5,8,2022,01-18,16:10
014 Beaux-Arts,2,6,8,2022,01-18,16:10
015 Les Aubes,3,5,8,2022,01-18,16:10
016 Antigone centre,10,6,16,2022,01-18,16:10
017 M�diath�que Emile Zola,11,5,16,2022,01-18,16:10
018 Nombre d'Or,12,4,16,2022,01-18,16:10
019 Louis Blanc,2,14,16,2022,01-18,16:10
020 Gambetta,1,7,8,2022,01-18,16:10
021 Port Marianne,9,7,16,2022,01-18,16:10
022 Clemenceau,3,9,12,2022,01-18,16:10
023 Les Arceaux,0,16,16,2022,01-18,16:10
024 Cit� Mion,3,5,8,2022,01-18,16:10
025 Nouveau Saint-Roch,2,6,8,2022,01-18,16:10
026 Renouvier,3,5,8,2022,01-18,16:10
027 Odysseum,5,3,8,2022,01-18,16:10
028 Saint-Denis,6,2,8,2022,01-18,16:10
029 Richter,11,5,16,2022,01-18,16:10
030 Charles Flahault,6,2,8,2022,01-18,16:10
031 Voltaire,4,4,8,2022,01-18,16:10
032 Pr�s d'Ar�nes,8,0,8,2022,01-18,16:10
033 Garcia Lorca,8,0,8,2022,01-18,16:10
034 Vert Bois,0,16,16,2022,01-18,16:10
035 Malbosc,1,7,8,2022,01-18,16:10
036 Occitanie,2,30,32,2022,01-18,16:10
037 FacdesSciences,10,14,24,2022,01-18,16:10
038 Fac de Lettres,0,16,16,2022,01-18,16:10
039 Aiguelongue,6,2,8,2022,01-18,16:10
040 Jeu de Mail des Abb�s,4,4,8,2022,01-18,16:10
041 Eurom�decine,0,8,8,2022,01-18,16:10
042 Marie Caizergues,2,6,8,2022,01-18,16:10
043 Sabines,3,5,8,2022,01-18,16:10
044 Celleneuve,0,8,8,2022,01-18,16:10
045 Jardin de la Lironde,3,5,8,2022,01-18,16:10
046 P�re Soulas,6,2,8,2022,01-18,16:10
047 Place Viala,1,7,8,2022,01-18,16:10
048 H�tel du D�partement,2,6,8,2022,01-18,16:10
049 Tonnelles,1,7,8,2022,01-18,16:10
050 Parvis Jules Ferry - Gare Saint-Roch,7,1,8,2022,01-18,16:10
051 Pont de Lattes - Gare Saint-Roch,3,9,12,2022,01-18,16:10
053 Deux Ponts - Gare Saint-Roch,2,6,8,2022,01-18,16:10
054 Providence - Ovalie,5,3,8,2022,01-18,16:10
055 P�rols Etang de l'Or,18,50,68,2022,01-18,16:10
056 Albert 1er - Cath�drale,6,6,12,2022,01-18,16:10
057 Saint-Guilhem - Courreau,0,8,8,2022,01-18,16:10
059 Sud De France,1,7,8,2022,01-18,16:10
001 Rue Jules Ferry - Gare Saint-Roch,5,7,12,2022,01-18,16:20
002 Com�die,13,11,24,2022,01-18,16:20
003 Esplanade,14,18,32,2022,01-18,16:20
004 H�tel de Ville,14,2,16,2022,01-18,16:20
005 Corum,8,4,12,2022,01-18,16:20
006 Place Albert 1er - St Charles,16,15,31,2022,01-18,16:20
007 Foch,1,7,8,2022,01-18,16:20
008 Halles Castellane,2,10,12,2022,01-18,16:20
009 Observatoire,6,2,8,2022,01-18,16:20
010 Rondelet,5,11,16,2022,01-18,16:20
011 Plan Cabanes,5,7,12,2022,01-18,16:20
012 Boutonnet,5,7,12,2022,01-18,16:20
013 Emile Combes,3,5,8,2022,01-18,16:20
014 Beaux-Arts,2,6,8,2022,01-18,16:20
015 Les Aubes,5,3,8,2022,01-18,16:20
016 Antigone centre,11,5,16,2022,01-18,16:20
017 M�diath�que Emile Zola,11,5,16,2022,01-18,16:20
018 Nombre d'Or,12,4,16,2022,01-18,16:20
019 Louis Blanc,1,15,16,2022,01-18,16:20
020 Gambetta,1,7,8,2022,01-18,16:20
021 Port Marianne,13,3,16,2022,01-18,16:20
022 Clemenceau,3,9,12,2022,01-18,16:20
023 Les Arceaux,0,16,16,2022,01-18,16:20
024 Cit� Mion,2,6,8,2022,01-18,16:20
025 Nouveau Saint-Roch,2,6,8,2022,01-18,16:20
026 Renouvier,3,5,8,2022,01-18,16:20
027 Odysseum,5,3,8,2022,01-18,16:20
028 Saint-Denis,6,2,8,2022,01-18,16:20
029 Richter,11,5,16,2022,01-18,16:20
030 Charles Flahault,6,2,8,2022,01-18,16:20
031 Voltaire,4,4,8,2022,01-18,16:20
032 Pr�s d'Ar�nes,8,0,8,2022,01-18,16:20
033 Garcia Lorca,8,0,8,2022,01-18,16:20
034 Vert Bois,0,16,16,2022,01-18,16:20
035 Malbosc,1,7,8,2022,01-18,16:20
036 Occitanie,2,30,32,2022,01-18,16:20
037 FacdesSciences,10,14,24,2022,01-18,16:20
038 Fac de Lettres,0,16,16,2022,01-18,16:20
039 Aiguelongue,6,2,8,2022,01-18,16:20
040 Jeu de Mail des Abb�s,4,4,8,2022,01-18,16:20
041 Eurom�decine,0,8,8,2022,01-18,16:20
042 Marie Caizergues,2,6,8,2022,01-18,16:20
043 Sabines,3,5,8,2022,01-18,16:20
044 Celleneuve,0,8,8,2022,01-18,16:20
045 Jardin de la Lironde,3,5,8,2022,01-18,16:20
046 P�re Soulas,5,3,8,2022,01-18,16:20
047 Place Viala,1,7,8,2022,01-18,16:20
048 H�tel du D�partement,2,6,8,2022,01-18,16:20
049 Tonnelles,1,7,8,2022,01-18,16:20
050 Parvis Jules Ferry - Gare Saint-Roch,5,3,8,2022,01-18,16:20
051 Pont de Lattes - Gare Saint-Roch,3,9,12,2022,01-18,16:20
053 Deux Ponts - Gare Saint-Roch,2,6,8,2022,01-18,16:20
054 Providence - Ovalie,5,3,8,2022,01-18,16:20
055 P�rols Etang de l'Or,18,50,68,2022,01-18,16:20
056 Albert 1er - Cath�drale,6,6,12,2022,01-18,16:20
057 Saint-Guilhem - Courreau,0,8,8,2022,01-18,16:20
059 Sud De France,1,7,8,2022,01-18,16:20
001 Rue Jules Ferry - Gare Saint-Roch,5,7,12,2022,01-18,16:30
002 Com�die,13,11,24,2022,01-18,16:30
003 Esplanade,14,18,32,2022,01-18,16:30
004 H�tel de Ville,14,2,16,2022,01-18,16:30
005 Corum,8,4,12,2022,01-18,16:30
006 Place Albert 1er - St Charles,15,16,31,2022,01-18,16:30
007 Foch,1,7,8,2022,01-18,16:30
008 Halles Castellane,2,10,12,2022,01-18,16:30
009 Observatoire,5,3,8,2022,01-18,16:30
010 Rondelet,5,11,16,2022,01-18,16:30
011 Plan Cabanes,6,6,12,2022,01-18,16:30
012 Boutonnet,7,5,12,2022,01-18,16:30
013 Emile Combes,3,5,8,2022,01-18,16:30
014 Beaux-Arts,2,6,8,2022,01-18,16:30
015 Les Aubes,5,3,8,2022,01-18,16:30
016 Antigone centre,11,5,16,2022,01-18,16:30
017 M�diath�que Emile Zola,11,5,16,2022,01-18,16:30
018 Nombre d'Or,10,6,16,2022,01-18,16:30
019 Louis Blanc,1,15,16,2022,01-18,16:30
020 Gambetta,1,7,8,2022,01-18,16:30
021 Port Marianne,13,3,16,2022,01-18,16:30
022 Clemenceau,1,11,12,2022,01-18,16:30
023 Les Arceaux,0,16,16,2022,01-18,16:30
024 Cit� Mion,2,6,8,2022,01-18,16:30
025 Nouveau Saint-Roch,2,6,8,2022,01-18,16:30
026 Renouvier,3,5,8,2022,01-18,16:30
027 Odysseum,5,3,8,2022,01-18,16:30
028 Saint-Denis,6,2,8,2022,01-18,16:30
029 Richter,11,5,16,2022,01-18,16:30
030 Charles Flahault,6,2,8,2022,01-18,16:30
031 Voltaire,4,4,8,2022,01-18,16:30
032 Pr�s d'Ar�nes,8,0,8,2022,01-18,16:30
033 Garcia Lorca,8,0,8,2022,01-18,16:30
034 Vert Bois,0,16,16,2022,01-18,16:30
035 Malbosc,1,7,8,2022,01-18,16:30
036 Occitanie,2,30,32,2022,01-18,16:30
037 FacdesSciences,8,16,24,2022,01-18,16:30
038 Fac de Lettres,0,16,16,2022,01-18,16:30
039 Aiguelongue,7,1,8,2022,01-18,16:30
040 Jeu de Mail des Abb�s,4,4,8,2022,01-18,16:30
041 Eurom�decine,0,8,8,2022,01-18,16:30
042 Marie Caizergues,1,7,8,2022,01-18,16:30
043 Sabines,3,5,8,2022,01-18,16:30
044 Celleneuve,0,8,8,2022,01-18,16:30
045 Jardin de la Lironde,3,5,8,2022,01-18,16:30
046 P�re Soulas,6,2,8,2022,01-18,16:30
047 Place Viala,1,7,8,2022,01-18,16:30
048 H�tel du D�partement,2,6,8,2022,01-18,16:30
049 Tonnelles,1,7,8,2022,01-18,16:30
050 Parvis Jules Ferry - Gare Saint-Roch,5,3,8,2022,01-18,16:30
051 Pont de Lattes - Gare Saint-Roch,2,10,12,2022,01-18,16:30
053 Deux Ponts - Gare Saint-Roch,2,6,8,2022,01-18,16:30
054 Providence - Ovalie,5,3,8,2022,01-18,16:30
055 P�rols Etang de l'Or,20,48,68,2022,01-18,16:30
056 Albert 1er - Cath�drale,6,6,12,2022,01-18,16:30
057 Saint-Guilhem - Courreau,0,8,8,2022,01-18,16:30
059 Sud De France,1,7,8,2022,01-18,16:30
001 Rue Jules Ferry - Gare Saint-Roch,6,6,12,2022,01-18,16:40
002 Com�die,13,11,24,2022,01-18,16:40
003 Esplanade,14,18,32,2022,01-18,16:40
004 H�tel de Ville,14,2,16,2022,01-18,16:40
005 Corum,8,4,12,2022,01-18,16:40
006 Place Albert 1er - St Charles,16,15,31,2022,01-18,16:40
007 Foch,2,6,8,2022,01-18,16:40
008 Halles Castellane,4,8,12,2022,01-18,16:40
009 Observatoire,5,3,8,2022,01-18,16:40
010 Rondelet,5,11,16,2022,01-18,16:40
011 Plan Cabanes,5,7,12,2022,01-18,16:40
012 Boutonnet,8,4,12,2022,01-18,16:40
013 Emile Combes,3,5,8,2022,01-18,16:40
014 Beaux-Arts,2,6,8,2022,01-18,16:40
015 Les Aubes,5,3,8,2022,01-18,16:40
016 Antigone centre,11,5,16,2022,01-18,16:40
017 M�diath�que Emile Zola,11,5,16,2022,01-18,16:40
018 Nombre d'Or,10,6,16,2022,01-18,16:40
019 Louis Blanc,1,15,16,2022,01-18,16:40
020 Gambetta,2,6,8,2022,01-18,16:40
021 Port Marianne,13,3,16,2022,01-18,16:40
022 Clemenceau,1,11,12,2022,01-18,16:40
023 Les Arceaux,0,16,16,2022,01-18,16:40
024 Cit� Mion,2,6,8,2022,01-18,16:40
025 Nouveau Saint-Roch,2,6,8,2022,01-18,16:40
026 Renouvier,3,5,8,2022,01-18,16:40
027 Odysseum,5,3,8,2022,01-18,16:40
028 Saint-Denis,5,3,8,2022,01-18,16:40
029 Richter,11,5,16,2022,01-18,16:40
030 Charles Flahault,6,2,8,2022,01-18,16:40
031 Voltaire,4,4,8,2022,01-18,16:40
032 Pr�s d'Ar�nes,8,0,8,2022,01-18,16:40
033 Garcia Lorca,8,0,8,2022,01-18,16:40
034 Vert Bois,0,16,16,2022,01-18,16:40
035 Malbosc,1,7,8,2022,01-18,16:40
036 Occitanie,3,29,32,2022,01-18,16:40
037 FacdesSciences,7,17,24,2022,01-18,16:40
038 Fac de Lettres,0,16,16,2022,01-18,16:40
039 Aiguelongue,7,1,8,2022,01-18,16:40
040 Jeu de Mail des Abb�s,4,4,8,2022,01-18,16:40
041 Eurom�decine,0,8,8,2022,01-18,16:40
042 Marie Caizergues,1,7,8,2022,01-18,16:40
043 Sabines,3,5,8,2022,01-18,16:40
044 Celleneuve,0,8,8,2022,01-18,16:40
045 Jardin de la Lironde,3,5,8,2022,01-18,16:40
046 P�re Soulas,6,2,8,2022,01-18,16:40
047 Place Viala,1,7,8,2022,01-18,16:40
048 H�tel du D�partement,2,6,8,2022,01-18,16:40
049 Tonnelles,1,7,8,2022,01-18,16:40
050 Parvis Jules Ferry - Gare Saint-Roch,5,3,8,2022,01-18,16:40
051 Pont de Lattes - Gare Saint-Roch,2,10,12,2022,01-18,16:40
053 Deux Ponts - Gare Saint-Roch,2,6,8,2022,01-18,16:40
054 Providence - Ovalie,4,4,8,2022,01-18,16:40
055 P�rols Etang de l'Or,20,48,68,2022,01-18,16:40
056 Albert 1er - Cath�drale,6,6,12,2022,01-18,16:40
057 Saint-Guilhem - Courreau,2,6,8,2022,01-18,16:40
059 Sud De France,1,7,8,2022,01-18,16:40
001 Rue Jules Ferry - Gare Saint-Roch,6,6,12,2022,01-18,16:51
002 Com�die,13,11,24,2022,01-18,16:51
003 Esplanade,14,18,32,2022,01-18,16:51
004 H�tel de Ville,12,4,16,2022,01-18,16:51
005 Corum,8,4,12,2022,01-18,16:51
006 Place Albert 1er - St Charles,16,15,31,2022,01-18,16:51
007 Foch,2,6,8,2022,01-18,16:51
008 Halles Castellane,4,8,12,2022,01-18,16:51
009 Observatoire,5,3,8,2022,01-18,16:51
010 Rondelet,5,11,16,2022,01-18,16:51
011 Plan Cabanes,5,7,12,2022,01-18,16:51
012 Boutonnet,8,4,12,2022,01-18,16:51
013 Emile Combes,3,5,8,2022,01-18,16:51
014 Beaux-Arts,2,6,8,2022,01-18,16:51
015 Les Aubes,5,3,8,2022,01-18,16:51
016 Antigone centre,11,5,16,2022,01-18,16:51
017 M�diath�que Emile Zola,11,5,16,2022,01-18,16:51
018 Nombre d'Or,10,6,16,2022,01-18,16:51
019 Louis Blanc,2,14,16,2022,01-18,16:51
020 Gambetta,2,6,8,2022,01-18,16:51
021 Port Marianne,13,3,16,2022,01-18,16:51
022 Clemenceau,0,12,12,2022,01-18,16:51
023 Les Arceaux,0,16,16,2022,01-18,16:51
024 Cit� Mion,2,6,8,2022,01-18,16:51
025 Nouveau Saint-Roch,2,6,8,2022,01-18,16:51
026 Renouvier,3,5,8,2022,01-18,16:51
027 Odysseum,5,3,8,2022,01-18,16:51
028 Saint-Denis,6,2,8,2022,01-18,16:51
029 Richter,11,5,16,2022,01-18,16:51
030 Charles Flahault,5,3,8,2022,01-18,16:51
031 Voltaire,4,4,8,2022,01-18,16:51
032 Pr�s d'Ar�nes,8,0,8,2022,01-18,16:51
033 Garcia Lorca,8,0,8,2022,01-18,16:51
034 Vert Bois,0,16,16,2022,01-18,16:51
035 Malbosc,1,7,8,2022,01-18,16:51
036 Occitanie,3,29,32,2022,01-18,16:51
037 FacdesSciences,5,19,24,2022,01-18,16:51
038 Fac de Lettres,0,16,16,2022,01-18,16:51
039 Aiguelongue,5,3,8,2022,01-18,16:51
040 Jeu de Mail des Abb�s,4,4,8,2022,01-18,16:51
041 Eurom�decine,0,8,8,2022,01-18,16:51
042 Marie Caizergues,2,6,8,2022,01-18,16:51
043 Sabines,3,5,8,2022,01-18,16:51
044 Celleneuve,0,8,8,2022,01-18,16:51
045 Jardin de la Lironde,3,5,8,2022,01-18,16:51
046 P�re Soulas,5,3,8,2022,01-18,16:51
047 Place Viala,1,7,8,2022,01-18,16:51
048 H�tel du D�partement,2,6,8,2022,01-18,16:51
049 Tonnelles,1,7,8,2022,01-18,16:51
050 Parvis Jules Ferry - Gare Saint-Roch,5,3,8,2022,01-18,16:51
051 Pont de Lattes - Gare Saint-Roch,2,10,12,2022,01-18,16:51
053 Deux Ponts - Gare Saint-Roch,2,6,8,2022,01-18,16:51
054 Providence - Ovalie,4,4,8,2022,01-18,16:51
055 P�rols Etang de l'Or,18,50,68,2022,01-18,16:51
056 Albert 1er - Cath�drale,6,6,12,2022,01-18,16:51
057 Saint-Guilhem - Courreau,2,6,8,2022,01-18,16:51
059 Sud De France,1,7,8,2022,01-18,16:51
001 Rue Jules Ferry - Gare Saint-Roch,6,6,12,2022,01-18,17:01
002 Com�die,13,11,24,2022,01-18,17:01
003 Esplanade,14,18,32,2022,01-18,17:01
004 H�tel de Ville,14,2,16,2022,01-18,17:01
005 Corum,8,4,12,2022,01-18,17:01
006 Place Albert 1er - St Charles,17,14,31,2022,01-18,17:01
007 Foch,2,6,8,2022,01-18,17:01
008 Halles Castellane,3,9,12,2022,01-18,17:01
009 Observatoire,5,3,8,2022,01-18,17:01
010 Rondelet,5,11,16,2022,01-18,17:01
011 Plan Cabanes,5,7,12,2022,01-18,17:01
012 Boutonnet,8,4,12,2022,01-18,17:01
013 Emile Combes,3,5,8,2022,01-18,17:01
014 Beaux-Arts,2,6,8,2022,01-18,17:01
015 Les Aubes,5,3,8,2022,01-18,17:01
016 Antigone centre,11,5,16,2022,01-18,17:01
017 M�diath�que Emile Zola,10,6,16,2022,01-18,17:01
018 Nombre d'Or,10,6,16,2022,01-18,17:01
019 Louis Blanc,4,12,16,2022,01-18,17:01
020 Gambetta,2,6,8,2022,01-18,17:01
021 Port Marianne,13,3,16,2022,01-18,17:01
022 Clemenceau,0,12,12,2022,01-18,17:01
023 Les Arceaux,0,16,16,2022,01-18,17:01
024 Cit� Mion,2,6,8,2022,01-18,17:01
025 Nouveau Saint-Roch,2,6,8,2022,01-18,17:01
026 Renouvier,3,5,8,2022,01-18,17:01
027 Odysseum,5,3,8,2022,01-18,17:01
028 Saint-Denis,6,2,8,2022,01-18,17:01
029 Richter,11,5,16,2022,01-18,17:01
030 Charles Flahault,5,3,8,2022,01-18,17:01
031 Voltaire,5,3,8,2022,01-18,17:01
032 Pr�s d'Ar�nes,8,0,8,2022,01-18,17:01
033 Garcia Lorca,8,0,8,2022,01-18,17:01
034 Vert Bois,0,16,16,2022,01-18,17:01
035 Malbosc,1,7,8,2022,01-18,17:01
036 Occitanie,3,29,32,2022,01-18,17:01
037 FacdesSciences,5,19,24,2022,01-18,17:01
038 Fac de Lettres,0,16,16,2022,01-18,17:01
039 Aiguelongue,5,3,8,2022,01-18,17:01
040 Jeu de Mail des Abb�s,4,4,8,2022,01-18,17:01
041 Eurom�decine,0,8,8,2022,01-18,17:01
042 Marie Caizergues,2,6,8,2022,01-18,17:01
043 Sabines,3,5,8,2022,01-18,17:01
044 Celleneuve,0,8,8,2022,01-18,17:01
045 Jardin de la Lironde,3,5,8,2022,01-18,17:01
046 P�re Soulas,5,3,8,2022,01-18,17:01
047 Place Viala,1,7,8,2022,01-18,17:01
048 H�tel du D�partement,0,8,8,2022,01-18,17:01
049 Tonnelles,1,7,8,2022,01-18,17:01
050 Parvis Jules Ferry - Gare Saint-Roch,5,3,8,2022,01-18,17:01
051 Pont de Lattes - Gare Saint-Roch,2,10,12,2022,01-18,17:01
053 Deux Ponts - Gare Saint-Roch,2,6,8,2022,01-18,17:01
054 Providence - Ovalie,4,4,8,2022,01-18,17:01
055 P�rols Etang de l'Or,18,50,68,2022,01-18,17:01
056 Albert 1er - Cath�drale,6,6,12,2022,01-18,17:01
057 Saint-Guilhem - Courreau,2,6,8,2022,01-18,17:01
059 Sud De France,1,7,8,2022,01-18,17:01
001 Rue Jules Ferry - Gare Saint-Roch,6,6,12,2022,01-18,17:11
002 Com�die,13,11,24,2022,01-18,17:11
003 Esplanade,14,18,32,2022,01-18,17:11
004 H�tel de Ville,13,3,16,2022,01-18,17:11
005 Corum,8,4,12,2022,01-18,17:11
006 Place Albert 1er - St Charles,18,13,31,2022,01-18,17:11
007 Foch,2,6,8,2022,01-18,17:11
008 Halles Castellane,2,10,12,2022,01-18,17:11
009 Observatoire,6,2,8,2022,01-18,17:11
010 Rondelet,5,11,16,2022,01-18,17:11
011 Plan Cabanes,5,7,12,2022,01-18,17:11
012 Boutonnet,7,5,12,2022,01-18,17:11
013 Emile Combes,4,4,8,2022,01-18,17:11
014 Beaux-Arts,2,6,8,2022,01-18,17:11
015 Les Aubes,5,3,8,2022,01-18,17:11
016 Antigone centre,11,5,16,2022,01-18,17:11
017 M�diath�que Emile Zola,9,7,16,2022,01-18,17:11
018 Nombre d'Or,10,6,16,2022,01-18,17:11
019 Louis Blanc,2,14,16,2022,01-18,17:11
020 Gambetta,1,7,8,2022,01-18,17:11
021 Port Marianne,13,3,16,2022,01-18,17:11
022 Clemenceau,0,12,12,2022,01-18,17:11
023 Les Arceaux,0,16,16,2022,01-18,17:11
024 Cit� Mion,2,6,8,2022,01-18,17:11
025 Nouveau Saint-Roch,2,6,8,2022,01-18,17:11
026 Renouvier,3,5,8,2022,01-18,17:11
027 Odysseum,5,3,8,2022,01-18,17:11
028 Saint-Denis,6,2,8,2022,01-18,17:11
029 Richter,11,5,16,2022,01-18,17:11
030 Charles Flahault,5,3,8,2022,01-18,17:11
031 Voltaire,5,3,8,2022,01-18,17:11
032 Pr�s d'Ar�nes,7,1,8,2022,01-18,17:11
033 Garcia Lorca,7,1,8,2022,01-18,17:11
034 Vert Bois,0,16,16,2022,01-18,17:11
035 Malbosc,1,7,8,2022,01-18,17:11
036 Occitanie,3,29,32,2022,01-18,17:11
037 FacdesSciences,4,20,24,2022,01-18,17:11
038 Fac de Lettres,0,16,16,2022,01-18,17:11
039 Aiguelongue,5,3,8,2022,01-18,17:11
040 Jeu de Mail des Abb�s,4,4,8,2022,01-18,17:11
041 Eurom�decine,0,8,8,2022,01-18,17:11
042 Marie Caizergues,2,6,8,2022,01-18,17:11
043 Sabines,3,5,8,2022,01-18,17:11
044 Celleneuve,0,8,8,2022,01-18,17:11
045 Jardin de la Lironde,3,5,8,2022,01-18,17:11
046 P�re Soulas,5,3,8,2022,01-18,17:11
047 Place Viala,0,8,8,2022,01-18,17:11
048 H�tel du D�partement,0,8,8,2022,01-18,17:11
049 Tonnelles,1,7,8,2022,01-18,17:11
050 Parvis Jules Ferry - Gare Saint-Roch,5,3,8,2022,01-18,17:11
051 Pont de Lattes - Gare Saint-Roch,2,10,12,2022,01-18,17:11
053 Deux Ponts - Gare Saint-Roch,2,6,8,2022,01-18,17:11
054 Providence - Ovalie,4,4,8,2022,01-18,17:11
055 P�rols Etang de l'Or,18,50,68,2022,01-18,17:11
056 Albert 1er - Cath�drale,6,6,12,2022,01-18,17:11
057 Saint-Guilhem - Courreau,1,7,8,2022,01-18,17:11
059 Sud De France,1,7,8,2022,01-18,17:11
001 Rue Jules Ferry - Gare Saint-Roch,6,6,12,2022,01-18,17:21
002 Com�die,13,11,24,2022,01-18,17:21
003 Esplanade,12,20,32,2022,01-18,17:21
004 H�tel de Ville,14,2,16,2022,01-18,17:21
005 Corum,7,5,12,2022,01-18,17:21
006 Place Albert 1er - St Charles,18,13,31,2022,01-18,17:21
007 Foch,2,6,8,2022,01-18,17:21
008 Halles Castellane,2,10,12,2022,01-18,17:21
009 Observatoire,6,2,8,2022,01-18,17:21
010 Rondelet,5,11,16,2022,01-18,17:21
011 Plan Cabanes,5,7,12,2022,01-18,17:21
012 Boutonnet,6,6,12,2022,01-18,17:21
013 Emile Combes,4,4,8,2022,01-18,17:21
014 Beaux-Arts,2,6,8,2022,01-18,17:21
015 Les Aubes,5,3,8,2022,01-18,17:21
016 Antigone centre,11,5,16,2022,01-18,17:21
017 M�diath�que Emile Zola,8,8,16,2022,01-18,17:21
018 Nombre d'Or,10,6,16,2022,01-18,17:21
019 Louis Blanc,2,14,16,2022,01-18,17:21
020 Gambetta,0,8,8,2022,01-18,17:21
021 Port Marianne,14,2,16,2022,01-18,17:21
022 Clemenceau,1,11,12,2022,01-18,17:21
023 Les Arceaux,0,16,16,2022,01-18,17:21
024 Cit� Mion,2,6,8,2022,01-18,17:21
025 Nouveau Saint-Roch,2,6,8,2022,01-18,17:21
026 Renouvier,3,5,8,2022,01-18,17:21
027 Odysseum,5,3,8,2022,01-18,17:21
028 Saint-Denis,6,2,8,2022,01-18,17:21
029 Richter,11,5,16,2022,01-18,17:21
030 Charles Flahault,4,4,8,2022,01-18,17:21
031 Voltaire,5,3,8,2022,01-18,17:21
032 Pr�s d'Ar�nes,7,1,8,2022,01-18,17:21
033 Garcia Lorca,8,0,8,2022,01-18,17:21
034 Vert Bois,0,16,16,2022,01-18,17:21
035 Malbosc,1,7,8,2022,01-18,17:21
036 Occitanie,3,29,32,2022,01-18,17:21
037 FacdesSciences,3,21,24,2022,01-18,17:21
038 Fac de Lettres,0,16,16,2022,01-18,17:21
039 Aiguelongue,5,3,8,2022,01-18,17:21
040 Jeu de Mail des Abb�s,5,3,8,2022,01-18,17:21
041 Eurom�decine,0,8,8,2022,01-18,17:21
042 Marie Caizergues,2,6,8,2022,01-18,17:21
043 Sabines,3,5,8,2022,01-18,17:21
044 Celleneuve,0,8,8,2022,01-18,17:21
045 Jardin de la Lironde,0,8,8,2022,01-18,17:21
046 P�re Soulas,5,3,8,2022,01-18,17:21
047 Place Viala,1,7,8,2022,01-18,17:21
048 H�tel du D�partement,0,8,8,2022,01-18,17:21
049 Tonnelles,1,7,8,2022,01-18,17:21
050 Parvis Jules Ferry - Gare Saint-Roch,5,3,8,2022,01-18,17:21
051 Pont de Lattes - Gare Saint-Roch,2,10,12,2022,01-18,17:21
053 Deux Ponts - Gare Saint-Roch,2,6,8,2022,01-18,17:21
054 Providence - Ovalie,4,4,8,2022,01-18,17:21
055 P�rols Etang de l'Or,18,50,68,2022,01-18,17:21
056 Albert 1er - Cath�drale,7,5,12,2022,01-18,17:21
057 Saint-Guilhem - Courreau,2,6,8,2022,01-18,17:21
059 Sud De France,1,7,8,2022,01-18,17:21
001 Rue Jules Ferry - Gare Saint-Roch,7,5,12,2022,01-18,17:31
002 Com�die,13,11,24,2022,01-18,17:31
003 Esplanade,12,20,32,2022,01-18,17:31
004 H�tel de Ville,14,2,16,2022,01-18,17:31
005 Corum,8,4,12,2022,01-18,17:31
006 Place Albert 1er - St Charles,19,12,31,2022,01-18,17:31
007 Foch,2,6,8,2022,01-18,17:31
008 Halles Castellane,1,11,12,2022,01-18,17:31
009 Observatoire,6,2,8,2022,01-18,17:31
010 Rondelet,5,11,16,2022,01-18,17:31
011 Plan Cabanes,7,5,12,2022,01-18,17:31
012 Boutonnet,6,6,12,2022,01-18,17:31
013 Emile Combes,4,4,8,2022,01-18,17:31
014 Beaux-Arts,2,6,8,2022,01-18,17:31
015 Les Aubes,5,3,8,2022,01-18,17:31
016 Antigone centre,11,5,16,2022,01-18,17:31
017 M�diath�que Emile Zola,8,8,16,2022,01-18,17:31
018 Nombre d'Or,11,5,16,2022,01-18,17:31
019 Louis Blanc,2,14,16,2022,01-18,17:31
020 Gambetta,0,8,8,2022,01-18,17:31
021 Port Marianne,14,2,16,2022,01-18,17:31
022 Clemenceau,1,11,12,2022,01-18,17:31
023 Les Arceaux,0,16,16,2022,01-18,17:31
024 Cit� Mion,2,6,8,2022,01-18,17:31
025 Nouveau Saint-Roch,2,6,8,2022,01-18,17:31
026 Renouvier,3,5,8,2022,01-18,17:31
027 Odysseum,5,3,8,2022,01-18,17:31
028 Saint-Denis,5,3,8,2022,01-18,17:31
029 Richter,12,4,16,2022,01-18,17:31
030 Charles Flahault,4,4,8,2022,01-18,17:31
031 Voltaire,5,3,8,2022,01-18,17:31
032 Pr�s d'Ar�nes,7,1,8,2022,01-18,17:31
033 Garcia Lorca,8,0,8,2022,01-18,17:31
034 Vert Bois,0,16,16,2022,01-18,17:31
035 Malbosc,1,7,8,2022,01-18,17:31
036 Occitanie,3,29,32,2022,01-18,17:31
037 FacdesSciences,3,21,24,2022,01-18,17:31
038 Fac de Lettres,0,16,16,2022,01-18,17:31
039 Aiguelongue,5,3,8,2022,01-18,17:31
040 Jeu de Mail des Abb�s,7,1,8,2022,01-18,17:31
041 Eurom�decine,0,8,8,2022,01-18,17:31
042 Marie Caizergues,2,6,8,2022,01-18,17:31
043 Sabines,3,5,8,2022,01-18,17:31
044 Celleneuve,0,8,8,2022,01-18,17:31
045 Jardin de la Lironde,0,8,8,2022,01-18,17:31
046 P�re Soulas,4,4,8,2022,01-18,17:31
047 Place Viala,1,7,8,2022,01-18,17:31
048 H�tel du D�partement,0,8,8,2022,01-18,17:31
049 Tonnelles,1,7,8,2022,01-18,17:31
050 Parvis Jules Ferry - Gare Saint-Roch,5,3,8,2022,01-18,17:31
051 Pont de Lattes - Gare Saint-Roch,2,10,12,2022,01-18,17:31
053 Deux Ponts - Gare Saint-Roch,2,6,8,2022,01-18,17:31
054 Providence - Ovalie,4,4,8,2022,01-18,17:31
055 P�rols Etang de l'Or,19,49,68,2022,01-18,17:31
056 Albert 1er - Cath�drale,7,5,12,2022,01-18,17:31
057 Saint-Guilhem - Courreau,5,3,8,2022,01-18,17:31
059 Sud De France,1,7,8,2022,01-18,17:31
001 Rue Jules Ferry - Gare Saint-Roch,7,5,12,2022,01-18,17:41
002 Com�die,13,11,24,2022,01-18,17:41
003 Esplanade,12,20,32,2022,01-18,17:41
004 H�tel de Ville,15,1,16,2022,01-18,17:41
005 Corum,8,4,12,2022,01-18,17:41
006 Place Albert 1er - St Charles,19,12,31,2022,01-18,17:41
007 Foch,2,6,8,2022,01-18,17:41
008 Halles Castellane,0,12,12,2022,01-18,17:41
009 Observatoire,7,1,8,2022,01-18,17:41
010 Rondelet,5,11,16,2022,01-18,17:41
011 Plan Cabanes,7,5,12,2022,01-18,17:41
012 Boutonnet,4,8,12,2022,01-18,17:41
013 Emile Combes,4,4,8,2022,01-18,17:41
014 Beaux-Arts,2,6,8,2022,01-18,17:41
015 Les Aubes,5,3,8,2022,01-18,17:41
016 Antigone centre,10,6,16,2022,01-18,17:41
017 M�diath�que Emile Zola,8,8,16,2022,01-18,17:41
018 Nombre d'Or,11,5,16,2022,01-18,17:41
019 Louis Blanc,2,14,16,2022,01-18,17:41
020 Gambetta,0,8,8,2022,01-18,17:41
021 Port Marianne,14,2,16,2022,01-18,17:41
022 Clemenceau,1,11,12,2022,01-18,17:41
023 Les Arceaux,0,16,16,2022,01-18,17:41
024 Cit� Mion,2,6,8,2022,01-18,17:41
025 Nouveau Saint-Roch,2,6,8,2022,01-18,17:41
026 Renouvier,3,5,8,2022,01-18,17:41
027 Odysseum,5,3,8,2022,01-18,17:41
028 Saint-Denis,4,4,8,2022,01-18,17:41
029 Richter,12,4,16,2022,01-18,17:41
030 Charles Flahault,4,4,8,2022,01-18,17:41
031 Voltaire,5,3,8,2022,01-18,17:41
032 Pr�s d'Ar�nes,8,0,8,2022,01-18,17:41
033 Garcia Lorca,8,0,8,2022,01-18,17:41
034 Vert Bois,0,16,16,2022,01-18,17:41
035 Malbosc,2,6,8,2022,01-18,17:41
036 Occitanie,3,29,32,2022,01-18,17:41
037 FacdesSciences,3,21,24,2022,01-18,17:41
038 Fac de Lettres,0,16,16,2022,01-18,17:41
039 Aiguelongue,5,3,8,2022,01-18,17:41
040 Jeu de Mail des Abb�s,7,1,8,2022,01-18,17:41
041 Eurom�decine,0,8,8,2022,01-18,17:41
042 Marie Caizergues,2,6,8,2022,01-18,17:41
043 Sabines,3,5,8,2022,01-18,17:41
044 Celleneuve,0,8,8,2022,01-18,17:41
045 Jardin de la Lironde,0,8,8,2022,01-18,17:41
046 P�re Soulas,4,4,8,2022,01-18,17:41
047 Place Viala,2,6,8,2022,01-18,17:41
048 H�tel du D�partement,0,8,8,2022,01-18,17:41
049 Tonnelles,1,7,8,2022,01-18,17:41
050 Parvis Jules Ferry - Gare Saint-Roch,5,3,8,2022,01-18,17:41
051 Pont de Lattes - Gare Saint-Roch,2,10,12,2022,01-18,17:41
053 Deux Ponts - Gare Saint-Roch,2,6,8,2022,01-18,17:41
054 Providence - Ovalie,4,4,8,2022,01-18,17:41
055 P�rols Etang de l'Or,19,49,68,2022,01-18,17:41
056 Albert 1er - Cath�drale,7,5,12,2022,01-18,17:41
057 Saint-Guilhem - Courreau,5,3,8,2022,01-18,17:41
059 Sud De France,1,7,8,2022,01-18,17:41
001 Rue Jules Ferry - Gare Saint-Roch,7,5,12,2022,01-18,17:52
002 Com�die,14,10,24,2022,01-18,17:52
003 Esplanade,13,19,32,2022,01-18,17:52
004 H�tel de Ville,15,1,16,2022,01-18,17:52
005 Corum,8,4,12,2022,01-18,17:52
006 Place Albert 1er - St Charles,20,11,31,2022,01-18,17:52
007 Foch,2,6,8,2022,01-18,17:52
008 Halles Castellane,0,12,12,2022,01-18,17:52
009 Observatoire,7,1,8,2022,01-18,17:52
010 Rondelet,5,11,16,2022,01-18,17:52
011 Plan Cabanes,7,5,12,2022,01-18,17:52
012 Boutonnet,4,8,12,2022,01-18,17:52
013 Emile Combes,4,4,8,2022,01-18,17:52
014 Beaux-Arts,2,6,8,2022,01-18,17:52
015 Les Aubes,5,3,8,2022,01-18,17:52
016 Antigone centre,10,6,16,2022,01-18,17:52
017 M�diath�que Emile Zola,8,8,16,2022,01-18,17:52
018 Nombre d'Or,11,5,16,2022,01-18,17:52
019 Louis Blanc,3,13,16,2022,01-18,17:52
020 Gambetta,0,8,8,2022,01-18,17:52
021 Port Marianne,14,2,16,2022,01-18,17:52
022 Clemenceau,1,11,12,2022,01-18,17:52
023 Les Arceaux,2,14,16,2022,01-18,17:52
024 Cit� Mion,2,6,8,2022,01-18,17:52
025 Nouveau Saint-Roch,3,5,8,2022,01-18,17:52
026 Renouvier,3,5,8,2022,01-18,17:52
027 Odysseum,5,3,8,2022,01-18,17:52
028 Saint-Denis,4,4,8,2022,01-18,17:52
029 Richter,12,4,16,2022,01-18,17:52
030 Charles Flahault,4,4,8,2022,01-18,17:52
031 Voltaire,5,3,8,2022,01-18,17:52
032 Pr�s d'Ar�nes,8,0,8,2022,01-18,17:52
033 Garcia Lorca,8,0,8,2022,01-18,17:52
034 Vert Bois,0,16,16,2022,01-18,17:52
035 Malbosc,1,7,8,2022,01-18,17:52
036 Occitanie,2,30,32,2022,01-18,17:52
037 FacdesSciences,1,23,24,2022,01-18,17:52
038 Fac de Lettres,0,16,16,2022,01-18,17:52
039 Aiguelongue,5,3,8,2022,01-18,17:52
040 Jeu de Mail des Abb�s,7,1,8,2022,01-18,17:52
041 Eurom�decine,0,8,8,2022,01-18,17:52
042 Marie Caizergues,2,6,8,2022,01-18,17:52
043 Sabines,3,5,8,2022,01-18,17:52
044 Celleneuve,0,8,8,2022,01-18,17:52
045 Jardin de la Lironde,0,8,8,2022,01-18,17:52
046 P�re Soulas,4,4,8,2022,01-18,17:52
047 Place Viala,2,6,8,2022,01-18,17:52
048 H�tel du D�partement,0,8,8,2022,01-18,17:52
049 Tonnelles,1,7,8,2022,01-18,17:52
050 Parvis Jules Ferry - Gare Saint-Roch,5,3,8,2022,01-18,17:52
051 Pont de Lattes - Gare Saint-Roch,2,10,12,2022,01-18,17:52
053 Deux Ponts - Gare Saint-Roch,2,6,8,2022,01-18,17:52
054 Providence - Ovalie,4,4,8,2022,01-18,17:52
055 P�rols Etang de l'Or,19,49,68,2022,01-18,17:52
056 Albert 1er - Cath�drale,7,5,12,2022,01-18,17:52
057 Saint-Guilhem - Courreau,4,4,8,2022,01-18,17:52
059 Sud De France,1,7,8,2022,01-18,17:52
001 Rue Jules Ferry - Gare Saint-Roch,7,5,12,2022,01-18,18:02
002 Com�die,15,9,24,2022,01-18,18:02
003 Esplanade,11,21,32,2022,01-18,18:02
004 H�tel de Ville,15,1,16,2022,01-18,18:02
005 Corum,8,4,12,2022,01-18,18:02
006 Place Albert 1er - St Charles,20,11,31,2022,01-18,18:02
007 Foch,2,6,8,2022,01-18,18:02
008 Halles Castellane,0,12,12,2022,01-18,18:02
009 Observatoire,7,1,8,2022,01-18,18:02
010 Rondelet,5,11,16,2022,01-18,18:02
011 Plan Cabanes,7,5,12,2022,01-18,18:02
012 Boutonnet,4,8,12,2022,01-18,18:02
013 Emile Combes,4,4,8,2022,01-18,18:02
014 Beaux-Arts,2,6,8,2022,01-18,18:02
015 Les Aubes,5,3,8,2022,01-18,18:02
016 Antigone centre,11,5,16,2022,01-18,18:02
017 M�diath�que Emile Zola,8,8,16,2022,01-18,18:02
018 Nombre d'Or,11,5,16,2022,01-18,18:02
019 Louis Blanc,4,12,16,2022,01-18,18:02
020 Gambetta,1,7,8,2022,01-18,18:02
021 Port Marianne,14,2,16,2022,01-18,18:02
022 Clemenceau,2,10,12,2022,01-18,18:02
023 Les Arceaux,3,13,16,2022,01-18,18:02
024 Cit� Mion,2,6,8,2022,01-18,18:02
025 Nouveau Saint-Roch,2,6,8,2022,01-18,18:02
026 Renouvier,4,4,8,2022,01-18,18:02
027 Odysseum,5,3,8,2022,01-18,18:02
028 Saint-Denis,2,6,8,2022,01-18,18:02
029 Richter,12,4,16,2022,01-18,18:02
030 Charles Flahault,4,4,8,2022,01-18,18:02
031 Voltaire,4,4,8,2022,01-18,18:02
032 Pr�s d'Ar�nes,8,0,8,2022,01-18,18:02
033 Garcia Lorca,8,0,8,2022,01-18,18:02
034 Vert Bois,0,16,16,2022,01-18,18:02
035 Malbosc,1,7,8,2022,01-18,18:02
036 Occitanie,2,30,32,2022,01-18,18:02
037 FacdesSciences,1,23,24,2022,01-18,18:02
038 Fac de Lettres,0,16,16,2022,01-18,18:02
039 Aiguelongue,5,3,8,2022,01-18,18:02
040 Jeu de Mail des Abb�s,7,1,8,2022,01-18,18:02
041 Eurom�decine,0,8,8,2022,01-18,18:02
042 Marie Caizergues,2,6,8,2022,01-18,18:02
043 Sabines,3,5,8,2022,01-18,18:02
044 Celleneuve,0,8,8,2022,01-18,18:02
045 Jardin de la Lironde,0,8,8,2022,01-18,18:02
046 P�re Soulas,4,4,8,2022,01-18,18:02
047 Place Viala,2,6,8,2022,01-18,18:02
048 H�tel du D�partement,0,8,8,2022,01-18,18:02
049 Tonnelles,1,7,8,2022,01-18,18:02
050 Parvis Jules Ferry - Gare Saint-Roch,2,6,8,2022,01-18,18:02
051 Pont de Lattes - Gare Saint-Roch,2,10,12,2022,01-18,18:02
053 Deux Ponts - Gare Saint-Roch,2,6,8,2022,01-18,18:02
054 Providence - Ovalie,4,4,8,2022,01-18,18:02
055 P�rols Etang de l'Or,19,49,68,2022,01-18,18:02
056 Albert 1er - Cath�drale,7,5,12,2022,01-18,18:02
057 Saint-Guilhem - Courreau,4,4,8,2022,01-18,18:02
059 Sud De France,1,7,8,2022,01-18,18:02
001 Rue Jules Ferry - Gare Saint-Roch,7,5,12,2022,01-18,18:12
002 Com�die,13,11,24,2022,01-18,18:12
003 Esplanade,11,21,32,2022,01-18,18:12
004 H�tel de Ville,15,1,16,2022,01-18,18:12
005 Corum,8,4,12,2022,01-18,18:12
006 Place Albert 1er - St Charles,20,11,31,2022,01-18,18:12
007 Foch,2,6,8,2022,01-18,18:12
008 Halles Castellane,0,12,12,2022,01-18,18:12
009 Observatoire,7,1,8,2022,01-18,18:12
010 Rondelet,5,11,16,2022,01-18,18:12
011 Plan Cabanes,8,4,12,2022,01-18,18:12
012 Boutonnet,1,11,12,2022,01-18,18:12
013 Emile Combes,4,4,8,2022,01-18,18:12
014 Beaux-Arts,2,6,8,2022,01-18,18:12
015 Les Aubes,5,3,8,2022,01-18,18:12
016 Antigone centre,11,5,16,2022,01-18,18:12
017 M�diath�que Emile Zola,8,8,16,2022,01-18,18:12
018 Nombre d'Or,11,5,16,2022,01-18,18:12
019 Louis Blanc,6,10,16,2022,01-18,18:12
020 Gambetta,1,7,8,2022,01-18,18:12
021 Port Marianne,14,2,16,2022,01-18,18:12
022 Clemenceau,1,11,12,2022,01-18,18:12
023 Les Arceaux,3,13,16,2022,01-18,18:12
024 Cit� Mion,2,6,8,2022,01-18,18:12
025 Nouveau Saint-Roch,1,7,8,2022,01-18,18:12
026 Renouvier,5,3,8,2022,01-18,18:12
027 Odysseum,5,3,8,2022,01-18,18:12
028 Saint-Denis,2,6,8,2022,01-18,18:12
029 Richter,12,4,16,2022,01-18,18:12
030 Charles Flahault,4,4,8,2022,01-18,18:12
031 Voltaire,4,4,8,2022,01-18,18:12
032 Pr�s d'Ar�nes,8,0,8,2022,01-18,18:12
033 Garcia Lorca,8,0,8,2022,01-18,18:12
034 Vert Bois,0,16,16,2022,01-18,18:12
035 Malbosc,1,7,8,2022,01-18,18:12
036 Occitanie,1,31,32,2022,01-18,18:12
037 FacdesSciences,0,24,24,2022,01-18,18:12
038 Fac de Lettres,1,15,16,2022,01-18,18:12
039 Aiguelongue,4,4,8,2022,01-18,18:12
040 Jeu de Mail des Abb�s,7,1,8,2022,01-18,18:12
041 Eurom�decine,0,8,8,2022,01-18,18:12
042 Marie Caizergues,2,6,8,2022,01-18,18:12
043 Sabines,3,5,8,2022,01-18,18:12
044 Celleneuve,0,8,8,2022,01-18,18:12
045 Jardin de la Lironde,0,8,8,2022,01-18,18:12
046 P�re Soulas,4,4,8,2022,01-18,18:12
047 Place Viala,1,7,8,2022,01-18,18:12
048 H�tel du D�partement,0,8,8,2022,01-18,18:12
049 Tonnelles,1,7,8,2022,01-18,18:12
050 Parvis Jules Ferry - Gare Saint-Roch,2,6,8,2022,01-18,18:12
051 Pont de Lattes - Gare Saint-Roch,2,10,12,2022,01-18,18:12
053 Deux Ponts - Gare Saint-Roch,2,6,8,2022,01-18,18:12
054 Providence - Ovalie,4,4,8,2022,01-18,18:12
055 P�rols Etang de l'Or,19,49,68,2022,01-18,18:12
056 Albert 1er - Cath�drale,7,5,12,2022,01-18,18:12
057 Saint-Guilhem - Courreau,4,4,8,2022,01-18,18:12
059 Sud De France,1,7,8,2022,01-18,18:12
001 Rue Jules Ferry - Gare Saint-Roch,7,5,12,2022,01-18,18:22
002 Com�die,13,11,24,2022,01-18,18:22
003 Esplanade,11,21,32,2022,01-18,18:22
004 H�tel de Ville,15,1,16,2022,01-18,18:22
005 Corum,8,4,12,2022,01-18,18:22
006 Place Albert 1er - St Charles,20,11,31,2022,01-18,18:22
007 Foch,2,6,8,2022,01-18,18:22
008 Halles Castellane,1,11,12,2022,01-18,18:22
009 Observatoire,7,1,8,2022,01-18,18:22
010 Rondelet,5,11,16,2022,01-18,18:22
011 Plan Cabanes,8,4,12,2022,01-18,18:22
012 Boutonnet,1,11,12,2022,01-18,18:22
013 Emile Combes,3,5,8,2022,01-18,18:22
014 Beaux-Arts,2,6,8,2022,01-18,18:22
015 Les Aubes,5,3,8,2022,01-18,18:22
016 Antigone centre,11,5,16,2022,01-18,18:22
017 M�diath�que Emile Zola,8,8,16,2022,01-18,18:22
018 Nombre d'Or,11,5,16,2022,01-18,18:22
019 Louis Blanc,7,9,16,2022,01-18,18:22
020 Gambetta,1,7,8,2022,01-18,18:22
021 Port Marianne,15,1,16,2022,01-18,18:22
022 Clemenceau,2,10,12,2022,01-18,18:22
023 Les Arceaux,3,13,16,2022,01-18,18:22
024 Cit� Mion,2,6,8,2022,01-18,18:22
025 Nouveau Saint-Roch,1,7,8,2022,01-18,18:22
026 Renouvier,5,3,8,2022,01-18,18:22
027 Odysseum,4,4,8,2022,01-18,18:22
028 Saint-Denis,3,5,8,2022,01-18,18:22
029 Richter,12,4,16,2022,01-18,18:22
030 Charles Flahault,4,4,8,2022,01-18,18:22
031 Voltaire,4,4,8,2022,01-18,18:22
032 Pr�s d'Ar�nes,8,0,8,2022,01-18,18:22
033 Garcia Lorca,8,0,8,2022,01-18,18:22
034 Vert Bois,0,16,16,2022,01-18,18:22
035 Malbosc,1,7,8,2022,01-18,18:22
036 Occitanie,1,31,32,2022,01-18,18:22
037 FacdesSciences,0,24,24,2022,01-18,18:22
038 Fac de Lettres,1,15,16,2022,01-18,18:22
039 Aiguelongue,4,4,8,2022,01-18,18:22
040 Jeu de Mail des Abb�s,7,1,8,2022,01-18,18:22
041 Eurom�decine,0,8,8,2022,01-18,18:22
042 Marie Caizergues,2,6,8,2022,01-18,18:22
043 Sabines,3,5,8,2022,01-18,18:22
044 Celleneuve,0,8,8,2022,01-18,18:22
045 Jardin de la Lironde,0,8,8,2022,01-18,18:22
046 P�re Soulas,4,4,8,2022,01-18,18:22
047 Place Viala,1,7,8,2022,01-18,18:22
048 H�tel du D�partement,0,8,8,2022,01-18,18:22
049 Tonnelles,1,7,8,2022,01-18,18:22
050 Parvis Jules Ferry - Gare Saint-Roch,2,6,8,2022,01-18,18:22
051 Pont de Lattes - Gare Saint-Roch,2,10,12,2022,01-18,18:22
053 Deux Ponts - Gare Saint-Roch,2,6,8,2022,01-18,18:22
054 Providence - Ovalie,4,4,8,2022,01-18,18:22
055 P�rols Etang de l'Or,19,49,68,2022,01-18,18:22
056 Albert 1er - Cath�drale,7,5,12,2022,01-18,18:22
057 Saint-Guilhem - Courreau,5,3,8,2022,01-18,18:22
059 Sud De France,1,7,8,2022,01-18,18:22
001 Rue Jules Ferry - Gare Saint-Roch,7,5,12,2022,01-18,18:32
002 Com�die,13,11,24,2022,01-18,18:32
003 Esplanade,9,23,32,2022,01-18,18:32
004 H�tel de Ville,15,1,16,2022,01-18,18:32
005 Corum,8,4,12,2022,01-18,18:32
006 Place Albert 1er - St Charles,20,11,31,2022,01-18,18:32
007 Foch,2,6,8,2022,01-18,18:32
008 Halles Castellane,1,11,12,2022,01-18,18:32
009 Observatoire,7,1,8,2022,01-18,18:32
010 Rondelet,5,11,16,2022,01-18,18:32
011 Plan Cabanes,9,3,12,2022,01-18,18:32
012 Boutonnet,1,11,12,2022,01-18,18:32
013 Emile Combes,3,5,8,2022,01-18,18:32
014 Beaux-Arts,2,6,8,2022,01-18,18:32
015 Les Aubes,5,3,8,2022,01-18,18:32
016 Antigone centre,12,4,16,2022,01-18,18:32
017 M�diath�que Emile Zola,8,8,16,2022,01-18,18:32
018 Nombre d'Or,11,5,16,2022,01-18,18:32
019 Louis Blanc,7,9,16,2022,01-18,18:32
020 Gambetta,1,7,8,2022,01-18,18:32
021 Port Marianne,15,1,16,2022,01-18,18:32
022 Clemenceau,2,10,12,2022,01-18,18:32
023 Les Arceaux,3,13,16,2022,01-18,18:32
024 Cit� Mion,2,6,8,2022,01-18,18:32
025 Nouveau Saint-Roch,1,7,8,2022,01-18,18:32
026 Renouvier,3,5,8,2022,01-18,18:32
027 Odysseum,4,4,8,2022,01-18,18:32
028 Saint-Denis,3,5,8,2022,01-18,18:32
029 Richter,12,4,16,2022,01-18,18:32
030 Charles Flahault,5,3,8,2022,01-18,18:32
031 Voltaire,4,4,8,2022,01-18,18:32
032 Pr�s d'Ar�nes,8,0,8,2022,01-18,18:32
033 Garcia Lorca,8,0,8,2022,01-18,18:32
034 Vert Bois,0,16,16,2022,01-18,18:32
035 Malbosc,1,7,8,2022,01-18,18:32
036 Occitanie,1,31,32,2022,01-18,18:32
037 FacdesSciences,0,24,24,2022,01-18,18:32
038 Fac de Lettres,1,15,16,2022,01-18,18:32
039 Aiguelongue,4,4,8,2022,01-18,18:32
040 Jeu de Mail des Abb�s,7,1,8,2022,01-18,18:32
041 Eurom�decine,0,8,8,2022,01-18,18:32
042 Marie Caizergues,2,6,8,2022,01-18,18:32
043 Sabines,3,5,8,2022,01-18,18:32
044 Celleneuve,0,8,8,2022,01-18,18:32
045 Jardin de la Lironde,0,8,8,2022,01-18,18:32
046 P�re Soulas,4,4,8,2022,01-18,18:32
047 Place Viala,1,7,8,2022,01-18,18:32
048 H�tel du D�partement,0,8,8,2022,01-18,18:32
049 Tonnelles,1,7,8,2022,01-18,18:32
050 Parvis Jules Ferry - Gare Saint-Roch,2,6,8,2022,01-18,18:32
051 Pont de Lattes - Gare Saint-Roch,2,10,12,2022,01-18,18:32
053 Deux Ponts - Gare Saint-Roch,2,6,8,2022,01-18,18:32
054 Providence - Ovalie,4,4,8,2022,01-18,18:32
055 P�rols Etang de l'Or,19,49,68,2022,01-18,18:32
056 Albert 1er - Cath�drale,7,5,12,2022,01-18,18:32
057 Saint-Guilhem - Courreau,4,4,8,2022,01-18,18:32
059 Sud De France,1,7,8,2022,01-18,18:32
001 Rue Jules Ferry - Gare Saint-Roch,7,5,12,2022,01-18,18:43
002 Com�die,13,11,24,2022,01-18,18:43
003 Esplanade,10,22,32,2022,01-18,18:43
004 H�tel de Ville,15,1,16,2022,01-18,18:43
005 Corum,7,5,12,2022,01-18,18:43
006 Place Albert 1er - St Charles,20,11,31,2022,01-18,18:43
007 Foch,2,6,8,2022,01-18,18:43
008 Halles Castellane,1,11,12,2022,01-18,18:43
009 Observatoire,7,1,8,2022,01-18,18:43
010 Rondelet,5,11,16,2022,01-18,18:43
011 Plan Cabanes,9,3,12,2022,01-18,18:43
012 Boutonnet,1,11,12,2022,01-18,18:43
013 Emile Combes,3,5,8,2022,01-18,18:43
014 Beaux-Arts,2,6,8,2022,01-18,18:43
015 Les Aubes,5,3,8,2022,01-18,18:43
016 Antigone centre,14,2,16,2022,01-18,18:43
017 M�diath�que Emile Zola,8,8,16,2022,01-18,18:43
018 Nombre d'Or,11,5,16,2022,01-18,18:43
019 Louis Blanc,7,9,16,2022,01-18,18:43
020 Gambetta,1,7,8,2022,01-18,18:43
021 Port Marianne,15,1,16,2022,01-18,18:43
022 Clemenceau,2,10,12,2022,01-18,18:43
023 Les Arceaux,3,13,16,2022,01-18,18:43
024 Cit� Mion,2,6,8,2022,01-18,18:43
025 Nouveau Saint-Roch,1,7,8,2022,01-18,18:43
026 Renouvier,4,4,8,2022,01-18,18:43
027 Odysseum,4,4,8,2022,01-18,18:43
028 Saint-Denis,4,4,8,2022,01-18,18:43
029 Richter,11,5,16,2022,01-18,18:43
030 Charles Flahault,5,3,8,2022,01-18,18:43
031 Voltaire,4,4,8,2022,01-18,18:43
032 Pr�s d'Ar�nes,8,0,8,2022,01-18,18:43
033 Garcia Lorca,8,0,8,2022,01-18,18:43
034 Vert Bois,0,16,16,2022,01-18,18:43
035 Malbosc,1,7,8,2022,01-18,18:43
036 Occitanie,1,31,32,2022,01-18,18:43
037 FacdesSciences,0,24,24,2022,01-18,18:43
038 Fac de Lettres,0,16,16,2022,01-18,18:43
039 Aiguelongue,4,4,8,2022,01-18,18:43
040 Jeu de Mail des Abb�s,8,0,8,2022,01-18,18:43
041 Eurom�decine,0,8,8,2022,01-18,18:43
042 Marie Caizergues,2,6,8,2022,01-18,18:43
043 Sabines,3,5,8,2022,01-18,18:43
044 Celleneuve,0,8,8,2022,01-18,18:43
045 Jardin de la Lironde,0,8,8,2022,01-18,18:43
046 P�re Soulas,5,3,8,2022,01-18,18:43
047 Place Viala,1,7,8,2022,01-18,18:43
048 H�tel du D�partement,0,8,8,2022,01-18,18:43
049 Tonnelles,1,7,8,2022,01-18,18:43
050 Parvis Jules Ferry - Gare Saint-Roch,1,7,8,2022,01-18,18:43
051 Pont de Lattes - Gare Saint-Roch,2,10,12,2022,01-18,18:43
053 Deux Ponts - Gare Saint-Roch,2,6,8,2022,01-18,18:43
054 Providence - Ovalie,4,4,8,2022,01-18,18:43
055 P�rols Etang de l'Or,23,45,68,2022,01-18,18:43
056 Albert 1er - Cath�drale,7,5,12,2022,01-18,18:43
057 Saint-Guilhem - Courreau,4,4,8,2022,01-18,18:43
059 Sud De France,1,7,8,2022,01-18,18:43
001 Rue Jules Ferry - Gare Saint-Roch,7,5,12,2022,01-18,18:53
002 Com�die,13,11,24,2022,01-18,18:53
003 Esplanade,10,22,32,2022,01-18,18:53
004 H�tel de Ville,15,1,16,2022,01-18,18:53
005 Corum,8,4,12,2022,01-18,18:53
006 Place Albert 1er - St Charles,20,11,31,2022,01-18,18:53
007 Foch,2,6,8,2022,01-18,18:53
008 Halles Castellane,1,11,12,2022,01-18,18:53
009 Observatoire,7,1,8,2022,01-18,18:53
010 Rondelet,5,11,16,2022,01-18,18:53
011 Plan Cabanes,8,4,12,2022,01-18,18:53
012 Boutonnet,1,11,12,2022,01-18,18:53
013 Emile Combes,3,5,8,2022,01-18,18:53
014 Beaux-Arts,2,6,8,2022,01-18,18:53
015 Les Aubes,6,2,8,2022,01-18,18:53
016 Antigone centre,14,2,16,2022,01-18,18:53
017 M�diath�que Emile Zola,8,8,16,2022,01-18,18:53
018 Nombre d'Or,14,2,16,2022,01-18,18:53
019 Louis Blanc,7,9,16,2022,01-18,18:53
020 Gambetta,1,7,8,2022,01-18,18:53
021 Port Marianne,15,1,16,2022,01-18,18:53
022 Clemenceau,2,10,12,2022,01-18,18:53
023 Les Arceaux,3,13,16,2022,01-18,18:53
024 Cit� Mion,2,6,8,2022,01-18,18:53
025 Nouveau Saint-Roch,1,7,8,2022,01-18,18:53
026 Renouvier,4,4,8,2022,01-18,18:53
027 Odysseum,5,3,8,2022,01-18,18:53
028 Saint-Denis,4,4,8,2022,01-18,18:53
029 Richter,11,5,16,2022,01-18,18:53
030 Charles Flahault,5,3,8,2022,01-18,18:53
031 Voltaire,4,4,8,2022,01-18,18:53
032 Pr�s d'Ar�nes,8,0,8,2022,01-18,18:53
033 Garcia Lorca,8,0,8,2022,01-18,18:53
034 Vert Bois,0,16,16,2022,01-18,18:53
035 Malbosc,1,7,8,2022,01-18,18:53
036 Occitanie,1,31,32,2022,01-18,18:53
037 FacdesSciences,0,24,24,2022,01-18,18:53
038 Fac de Lettres,0,16,16,2022,01-18,18:53
039 Aiguelongue,4,4,8,2022,01-18,18:53
040 Jeu de Mail des Abb�s,8,0,8,2022,01-18,18:53
041 Eurom�decine,0,8,8,2022,01-18,18:53
042 Marie Caizergues,2,6,8,2022,01-18,18:53
043 Sabines,3,5,8,2022,01-18,18:53
044 Celleneuve,0,8,8,2022,01-18,18:53
045 Jardin de la Lironde,1,7,8,2022,01-18,18:53
046 P�re Soulas,5,3,8,2022,01-18,18:53
047 Place Viala,1,7,8,2022,01-18,18:53
048 H�tel du D�partement,0,8,8,2022,01-18,18:53
049 Tonnelles,1,7,8,2022,01-18,18:53
050 Parvis Jules Ferry - Gare Saint-Roch,1,7,8,2022,01-18,18:53
051 Pont de Lattes - Gare Saint-Roch,2,10,12,2022,01-18,18:53
053 Deux Ponts - Gare Saint-Roch,2,6,8,2022,01-18,18:53
054 Providence - Ovalie,4,4,8,2022,01-18,18:53
055 P�rols Etang de l'Or,23,45,68,2022,01-18,18:53
056 Albert 1er - Cath�drale,7,5,12,2022,01-18,18:53
057 Saint-Guilhem - Courreau,4,4,8,2022,01-18,18:53
059 Sud De France,1,7,8,2022,01-18,18:53
001 Rue Jules Ferry - Gare Saint-Roch,6,6,12,2022,01-18,19:03
002 Com�die,11,13,24,2022,01-18,19:03
003 Esplanade,10,22,32,2022,01-18,19:03
004 H�tel de Ville,15,1,16,2022,01-18,19:03
005 Corum,8,4,12,2022,01-18,19:03
006 Place Albert 1er - St Charles,20,11,31,2022,01-18,19:03
007 Foch,2,6,8,2022,01-18,19:03
008 Halles Castellane,1,11,12,2022,01-18,19:03
009 Observatoire,7,1,8,2022,01-18,19:03
010 Rondelet,5,11,16,2022,01-18,19:03
011 Plan Cabanes,8,4,12,2022,01-18,19:03
012 Boutonnet,1,11,12,2022,01-18,19:03
013 Emile Combes,3,5,8,2022,01-18,19:03
014 Beaux-Arts,2,6,8,2022,01-18,19:03
015 Les Aubes,6,2,8,2022,01-18,19:03
016 Antigone centre,15,1,16,2022,01-18,19:03
017 M�diath�que Emile Zola,8,8,16,2022,01-18,19:03
018 Nombre d'Or,14,2,16,2022,01-18,19:03
019 Louis Blanc,7,9,16,2022,01-18,19:03
020 Gambetta,1,7,8,2022,01-18,19:03
021 Port Marianne,15,1,16,2022,01-18,19:03
022 Clemenceau,2,10,12,2022,01-18,19:03
023 Les Arceaux,3,13,16,2022,01-18,19:03
024 Cit� Mion,2,6,8,2022,01-18,19:03
025 Nouveau Saint-Roch,1,7,8,2022,01-18,19:03
026 Renouvier,5,3,8,2022,01-18,19:03
027 Odysseum,5,3,8,2022,01-18,19:03
028 Saint-Denis,4,4,8,2022,01-18,19:03
029 Richter,10,6,16,2022,01-18,19:03
030 Charles Flahault,6,2,8,2022,01-18,19:03
031 Voltaire,4,4,8,2022,01-18,19:03
032 Pr�s d'Ar�nes,8,0,8,2022,01-18,19:03
033 Garcia Lorca,8,0,8,2022,01-18,19:03
034 Vert Bois,0,16,16,2022,01-18,19:03
035 Malbosc,0,8,8,2022,01-18,19:03
036 Occitanie,1,31,32,2022,01-18,19:03
037 FacdesSciences,0,24,24,2022,01-18,19:03
038 Fac de Lettres,0,16,16,2022,01-18,19:03
039 Aiguelongue,4,4,8,2022,01-18,19:03
040 Jeu de Mail des Abb�s,8,0,8,2022,01-18,19:03
041 Eurom�decine,0,8,8,2022,01-18,19:03
042 Marie Caizergues,2,6,8,2022,01-18,19:03
043 Sabines,3,5,8,2022,01-18,19:03
044 Celleneuve,0,8,8,2022,01-18,19:03
045 Jardin de la Lironde,2,6,8,2022,01-18,19:03
046 P�re Soulas,5,3,8,2022,01-18,19:03
047 Place Viala,1,7,8,2022,01-18,19:03
048 H�tel du D�partement,0,8,8,2022,01-18,19:03
049 Tonnelles,1,7,8,2022,01-18,19:03
050 Parvis Jules Ferry - Gare Saint-Roch,1,7,8,2022,01-18,19:03
051 Pont de Lattes - Gare Saint-Roch,2,10,12,2022,01-18,19:03
053 Deux Ponts - Gare Saint-Roch,2,6,8,2022,01-18,19:03
054 Providence - Ovalie,4,4,8,2022,01-18,19:03
055 P�rols Etang de l'Or,23,45,68,2022,01-18,19:03
056 Albert 1er - Cath�drale,7,5,12,2022,01-18,19:03
057 Saint-Guilhem - Courreau,4,4,8,2022,01-18,19:03
059 Sud De France,0,8,8,2022,01-18,19:03
001 Rue Jules Ferry - Gare Saint-Roch,6,6,12,2022,01-18,19:14
002 Com�die,12,12,24,2022,01-18,19:14
003 Esplanade,10,22,32,2022,01-18,19:14
004 H�tel de Ville,13,3,16,2022,01-18,19:14
005 Corum,8,4,12,2022,01-18,19:14
006 Place Albert 1er - St Charles,19,12,31,2022,01-18,19:14
007 Foch,2,6,8,2022,01-18,19:14
008 Halles Castellane,1,11,12,2022,01-18,19:14
009 Observatoire,7,1,8,2022,01-18,19:14
010 Rondelet,5,11,16,2022,01-18,19:14
011 Plan Cabanes,8,4,12,2022,01-18,19:14
012 Boutonnet,1,11,12,2022,01-18,19:14
013 Emile Combes,4,4,8,2022,01-18,19:14
014 Beaux-Arts,2,6,8,2022,01-18,19:14
015 Les Aubes,6,2,8,2022,01-18,19:14
016 Antigone centre,15,1,16,2022,01-18,19:14
017 M�diath�que Emile Zola,8,8,16,2022,01-18,19:14
018 Nombre d'Or,14,2,16,2022,01-18,19:14
019 Louis Blanc,7,9,16,2022,01-18,19:14
020 Gambetta,1,7,8,2022,01-18,19:14
021 Port Marianne,15,1,16,2022,01-18,19:14
022 Clemenceau,2,10,12,2022,01-18,19:14
023 Les Arceaux,3,13,16,2022,01-18,19:14
024 Cit� Mion,2,6,8,2022,01-18,19:14
025 Nouveau Saint-Roch,1,7,8,2022,01-18,19:14
026 Renouvier,5,3,8,2022,01-18,19:14
027 Odysseum,5,3,8,2022,01-18,19:14
028 Saint-Denis,4,4,8,2022,01-18,19:14
029 Richter,10,6,16,2022,01-18,19:14
030 Charles Flahault,6,2,8,2022,01-18,19:14
031 Voltaire,4,4,8,2022,01-18,19:14
032 Pr�s d'Ar�nes,8,0,8,2022,01-18,19:14
033 Garcia Lorca,8,0,8,2022,01-18,19:14
034 Vert Bois,0,16,16,2022,01-18,19:14
035 Malbosc,0,8,8,2022,01-18,19:14
036 Occitanie,1,31,32,2022,01-18,19:14
037 FacdesSciences,0,24,24,2022,01-18,19:14
038 Fac de Lettres,0,16,16,2022,01-18,19:14
039 Aiguelongue,5,3,8,2022,01-18,19:14
040 Jeu de Mail des Abb�s,8,0,8,2022,01-18,19:14
041 Eurom�decine,0,8,8,2022,01-18,19:14
042 Marie Caizergues,2,6,8,2022,01-18,19:14
043 Sabines,3,5,8,2022,01-18,19:14
044 Celleneuve,0,8,8,2022,01-18,19:14
045 Jardin de la Lironde,2,6,8,2022,01-18,19:14
046 P�re Soulas,5,3,8,2022,01-18,19:14
047 Place Viala,1,7,8,2022,01-18,19:14
048 H�tel du D�partement,0,8,8,2022,01-18,19:14
049 Tonnelles,1,7,8,2022,01-18,19:14
050 Parvis Jules Ferry - Gare Saint-Roch,1,7,8,2022,01-18,19:14
051 Pont de Lattes - Gare Saint-Roch,2,10,12,2022,01-18,19:14
053 Deux Ponts - Gare Saint-Roch,2,6,8,2022,01-18,19:14
054 Providence - Ovalie,4,4,8,2022,01-18,19:14
055 P�rols Etang de l'Or,23,45,68,2022,01-18,19:14
056 Albert 1er - Cath�drale,7,5,12,2022,01-18,19:14
057 Saint-Guilhem - Courreau,4,4,8,2022,01-18,19:14
059 Sud De France,0,8,8,2022,01-18,19:14
001 Rue Jules Ferry - Gare Saint-Roch,6,6,12,2022,01-18,19:24
002 Com�die,12,12,24,2022,01-18,19:24
003 Esplanade,10,22,32,2022,01-18,19:24
004 H�tel de Ville,13,3,16,2022,01-18,19:24
005 Corum,8,4,12,2022,01-18,19:24
006 Place Albert 1er - St Charles,20,11,31,2022,01-18,19:24
007 Foch,1,7,8,2022,01-18,19:24
008 Halles Castellane,1,11,12,2022,01-18,19:24
009 Observatoire,7,1,8,2022,01-18,19:24
010 Rondelet,5,11,16,2022,01-18,19:24
011 Plan Cabanes,8,4,12,2022,01-18,19:24
012 Boutonnet,1,11,12,2022,01-18,19:24
013 Emile Combes,4,4,8,2022,01-18,19:24
014 Beaux-Arts,2,6,8,2022,01-18,19:24
015 Les Aubes,6,2,8,2022,01-18,19:24
016 Antigone centre,15,1,16,2022,01-18,19:24
017 M�diath�que Emile Zola,8,8,16,2022,01-18,19:24
018 Nombre d'Or,15,1,16,2022,01-18,19:24
019 Louis Blanc,7,9,16,2022,01-18,19:24
020 Gambetta,0,8,8,2022,01-18,19:24
021 Port Marianne,15,1,16,2022,01-18,19:24
022 Clemenceau,2,10,12,2022,01-18,19:24
023 Les Arceaux,2,14,16,2022,01-18,19:24
024 Cit� Mion,2,6,8,2022,01-18,19:24
025 Nouveau Saint-Roch,1,7,8,2022,01-18,19:24
026 Renouvier,5,3,8,2022,01-18,19:24
027 Odysseum,5,3,8,2022,01-18,19:24
028 Saint-Denis,4,4,8,2022,01-18,19:24
029 Richter,10,6,16,2022,01-18,19:24
030 Charles Flahault,6,2,8,2022,01-18,19:24
031 Voltaire,4,4,8,2022,01-18,19:24
032 Pr�s d'Ar�nes,8,0,8,2022,01-18,19:24
033 Garcia Lorca,8,0,8,2022,01-18,19:24
034 Vert Bois,0,16,16,2022,01-18,19:24
035 Malbosc,0,8,8,2022,01-18,19:24
036 Occitanie,1,31,32,2022,01-18,19:24
037 FacdesSciences,0,24,24,2022,01-18,19:24
038 Fac de Lettres,0,16,16,2022,01-18,19:24
039 Aiguelongue,5,3,8,2022,01-18,19:24
040 Jeu de Mail des Abb�s,8,0,8,2022,01-18,19:24
041 Eurom�decine,0,8,8,2022,01-18,19:24
042 Marie Caizergues,2,6,8,2022,01-18,19:24
043 Sabines,3,5,8,2022,01-18,19:24
044 Celleneuve,0,8,8,2022,01-18,19:24
045 Jardin de la Lironde,2,6,8,2022,01-18,19:24
046 P�re Soulas,5,3,8,2022,01-18,19:24
047 Place Viala,1,7,8,2022,01-18,19:24
048 H�tel du D�partement,0,8,8,2022,01-18,19:24
049 Tonnelles,1,7,8,2022,01-18,19:24
050 Parvis Jules Ferry - Gare Saint-Roch,1,7,8,2022,01-18,19:24
051 Pont de Lattes - Gare Saint-Roch,2,10,12,2022,01-18,19:24
053 Deux Ponts - Gare Saint-Roch,2,6,8,2022,01-18,19:24
054 Providence - Ovalie,4,4,8,2022,01-18,19:24
055 P�rols Etang de l'Or,23,45,68,2022,01-18,19:24
056 Albert 1er - Cath�drale,7,5,12,2022,01-18,19:24
057 Saint-Guilhem - Courreau,4,4,8,2022,01-18,19:24
059 Sud De France,0,8,8,2022,01-18,19:24
001 Rue Jules Ferry - Gare Saint-Roch,6,6,12,2022,01-18,19:34
002 Com�die,12,12,24,2022,01-18,19:34
003 Esplanade,9,23,32,2022,01-18,19:34
004 H�tel de Ville,13,3,16,2022,01-18,19:34
005 Corum,8,4,12,2022,01-18,19:34
006 Place Albert 1er - St Charles,21,10,31,2022,01-18,19:34
007 Foch,1,7,8,2022,01-18,19:34
008 Halles Castellane,1,11,12,2022,01-18,19:34
009 Observatoire,7,1,8,2022,01-18,19:34
010 Rondelet,5,11,16,2022,01-18,19:34
011 Plan Cabanes,8,4,12,2022,01-18,19:34
012 Boutonnet,3,9,12,2022,01-18,19:34
013 Emile Combes,4,4,8,2022,01-18,19:34
014 Beaux-Arts,2,6,8,2022,01-18,19:34
015 Les Aubes,6,2,8,2022,01-18,19:34
016 Antigone centre,15,1,16,2022,01-18,19:34
017 M�diath�que Emile Zola,9,7,16,2022,01-18,19:34
018 Nombre d'Or,15,1,16,2022,01-18,19:34
019 Louis Blanc,7,9,16,2022,01-18,19:34
020 Gambetta,0,8,8,2022,01-18,19:34
021 Port Marianne,15,1,16,2022,01-18,19:34
022 Clemenceau,2,10,12,2022,01-18,19:34
023 Les Arceaux,2,14,16,2022,01-18,19:34
024 Cit� Mion,2,6,8,2022,01-18,19:34
025 Nouveau Saint-Roch,1,7,8,2022,01-18,19:34
026 Renouvier,5,3,8,2022,01-18,19:34
027 Odysseum,4,4,8,2022,01-18,19:34
028 Saint-Denis,4,4,8,2022,01-18,19:34
029 Richter,10,6,16,2022,01-18,19:34
030 Charles Flahault,7,1,8,2022,01-18,19:34
031 Voltaire,4,4,8,2022,01-18,19:34
032 Pr�s d'Ar�nes,8,0,8,2022,01-18,19:34
033 Garcia Lorca,8,0,8,2022,01-18,19:34
034 Vert Bois,0,16,16,2022,01-18,19:34
035 Malbosc,0,8,8,2022,01-18,19:34
036 Occitanie,1,31,32,2022,01-18,19:34
037 FacdesSciences,1,23,24,2022,01-18,19:34
038 Fac de Lettres,0,16,16,2022,01-18,19:34
039 Aiguelongue,5,3,8,2022,01-18,19:34
040 Jeu de Mail des Abb�s,8,0,8,2022,01-18,19:34
041 Eurom�decine,0,8,8,2022,01-18,19:34
042 Marie Caizergues,3,5,8,2022,01-18,19:34
043 Sabines,3,5,8,2022,01-18,19:34
044 Celleneuve,0,8,8,2022,01-18,19:34
045 Jardin de la Lironde,2,6,8,2022,01-18,19:34
046 P�re Soulas,6,2,8,2022,01-18,19:34
047 Place Viala,1,7,8,2022,01-18,19:34
048 H�tel du D�partement,0,8,8,2022,01-18,19:34
049 Tonnelles,1,7,8,2022,01-18,19:34
050 Parvis Jules Ferry - Gare Saint-Roch,1,7,8,2022,01-18,19:34
051 Pont de Lattes - Gare Saint-Roch,2,10,12,2022,01-18,19:34
053 Deux Ponts - Gare Saint-Roch,2,6,8,2022,01-18,19:34
054 Providence - Ovalie,4,4,8,2022,01-18,19:34
055 P�rols Etang de l'Or,23,45,68,2022,01-18,19:34
056 Albert 1er - Cath�drale,7,5,12,2022,01-18,19:34
057 Saint-Guilhem - Courreau,4,4,8,2022,01-18,19:34
059 Sud De France,0,8,8,2022,01-18,19:34
001 Rue Jules Ferry - Gare Saint-Roch,6,6,12,2022,01-18,19:45
002 Com�die,11,13,24,2022,01-18,19:45
003 Esplanade,9,23,32,2022,01-18,19:45
004 H�tel de Ville,13,3,16,2022,01-18,19:45
005 Corum,9,3,12,2022,01-18,19:45
006 Place Albert 1er - St Charles,21,10,31,2022,01-18,19:45
007 Foch,1,7,8,2022,01-18,19:45
008 Halles Castellane,1,11,12,2022,01-18,19:45
009 Observatoire,7,1,8,2022,01-18,19:45
010 Rondelet,3,13,16,2022,01-18,19:45
011 Plan Cabanes,8,4,12,2022,01-18,19:45
012 Boutonnet,2,10,12,2022,01-18,19:45
013 Emile Combes,4,4,8,2022,01-18,19:45
014 Beaux-Arts,2,6,8,2022,01-18,19:45
015 Les Aubes,6,2,8,2022,01-18,19:45
016 Antigone centre,15,1,16,2022,01-18,19:45
017 M�diath�que Emile Zola,10,6,16,2022,01-18,19:45
018 Nombre d'Or,15,1,16,2022,01-18,19:45
019 Louis Blanc,8,8,16,2022,01-18,19:45
020 Gambetta,0,8,8,2022,01-18,19:45
021 Port Marianne,16,0,16,2022,01-18,19:45
022 Clemenceau,2,10,12,2022,01-18,19:45
023 Les Arceaux,1,15,16,2022,01-18,19:45
024 Cit� Mion,2,6,8,2022,01-18,19:45
025 Nouveau Saint-Roch,1,7,8,2022,01-18,19:45
026 Renouvier,5,3,8,2022,01-18,19:45
027 Odysseum,4,4,8,2022,01-18,19:45
028 Saint-Denis,4,4,8,2022,01-18,19:45
029 Richter,10,6,16,2022,01-18,19:45
030 Charles Flahault,7,1,8,2022,01-18,19:45
031 Voltaire,4,4,8,2022,01-18,19:45
032 Pr�s d'Ar�nes,8,0,8,2022,01-18,19:45
033 Garcia Lorca,8,0,8,2022,01-18,19:45
034 Vert Bois,0,16,16,2022,01-18,19:45
035 Malbosc,0,8,8,2022,01-18,19:45
036 Occitanie,1,31,32,2022,01-18,19:45
037 FacdesSciences,1,23,24,2022,01-18,19:45
038 Fac de Lettres,0,16,16,2022,01-18,19:45
039 Aiguelongue,5,3,8,2022,01-18,19:45
040 Jeu de Mail des Abb�s,8,0,8,2022,01-18,19:45
041 Eurom�decine,0,8,8,2022,01-18,19:45
042 Marie Caizergues,3,5,8,2022,01-18,19:45
043 Sabines,3,5,8,2022,01-18,19:45
044 Celleneuve,0,8,8,2022,01-18,19:45
045 Jardin de la Lironde,2,6,8,2022,01-18,19:45
046 P�re Soulas,6,2,8,2022,01-18,19:45
047 Place Viala,1,7,8,2022,01-18,19:45
048 H�tel du D�partement,0,8,8,2022,01-18,19:45
049 Tonnelles,1,7,8,2022,01-18,19:45
050 Parvis Jules Ferry - Gare Saint-Roch,1,7,8,2022,01-18,19:45
051 Pont de Lattes - Gare Saint-Roch,2,10,12,2022,01-18,19:45
053 Deux Ponts - Gare Saint-Roch,2,6,8,2022,01-18,19:45
054 Providence - Ovalie,4,4,8,2022,01-18,19:45
055 P�rols Etang de l'Or,23,45,68,2022,01-18,19:45
056 Albert 1er - Cath�drale,7,5,12,2022,01-18,19:45
057 Saint-Guilhem - Courreau,4,4,8,2022,01-18,19:45
059 Sud De France,0,8,8,2022,01-18,19:45
001 Rue Jules Ferry - Gare Saint-Roch,6,6,12,2022,01-18,19:55
002 Com�die,11,13,24,2022,01-18,19:55
003 Esplanade,9,23,32,2022,01-18,19:55
004 H�tel de Ville,13,3,16,2022,01-18,19:55
005 Corum,9,3,12,2022,01-18,19:55
006 Place Albert 1er - St Charles,21,10,31,2022,01-18,19:55
007 Foch,1,7,8,2022,01-18,19:55
008 Halles Castellane,1,11,12,2022,01-18,19:55
009 Observatoire,7,1,8,2022,01-18,19:55
010 Rondelet,3,13,16,2022,01-18,19:55
011 Plan Cabanes,8,4,12,2022,01-18,19:55
012 Boutonnet,3,9,12,2022,01-18,19:55
013 Emile Combes,4,4,8,2022,01-18,19:55
014 Beaux-Arts,2,6,8,2022,01-18,19:55
015 Les Aubes,6,2,8,2022,01-18,19:55
016 Antigone centre,15,1,16,2022,01-18,19:55
017 M�diath�que Emile Zola,10,6,16,2022,01-18,19:55
018 Nombre d'Or,15,1,16,2022,01-18,19:55
019 Louis Blanc,8,8,16,2022,01-18,19:55
020 Gambetta,0,8,8,2022,01-18,19:55
021 Port Marianne,16,0,16,2022,01-18,19:55
022 Clemenceau,3,9,12,2022,01-18,19:55
023 Les Arceaux,1,15,16,2022,01-18,19:55
024 Cit� Mion,2,6,8,2022,01-18,19:55
025 Nouveau Saint-Roch,1,7,8,2022,01-18,19:55
026 Renouvier,6,2,8,2022,01-18,19:55
027 Odysseum,4,4,8,2022,01-18,19:55
028 Saint-Denis,4,4,8,2022,01-18,19:55
029 Richter,10,6,16,2022,01-18,19:55
030 Charles Flahault,7,1,8,2022,01-18,19:55
031 Voltaire,3,5,8,2022,01-18,19:55
032 Pr�s d'Ar�nes,7,1,8,2022,01-18,19:55
033 Garcia Lorca,8,0,8,2022,01-18,19:55
034 Vert Bois,0,16,16,2022,01-18,19:55
035 Malbosc,0,8,8,2022,01-18,19:55
036 Occitanie,1,31,32,2022,01-18,19:55
037 FacdesSciences,1,23,24,2022,01-18,19:55
038 Fac de Lettres,0,16,16,2022,01-18,19:55
039 Aiguelongue,5,3,8,2022,01-18,19:55
040 Jeu de Mail des Abb�s,8,0,8,2022,01-18,19:55
041 Eurom�decine,0,8,8,2022,01-18,19:55
042 Marie Caizergues,3,5,8,2022,01-18,19:55
043 Sabines,3,5,8,2022,01-18,19:55
044 Celleneuve,0,8,8,2022,01-18,19:55
045 Jardin de la Lironde,2,6,8,2022,01-18,19:55
046 P�re Soulas,6,2,8,2022,01-18,19:55
047 Place Viala,1,7,8,2022,01-18,19:55
048 H�tel du D�partement,0,8,8,2022,01-18,19:55
049 Tonnelles,1,7,8,2022,01-18,19:55
050 Parvis Jules Ferry - Gare Saint-Roch,1,7,8,2022,01-18,19:55
051 Pont de Lattes - Gare Saint-Roch,2,10,12,2022,01-18,19:55
053 Deux Ponts - Gare Saint-Roch,2,6,8,2022,01-18,19:55
054 Providence - Ovalie,4,4,8,2022,01-18,19:55
055 P�rols Etang de l'Or,23,45,68,2022,01-18,19:55
056 Albert 1er - Cath�drale,7,5,12,2022,01-18,19:55
057 Saint-Guilhem - Courreau,5,3,8,2022,01-18,19:55
059 Sud De France,0,8,8,2022,01-18,19:55
001 Rue Jules Ferry - Gare Saint-Roch,5,7,12,2022,01-18,20:05
002 Com�die,10,14,24,2022,01-18,20:05
003 Esplanade,9,23,32,2022,01-18,20:05
004 H�tel de Ville,13,3,16,2022,01-18,20:05
005 Corum,9,3,12,2022,01-18,20:05
006 Place Albert 1er - St Charles,21,10,31,2022,01-18,20:05
007 Foch,1,7,8,2022,01-18,20:05
008 Halles Castellane,1,11,12,2022,01-18,20:05
009 Observatoire,7,1,8,2022,01-18,20:05
010 Rondelet,3,13,16,2022,01-18,20:05
011 Plan Cabanes,8,4,12,2022,01-18,20:05
012 Boutonnet,3,9,12,2022,01-18,20:05
013 Emile Combes,4,4,8,2022,01-18,20:05
014 Beaux-Arts,2,6,8,2022,01-18,20:05
015 Les Aubes,6,2,8,2022,01-18,20:05
016 Antigone centre,15,1,16,2022,01-18,20:05
017 M�diath�que Emile Zola,11,5,16,2022,01-18,20:05
018 Nombre d'Or,15,1,16,2022,01-18,20:05
019 Louis Blanc,8,8,16,2022,01-18,20:05
020 Gambetta,0,8,8,2022,01-18,20:05
021 Port Marianne,16,0,16,2022,01-18,20:05
022 Clemenceau,3,9,12,2022,01-18,20:05
023 Les Arceaux,1,15,16,2022,01-18,20:05
024 Cit� Mion,2,6,8,2022,01-18,20:05
025 Nouveau Saint-Roch,2,6,8,2022,01-18,20:05
026 Renouvier,6,2,8,2022,01-18,20:05
027 Odysseum,4,4,8,2022,01-18,20:05
028 Saint-Denis,4,4,8,2022,01-18,20:05
029 Richter,10,6,16,2022,01-18,20:05
030 Charles Flahault,7,1,8,2022,01-18,20:05
031 Voltaire,4,4,8,2022,01-18,20:05
032 Pr�s d'Ar�nes,7,1,8,2022,01-18,20:05
033 Garcia Lorca,8,0,8,2022,01-18,20:05
034 Vert Bois,0,16,16,2022,01-18,20:05
035 Malbosc,0,8,8,2022,01-18,20:05
036 Occitanie,1,31,32,2022,01-18,20:05
037 FacdesSciences,0,24,24,2022,01-18,20:05
038 Fac de Lettres,0,16,16,2022,01-18,20:05
039 Aiguelongue,5,3,8,2022,01-18,20:05
040 Jeu de Mail des Abb�s,8,0,8,2022,01-18,20:05
041 Eurom�decine,0,8,8,2022,01-18,20:05
042 Marie Caizergues,3,5,8,2022,01-18,20:05
043 Sabines,3,5,8,2022,01-18,20:05
044 Celleneuve,0,8,8,2022,01-18,20:05
045 Jardin de la Lironde,2,6,8,2022,01-18,20:05
046 P�re Soulas,6,2,8,2022,01-18,20:05
047 Place Viala,1,7,8,2022,01-18,20:05
048 H�tel du D�partement,0,8,8,2022,01-18,20:05
049 Tonnelles,1,7,8,2022,01-18,20:05
050 Parvis Jules Ferry - Gare Saint-Roch,1,7,8,2022,01-18,20:05
051 Pont de Lattes - Gare Saint-Roch,2,10,12,2022,01-18,20:05
053 Deux Ponts - Gare Saint-Roch,2,6,8,2022,01-18,20:05
054 Providence - Ovalie,4,4,8,2022,01-18,20:05
055 P�rols Etang de l'Or,23,45,68,2022,01-18,20:05
056 Albert 1er - Cath�drale,7,5,12,2022,01-18,20:05
057 Saint-Guilhem - Courreau,5,3,8,2022,01-18,20:05
059 Sud De France,0,8,8,2022,01-18,20:05
001 Rue Jules Ferry - Gare Saint-Roch,5,7,12,2022,01-18,20:15
002 Com�die,10,14,24,2022,01-18,20:15
003 Esplanade,9,23,32,2022,01-18,20:15
004 H�tel de Ville,13,3,16,2022,01-18,20:15
005 Corum,9,3,12,2022,01-18,20:15
006 Place Albert 1er - St Charles,21,10,31,2022,01-18,20:15
007 Foch,1,7,8,2022,01-18,20:15
008 Halles Castellane,1,11,12,2022,01-18,20:15
009 Observatoire,7,1,8,2022,01-18,20:15
010 Rondelet,2,14,16,2022,01-18,20:15
011 Plan Cabanes,8,4,12,2022,01-18,20:15
012 Boutonnet,3,9,12,2022,01-18,20:15
013 Emile Combes,4,4,8,2022,01-18,20:15
014 Beaux-Arts,2,6,8,2022,01-18,20:15
015 Les Aubes,6,2,8,2022,01-18,20:15
016 Antigone centre,15,1,16,2022,01-18,20:15
017 M�diath�que Emile Zola,11,5,16,2022,01-18,20:15
018 Nombre d'Or,15,1,16,2022,01-18,20:15
019 Louis Blanc,8,8,16,2022,01-18,20:15
020 Gambetta,0,8,8,2022,01-18,20:15
021 Port Marianne,16,0,16,2022,01-18,20:15
022 Clemenceau,3,9,12,2022,01-18,20:15
023 Les Arceaux,1,15,16,2022,01-18,20:15
024 Cit� Mion,2,6,8,2022,01-18,20:15
025 Nouveau Saint-Roch,3,5,8,2022,01-18,20:15
026 Renouvier,6,2,8,2022,01-18,20:15
027 Odysseum,3,5,8,2022,01-18,20:15
028 Saint-Denis,4,4,8,2022,01-18,20:15
029 Richter,10,6,16,2022,01-18,20:15
030 Charles Flahault,7,1,8,2022,01-18,20:15
031 Voltaire,4,4,8,2022,01-18,20:15
032 Pr�s d'Ar�nes,8,0,8,2022,01-18,20:15
033 Garcia Lorca,8,0,8,2022,01-18,20:15
034 Vert Bois,0,16,16,2022,01-18,20:15
035 Malbosc,0,8,8,2022,01-18,20:15
036 Occitanie,1,31,32,2022,01-18,20:15
037 FacdesSciences,0,24,24,2022,01-18,20:15
038 Fac de Lettres,0,16,16,2022,01-18,20:15
039 Aiguelongue,4,4,8,2022,01-18,20:15
040 Jeu de Mail des Abb�s,8,0,8,2022,01-18,20:15
041 Eurom�decine,0,8,8,2022,01-18,20:15
042 Marie Caizergues,3,5,8,2022,01-18,20:15
043 Sabines,3,5,8,2022,01-18,20:15
044 Celleneuve,0,8,8,2022,01-18,20:15
045 Jardin de la Lironde,2,6,8,2022,01-18,20:15
046 P�re Soulas,6,2,8,2022,01-18,20:15
047 Place Viala,1,7,8,2022,01-18,20:15
048 H�tel du D�partement,0,8,8,2022,01-18,20:15
049 Tonnelles,1,7,8,2022,01-18,20:15
050 Parvis Jules Ferry - Gare Saint-Roch,1,7,8,2022,01-18,20:15
051 Pont de Lattes - Gare Saint-Roch,3,9,12,2022,01-18,20:15
053 Deux Ponts - Gare Saint-Roch,2,6,8,2022,01-18,20:15
054 Providence - Ovalie,4,4,8,2022,01-18,20:15
055 P�rols Etang de l'Or,23,45,68,2022,01-18,20:15
056 Albert 1er - Cath�drale,7,5,12,2022,01-18,20:15
057 Saint-Guilhem - Courreau,4,4,8,2022,01-18,20:15
059 Sud De France,0,8,8,2022,01-18,20:15
001 Rue Jules Ferry - Gare Saint-Roch,5,7,12,2022,01-18,20:26
002 Com�die,10,14,24,2022,01-18,20:26
003 Esplanade,9,23,32,2022,01-18,20:26
004 H�tel de Ville,13,3,16,2022,01-18,20:26
005 Corum,9,3,12,2022,01-18,20:26
006 Place Albert 1er - St Charles,21,10,31,2022,01-18,20:26
007 Foch,3,5,8,2022,01-18,20:26
008 Halles Castellane,1,11,12,2022,01-18,20:26
009 Observatoire,7,1,8,2022,01-18,20:26
010 Rondelet,2,14,16,2022,01-18,20:26
011 Plan Cabanes,8,4,12,2022,01-18,20:26
012 Boutonnet,2,10,12,2022,01-18,20:26
013 Emile Combes,4,4,8,2022,01-18,20:26
014 Beaux-Arts,2,6,8,2022,01-18,20:26
015 Les Aubes,6,2,8,2022,01-18,20:26
016 Antigone centre,15,1,16,2022,01-18,20:26
017 M�diath�que Emile Zola,11,5,16,2022,01-18,20:26
018 Nombre d'Or,15,1,16,2022,01-18,20:26
019 Louis Blanc,8,8,16,2022,01-18,20:26
020 Gambetta,0,8,8,2022,01-18,20:26
021 Port Marianne,16,0,16,2022,01-18,20:26
022 Clemenceau,3,9,12,2022,01-18,20:26
023 Les Arceaux,2,14,16,2022,01-18,20:26
024 Cit� Mion,2,6,8,2022,01-18,20:26
025 Nouveau Saint-Roch,3,5,8,2022,01-18,20:26
026 Renouvier,6,2,8,2022,01-18,20:26
027 Odysseum,3,5,8,2022,01-18,20:26
028 Saint-Denis,4,4,8,2022,01-18,20:26
029 Richter,10,6,16,2022,01-18,20:26
030 Charles Flahault,7,1,8,2022,01-18,20:26
031 Voltaire,3,5,8,2022,01-18,20:26
032 Pr�s d'Ar�nes,8,0,8,2022,01-18,20:26
033 Garcia Lorca,8,0,8,2022,01-18,20:26
034 Vert Bois,0,16,16,2022,01-18,20:26
035 Malbosc,0,8,8,2022,01-18,20:26
036 Occitanie,1,31,32,2022,01-18,20:26
037 FacdesSciences,0,24,24,2022,01-18,20:26
038 Fac de Lettres,0,16,16,2022,01-18,20:26
039 Aiguelongue,4,4,8,2022,01-18,20:26
040 Jeu de Mail des Abb�s,8,0,8,2022,01-18,20:26
041 Eurom�decine,0,8,8,2022,01-18,20:26
042 Marie Caizergues,3,5,8,2022,01-18,20:26
043 Sabines,3,5,8,2022,01-18,20:26
044 Celleneuve,0,8,8,2022,01-18,20:26
045 Jardin de la Lironde,2,6,8,2022,01-18,20:26
046 P�re Soulas,6,2,8,2022,01-18,20:26
047 Place Viala,1,7,8,2022,01-18,20:26
048 H�tel du D�partement,0,8,8,2022,01-18,20:26
049 Tonnelles,1,7,8,2022,01-18,20:26
050 Parvis Jules Ferry - Gare Saint-Roch,1,7,8,2022,01-18,20:26
051 Pont de Lattes - Gare Saint-Roch,3,9,12,2022,01-18,20:26
053 Deux Ponts - Gare Saint-Roch,2,6,8,2022,01-18,20:26
054 Providence - Ovalie,4,4,8,2022,01-18,20:26
055 P�rols Etang de l'Or,23,45,68,2022,01-18,20:26
056 Albert 1er - Cath�drale,7,5,12,2022,01-18,20:26
057 Saint-Guilhem - Courreau,4,4,8,2022,01-18,20:26
059 Sud De France,0,8,8,2022,01-18,20:26
001 Rue Jules Ferry - Gare Saint-Roch,5,7,12,2022,01-18,20:36
002 Com�die,10,14,24,2022,01-18,20:36
003 Esplanade,9,23,32,2022,01-18,20:36
004 H�tel de Ville,14,2,16,2022,01-18,20:36
005 Corum,8,4,12,2022,01-18,20:36
006 Place Albert 1er - St Charles,21,10,31,2022,01-18,20:36
007 Foch,2,6,8,2022,01-18,20:36
008 Halles Castellane,1,11,12,2022,01-18,20:36
009 Observatoire,7,1,8,2022,01-18,20:36
010 Rondelet,2,14,16,2022,01-18,20:36
011 Plan Cabanes,8,4,12,2022,01-18,20:36
012 Boutonnet,2,10,12,2022,01-18,20:36
013 Emile Combes,4,4,8,2022,01-18,20:36
014 Beaux-Arts,2,6,8,2022,01-18,20:36
015 Les Aubes,6,2,8,2022,01-18,20:36
016 Antigone centre,15,1,16,2022,01-18,20:36
017 M�diath�que Emile Zola,11,5,16,2022,01-18,20:36
018 Nombre d'Or,15,1,16,2022,01-18,20:36
019 Louis Blanc,7,9,16,2022,01-18,20:36
020 Gambetta,0,8,8,2022,01-18,20:36
021 Port Marianne,15,1,16,2022,01-18,20:36
022 Clemenceau,3,9,12,2022,01-18,20:36
023 Les Arceaux,2,14,16,2022,01-18,20:36
024 Cit� Mion,2,6,8,2022,01-18,20:36
025 Nouveau Saint-Roch,3,5,8,2022,01-18,20:36
026 Renouvier,6,2,8,2022,01-18,20:36
027 Odysseum,4,4,8,2022,01-18,20:36
028 Saint-Denis,4,4,8,2022,01-18,20:36
029 Richter,10,6,16,2022,01-18,20:36
030 Charles Flahault,7,1,8,2022,01-18,20:36
031 Voltaire,3,5,8,2022,01-18,20:36
032 Pr�s d'Ar�nes,8,0,8,2022,01-18,20:36
033 Garcia Lorca,7,1,8,2022,01-18,20:36
034 Vert Bois,0,16,16,2022,01-18,20:36
035 Malbosc,0,8,8,2022,01-18,20:36
036 Occitanie,1,31,32,2022,01-18,20:36
037 FacdesSciences,0,24,24,2022,01-18,20:36
038 Fac de Lettres,0,16,16,2022,01-18,20:36
039 Aiguelongue,4,4,8,2022,01-18,20:36
040 Jeu de Mail des Abb�s,8,0,8,2022,01-18,20:36
041 Eurom�decine,0,8,8,2022,01-18,20:36
042 Marie Caizergues,3,5,8,2022,01-18,20:36
043 Sabines,3,5,8,2022,01-18,20:36
044 Celleneuve,0,8,8,2022,01-18,20:36
045 Jardin de la Lironde,1,7,8,2022,01-18,20:36
046 P�re Soulas,6,2,8,2022,01-18,20:36
047 Place Viala,1,7,8,2022,01-18,20:36
048 H�tel du D�partement,0,8,8,2022,01-18,20:36
049 Tonnelles,1,7,8,2022,01-18,20:36
050 Parvis Jules Ferry - Gare Saint-Roch,1,7,8,2022,01-18,20:36
051 Pont de Lattes - Gare Saint-Roch,3,9,12,2022,01-18,20:36
053 Deux Ponts - Gare Saint-Roch,2,6,8,2022,01-18,20:36
054 Providence - Ovalie,4,4,8,2022,01-18,20:36
055 P�rols Etang de l'Or,23,45,68,2022,01-18,20:36
056 Albert 1er - Cath�drale,7,5,12,2022,01-18,20:36
057 Saint-Guilhem - Courreau,4,4,8,2022,01-18,20:36
059 Sud De France,0,8,8,2022,01-18,20:36
001 Rue Jules Ferry - Gare Saint-Roch,4,8,12,2022,01-18,20:46
002 Com�die,10,14,24,2022,01-18,20:46
003 Esplanade,9,23,32,2022,01-18,20:46
004 H�tel de Ville,14,2,16,2022,01-18,20:46
005 Corum,8,4,12,2022,01-18,20:46
006 Place Albert 1er - St Charles,21,10,31,2022,01-18,20:46
007 Foch,2,6,8,2022,01-18,20:46
008 Halles Castellane,1,11,12,2022,01-18,20:46
009 Observatoire,7,1,8,2022,01-18,20:46
010 Rondelet,2,14,16,2022,01-18,20:46
011 Plan Cabanes,9,3,12,2022,01-18,20:46
012 Boutonnet,1,11,12,2022,01-18,20:46
013 Emile Combes,4,4,8,2022,01-18,20:46
014 Beaux-Arts,2,6,8,2022,01-18,20:46
015 Les Aubes,6,2,8,2022,01-18,20:46
016 Antigone centre,15,1,16,2022,01-18,20:46
017 M�diath�que Emile Zola,12,4,16,2022,01-18,20:46
018 Nombre d'Or,16,0,16,2022,01-18,20:46
019 Louis Blanc,7,9,16,2022,01-18,20:46
020 Gambetta,0,8,8,2022,01-18,20:46
021 Port Marianne,15,1,16,2022,01-18,20:46
022 Clemenceau,3,9,12,2022,01-18,20:46
023 Les Arceaux,2,14,16,2022,01-18,20:46
024 Cit� Mion,2,6,8,2022,01-18,20:46
025 Nouveau Saint-Roch,3,5,8,2022,01-18,20:46
026 Renouvier,6,2,8,2022,01-18,20:46
027 Odysseum,4,4,8,2022,01-18,20:46
028 Saint-Denis,4,4,8,2022,01-18,20:46
029 Richter,9,7,16,2022,01-18,20:46
030 Charles Flahault,7,1,8,2022,01-18,20:46
031 Voltaire,3,5,8,2022,01-18,20:46
032 Pr�s d'Ar�nes,8,0,8,2022,01-18,20:46
033 Garcia Lorca,7,1,8,2022,01-18,20:46
034 Vert Bois,0,16,16,2022,01-18,20:46
035 Malbosc,0,8,8,2022,01-18,20:46
036 Occitanie,1,31,32,2022,01-18,20:46
037 FacdesSciences,1,23,24,2022,01-18,20:46
038 Fac de Lettres,0,16,16,2022,01-18,20:46
039 Aiguelongue,4,4,8,2022,01-18,20:46
040 Jeu de Mail des Abb�s,8,0,8,2022,01-18,20:46
041 Eurom�decine,0,8,8,2022,01-18,20:46
042 Marie Caizergues,3,5,8,2022,01-18,20:46
043 Sabines,3,5,8,2022,01-18,20:46
044 Celleneuve,0,8,8,2022,01-18,20:46
045 Jardin de la Lironde,1,7,8,2022,01-18,20:46
046 P�re Soulas,7,1,8,2022,01-18,20:46
047 Place Viala,2,6,8,2022,01-18,20:46
048 H�tel du D�partement,0,8,8,2022,01-18,20:46
049 Tonnelles,1,7,8,2022,01-18,20:46
050 Parvis Jules Ferry - Gare Saint-Roch,1,7,8,2022,01-18,20:46
051 Pont de Lattes - Gare Saint-Roch,3,9,12,2022,01-18,20:46
053 Deux Ponts - Gare Saint-Roch,2,6,8,2022,01-18,20:46
054 Providence - Ovalie,4,4,8,2022,01-18,20:46
055 P�rols Etang de l'Or,23,45,68,2022,01-18,20:46
056 Albert 1er - Cath�drale,7,5,12,2022,01-18,20:46
057 Saint-Guilhem - Courreau,5,3,8,2022,01-18,20:46
059 Sud De France,0,8,8,2022,01-18,20:46
001 Rue Jules Ferry - Gare Saint-Roch,3,9,12,2022,01-18,20:57
002 Com�die,10,14,24,2022,01-18,20:57
003 Esplanade,9,23,32,2022,01-18,20:57
004 H�tel de Ville,14,2,16,2022,01-18,20:57
005 Corum,8,4,12,2022,01-18,20:57
006 Place Albert 1er - St Charles,22,9,31,2022,01-18,20:57
007 Foch,2,6,8,2022,01-18,20:57
008 Halles Castellane,0,12,12,2022,01-18,20:57
009 Observatoire,7,1,8,2022,01-18,20:57
010 Rondelet,2,14,16,2022,01-18,20:57
011 Plan Cabanes,9,3,12,2022,01-18,20:57
012 Boutonnet,1,11,12,2022,01-18,20:57
013 Emile Combes,4,4,8,2022,01-18,20:57
014 Beaux-Arts,2,6,8,2022,01-18,20:57
015 Les Aubes,6,2,8,2022,01-18,20:57
016 Antigone centre,15,1,16,2022,01-18,20:57
017 M�diath�que Emile Zola,13,3,16,2022,01-18,20:57
018 Nombre d'Or,16,0,16,2022,01-18,20:57
019 Louis Blanc,7,9,16,2022,01-18,20:57
020 Gambetta,2,6,8,2022,01-18,20:57
021 Port Marianne,15,1,16,2022,01-18,20:57
022 Clemenceau,3,9,12,2022,01-18,20:57
023 Les Arceaux,2,14,16,2022,01-18,20:57
024 Cit� Mion,2,6,8,2022,01-18,20:57
025 Nouveau Saint-Roch,4,4,8,2022,01-18,20:57
026 Renouvier,6,2,8,2022,01-18,20:57
027 Odysseum,4,4,8,2022,01-18,20:57
028 Saint-Denis,4,4,8,2022,01-18,20:57
029 Richter,9,7,16,2022,01-18,20:57
030 Charles Flahault,7,1,8,2022,01-18,20:57
031 Voltaire,3,5,8,2022,01-18,20:57
032 Pr�s d'Ar�nes,8,0,8,2022,01-18,20:57
033 Garcia Lorca,7,1,8,2022,01-18,20:57
034 Vert Bois,0,16,16,2022,01-18,20:57
035 Malbosc,0,8,8,2022,01-18,20:57
036 Occitanie,1,31,32,2022,01-18,20:57
037 FacdesSciences,1,23,24,2022,01-18,20:57
038 Fac de Lettres,0,16,16,2022,01-18,20:57
039 Aiguelongue,4,4,8,2022,01-18,20:57
040 Jeu de Mail des Abb�s,8,0,8,2022,01-18,20:57
041 Eurom�decine,0,8,8,2022,01-18,20:57
042 Marie Caizergues,3,5,8,2022,01-18,20:57
043 Sabines,3,5,8,2022,01-18,20:57
044 Celleneuve,0,8,8,2022,01-18,20:57
045 Jardin de la Lironde,1,7,8,2022,01-18,20:57
046 P�re Soulas,7,1,8,2022,01-18,20:57
047 Place Viala,2,6,8,2022,01-18,20:57
048 H�tel du D�partement,0,8,8,2022,01-18,20:57
049 Tonnelles,1,7,8,2022,01-18,20:57
050 Parvis Jules Ferry - Gare Saint-Roch,1,7,8,2022,01-18,20:57
051 Pont de Lattes - Gare Saint-Roch,3,9,12,2022,01-18,20:57
053 Deux Ponts - Gare Saint-Roch,2,6,8,2022,01-18,20:57
054 Providence - Ovalie,4,4,8,2022,01-18,20:57
055 P�rols Etang de l'Or,23,45,68,2022,01-18,20:57
056 Albert 1er - Cath�drale,7,5,12,2022,01-18,20:57
057 Saint-Guilhem - Courreau,5,3,8,2022,01-18,20:57
059 Sud De France,0,8,8,2022,01-18,20:57
001 Rue Jules Ferry - Gare Saint-Roch,3,9,12,2022,01-18,21:07
002 Com�die,10,14,24,2022,01-18,21:07
003 Esplanade,10,22,32,2022,01-18,21:07
004 H�tel de Ville,15,1,16,2022,01-18,21:07
005 Corum,8,4,12,2022,01-18,21:07
006 Place Albert 1er - St Charles,21,10,31,2022,01-18,21:07
007 Foch,2,6,8,2022,01-18,21:07
008 Halles Castellane,0,12,12,2022,01-18,21:07
009 Observatoire,6,2,8,2022,01-18,21:07
010 Rondelet,2,14,16,2022,01-18,21:07
011 Plan Cabanes,9,3,12,2022,01-18,21:07
012 Boutonnet,1,11,12,2022,01-18,21:07
013 Emile Combes,4,4,8,2022,01-18,21:07
014 Beaux-Arts,2,6,8,2022,01-18,21:07
015 Les Aubes,6,2,8,2022,01-18,21:07
016 Antigone centre,15,1,16,2022,01-18,21:07
017 M�diath�que Emile Zola,13,3,16,2022,01-18,21:07
018 Nombre d'Or,16,0,16,2022,01-18,21:07
019 Louis Blanc,7,9,16,2022,01-18,21:07
020 Gambetta,2,6,8,2022,01-18,21:07
021 Port Marianne,14,2,16,2022,01-18,21:07
022 Clemenceau,3,9,12,2022,01-18,21:07
023 Les Arceaux,2,14,16,2022,01-18,21:07
024 Cit� Mion,2,6,8,2022,01-18,21:07
025 Nouveau Saint-Roch,4,4,8,2022,01-18,21:07
026 Renouvier,6,2,8,2022,01-18,21:07
027 Odysseum,4,4,8,2022,01-18,21:07
028 Saint-Denis,4,4,8,2022,01-18,21:07
029 Richter,9,7,16,2022,01-18,21:07
030 Charles Flahault,7,1,8,2022,01-18,21:07
031 Voltaire,3,5,8,2022,01-18,21:07
032 Pr�s d'Ar�nes,8,0,8,2022,01-18,21:07
033 Garcia Lorca,8,0,8,2022,01-18,21:07
034 Vert Bois,0,16,16,2022,01-18,21:07
035 Malbosc,0,8,8,2022,01-18,21:07
036 Occitanie,1,31,32,2022,01-18,21:07
037 FacdesSciences,1,23,24,2022,01-18,21:07
038 Fac de Lettres,0,16,16,2022,01-18,21:07
039 Aiguelongue,4,4,8,2022,01-18,21:07
040 Jeu de Mail des Abb�s,8,0,8,2022,01-18,21:07
041 Eurom�decine,0,8,8,2022,01-18,21:07
042 Marie Caizergues,2,6,8,2022,01-18,21:07
043 Sabines,3,5,8,2022,01-18,21:07
044 Celleneuve,0,8,8,2022,01-18,21:07
045 Jardin de la Lironde,1,7,8,2022,01-18,21:07
046 P�re Soulas,6,2,8,2022,01-18,21:07
047 Place Viala,2,6,8,2022,01-18,21:07
048 H�tel du D�partement,0,8,8,2022,01-18,21:07
049 Tonnelles,1,7,8,2022,01-18,21:07
050 Parvis Jules Ferry - Gare Saint-Roch,1,7,8,2022,01-18,21:07
051 Pont de Lattes - Gare Saint-Roch,3,9,12,2022,01-18,21:07
053 Deux Ponts - Gare Saint-Roch,2,6,8,2022,01-18,21:07
054 Providence - Ovalie,4,4,8,2022,01-18,21:07
055 P�rols Etang de l'Or,23,45,68,2022,01-18,21:07
056 Albert 1er - Cath�drale,7,5,12,2022,01-18,21:07
057 Saint-Guilhem - Courreau,5,3,8,2022,01-18,21:07
059 Sud De France,0,8,8,2022,01-18,21:07
001 Rue Jules Ferry - Gare Saint-Roch,3,9,12,2022,01-18,21:17
002 Com�die,10,14,24,2022,01-18,21:17
003 Esplanade,10,22,32,2022,01-18,21:17
004 H�tel de Ville,15,1,16,2022,01-18,21:17
005 Corum,8,4,12,2022,01-18,21:17
006 Place Albert 1er - St Charles,20,11,31,2022,01-18,21:17
007 Foch,2,6,8,2022,01-18,21:17
008 Halles Castellane,0,12,12,2022,01-18,21:17
009 Observatoire,6,2,8,2022,01-18,21:17
010 Rondelet,2,14,16,2022,01-18,21:17
011 Plan Cabanes,9,3,12,2022,01-18,21:17
012 Boutonnet,3,9,12,2022,01-18,21:17
013 Emile Combes,4,4,8,2022,01-18,21:17
014 Beaux-Arts,4,4,8,2022,01-18,21:17
015 Les Aubes,6,2,8,2022,01-18,21:17
016 Antigone centre,16,0,16,2022,01-18,21:17
017 M�diath�que Emile Zola,13,3,16,2022,01-18,21:17
018 Nombre d'Or,16,0,16,2022,01-18,21:17
019 Louis Blanc,7,9,16,2022,01-18,21:17
020 Gambetta,2,6,8,2022,01-18,21:17
021 Port Marianne,14,2,16,2022,01-18,21:17
022 Clemenceau,3,9,12,2022,01-18,21:17
023 Les Arceaux,3,13,16,2022,01-18,21:17
024 Cit� Mion,2,6,8,2022,01-18,21:17
025 Nouveau Saint-Roch,4,4,8,2022,01-18,21:17
026 Renouvier,6,2,8,2022,01-18,21:17
027 Odysseum,4,4,8,2022,01-18,21:17
028 Saint-Denis,4,4,8,2022,01-18,21:17
029 Richter,9,7,16,2022,01-18,21:17
030 Charles Flahault,7,1,8,2022,01-18,21:17
031 Voltaire,3,5,8,2022,01-18,21:17
032 Pr�s d'Ar�nes,8,0,8,2022,01-18,21:17
033 Garcia Lorca,8,0,8,2022,01-18,21:17
034 Vert Bois,0,16,16,2022,01-18,21:17
035 Malbosc,0,8,8,2022,01-18,21:17
036 Occitanie,1,31,32,2022,01-18,21:17
037 FacdesSciences,0,24,24,2022,01-18,21:17
038 Fac de Lettres,0,16,16,2022,01-18,21:17
039 Aiguelongue,4,4,8,2022,01-18,21:17
040 Jeu de Mail des Abb�s,8,0,8,2022,01-18,21:17
041 Eurom�decine,0,8,8,2022,01-18,21:17
042 Marie Caizergues,2,6,8,2022,01-18,21:17
043 Sabines,3,5,8,2022,01-18,21:17
044 Celleneuve,0,8,8,2022,01-18,21:17
045 Jardin de la Lironde,1,7,8,2022,01-18,21:17
046 P�re Soulas,6,2,8,2022,01-18,21:17
047 Place Viala,2,6,8,2022,01-18,21:17
048 H�tel du D�partement,0,8,8,2022,01-18,21:17
049 Tonnelles,1,7,8,2022,01-18,21:17
050 Parvis Jules Ferry - Gare Saint-Roch,1,7,8,2022,01-18,21:17
051 Pont de Lattes - Gare Saint-Roch,3,9,12,2022,01-18,21:17
053 Deux Ponts - Gare Saint-Roch,2,6,8,2022,01-18,21:17
054 Providence - Ovalie,4,4,8,2022,01-18,21:17
055 P�rols Etang de l'Or,23,45,68,2022,01-18,21:17
056 Albert 1er - Cath�drale,7,5,12,2022,01-18,21:17
057 Saint-Guilhem - Courreau,5,3,8,2022,01-18,21:17
059 Sud De France,0,8,8,2022,01-18,21:17
001 Rue Jules Ferry - Gare Saint-Roch,3,9,12,2022,01-18,21:28
002 Com�die,10,14,24,2022,01-18,21:28
003 Esplanade,10,22,32,2022,01-18,21:28
004 H�tel de Ville,15,1,16,2022,01-18,21:28
005 Corum,8,4,12,2022,01-18,21:28
006 Place Albert 1er - St Charles,20,11,31,2022,01-18,21:28
007 Foch,1,7,8,2022,01-18,21:28
008 Halles Castellane,0,12,12,2022,01-18,21:28
009 Observatoire,6,2,8,2022,01-18,21:28
010 Rondelet,2,14,16,2022,01-18,21:28
011 Plan Cabanes,9,3,12,2022,01-18,21:28
012 Boutonnet,3,9,12,2022,01-18,21:28
013 Emile Combes,4,4,8,2022,01-18,21:28
014 Beaux-Arts,4,4,8,2022,01-18,21:28
015 Les Aubes,6,2,8,2022,01-18,21:28
016 Antigone centre,16,0,16,2022,01-18,21:28
017 M�diath�que Emile Zola,13,3,16,2022,01-18,21:28
018 Nombre d'Or,16,0,16,2022,01-18,21:28
019 Louis Blanc,7,9,16,2022,01-18,21:28
020 Gambetta,2,6,8,2022,01-18,21:28
021 Port Marianne,14,2,16,2022,01-18,21:28
022 Clemenceau,3,9,12,2022,01-18,21:28
023 Les Arceaux,3,13,16,2022,01-18,21:28
024 Cit� Mion,2,6,8,2022,01-18,21:28
025 Nouveau Saint-Roch,4,4,8,2022,01-18,21:28
026 Renouvier,6,2,8,2022,01-18,21:28
027 Odysseum,4,4,8,2022,01-18,21:28
028 Saint-Denis,4,4,8,2022,01-18,21:28
029 Richter,9,7,16,2022,01-18,21:28
030 Charles Flahault,6,2,8,2022,01-18,21:28
031 Voltaire,2,6,8,2022,01-18,21:28
032 Pr�s d'Ar�nes,8,0,8,2022,01-18,21:28
033 Garcia Lorca,8,0,8,2022,01-18,21:28
034 Vert Bois,0,16,16,2022,01-18,21:28
035 Malbosc,0,8,8,2022,01-18,21:28
036 Occitanie,1,31,32,2022,01-18,21:28
037 FacdesSciences,0,24,24,2022,01-18,21:28
038 Fac de Lettres,0,16,16,2022,01-18,21:28
039 Aiguelongue,4,4,8,2022,01-18,21:28
040 Jeu de Mail des Abb�s,8,0,8,2022,01-18,21:28
041 Eurom�decine,0,8,8,2022,01-18,21:28
042 Marie Caizergues,2,6,8,2022,01-18,21:28
043 Sabines,3,5,8,2022,01-18,21:28
044 Celleneuve,0,8,8,2022,01-18,21:28
045 Jardin de la Lironde,1,7,8,2022,01-18,21:28
046 P�re Soulas,6,2,8,2022,01-18,21:28
047 Place Viala,2,6,8,2022,01-18,21:28
048 H�tel du D�partement,0,8,8,2022,01-18,21:28
049 Tonnelles,1,7,8,2022,01-18,21:28
050 Parvis Jules Ferry - Gare Saint-Roch,1,7,8,2022,01-18,21:28
051 Pont de Lattes - Gare Saint-Roch,4,8,12,2022,01-18,21:28
053 Deux Ponts - Gare Saint-Roch,2,6,8,2022,01-18,21:28
054 Providence - Ovalie,4,4,8,2022,01-18,21:28
055 P�rols Etang de l'Or,23,45,68,2022,01-18,21:28
056 Albert 1er - Cath�drale,6,6,12,2022,01-18,21:28
057 Saint-Guilhem - Courreau,5,3,8,2022,01-18,21:28
059 Sud De France,0,8,8,2022,01-18,21:28
001 Rue Jules Ferry - Gare Saint-Roch,3,9,12,2022,01-18,21:38
002 Com�die,10,14,24,2022,01-18,21:38
003 Esplanade,10,22,32,2022,01-18,21:38
004 H�tel de Ville,15,1,16,2022,01-18,21:38
005 Corum,8,4,12,2022,01-18,21:38
006 Place Albert 1er - St Charles,19,12,31,2022,01-18,21:38
007 Foch,1,7,8,2022,01-18,21:38
008 Halles Castellane,1,11,12,2022,01-18,21:38
009 Observatoire,6,2,8,2022,01-18,21:38
010 Rondelet,2,14,16,2022,01-18,21:38
011 Plan Cabanes,9,3,12,2022,01-18,21:38
012 Boutonnet,3,9,12,2022,01-18,21:38
013 Emile Combes,4,4,8,2022,01-18,21:38
014 Beaux-Arts,4,4,8,2022,01-18,21:38
015 Les Aubes,6,2,8,2022,01-18,21:38
016 Antigone centre,16,0,16,2022,01-18,21:38
017 M�diath�que Emile Zola,13,3,16,2022,01-18,21:38
018 Nombre d'Or,16,0,16,2022,01-18,21:38
019 Louis Blanc,7,9,16,2022,01-18,21:38
020 Gambetta,3,5,8,2022,01-18,21:38
021 Port Marianne,14,2,16,2022,01-18,21:38
022 Clemenceau,4,8,12,2022,01-18,21:38
023 Les Arceaux,3,13,16,2022,01-18,21:38
024 Cit� Mion,2,6,8,2022,01-18,21:38
025 Nouveau Saint-Roch,4,4,8,2022,01-18,21:38
026 Renouvier,6,2,8,2022,01-18,21:38
027 Odysseum,4,4,8,2022,01-18,21:38
028 Saint-Denis,4,4,8,2022,01-18,21:38
029 Richter,10,6,16,2022,01-18,21:38
030 Charles Flahault,6,2,8,2022,01-18,21:38
031 Voltaire,2,6,8,2022,01-18,21:38
032 Pr�s d'Ar�nes,8,0,8,2022,01-18,21:38
033 Garcia Lorca,8,0,8,2022,01-18,21:38
034 Vert Bois,0,16,16,2022,01-18,21:38
035 Malbosc,0,8,8,2022,01-18,21:38
036 Occitanie,1,31,32,2022,01-18,21:38
037 FacdesSciences,0,24,24,2022,01-18,21:38
038 Fac de Lettres,0,16,16,2022,01-18,21:38
039 Aiguelongue,4,4,8,2022,01-18,21:38
040 Jeu de Mail des Abb�s,8,0,8,2022,01-18,21:38
041 Eurom�decine,0,8,8,2022,01-18,21:38
042 Marie Caizergues,1,7,8,2022,01-18,21:38
043 Sabines,3,5,8,2022,01-18,21:38
044 Celleneuve,0,8,8,2022,01-18,21:38
045 Jardin de la Lironde,1,7,8,2022,01-18,21:38
046 P�re Soulas,6,2,8,2022,01-18,21:38
047 Place Viala,2,6,8,2022,01-18,21:38
048 H�tel du D�partement,0,8,8,2022,01-18,21:38
049 Tonnelles,1,7,8,2022,01-18,21:38
050 Parvis Jules Ferry - Gare Saint-Roch,1,7,8,2022,01-18,21:38
051 Pont de Lattes - Gare Saint-Roch,4,8,12,2022,01-18,21:38
053 Deux Ponts - Gare Saint-Roch,2,6,8,2022,01-18,21:38
054 Providence - Ovalie,4,4,8,2022,01-18,21:38
055 P�rols Etang de l'Or,23,45,68,2022,01-18,21:38
056 Albert 1er - Cath�drale,6,6,12,2022,01-18,21:38
057 Saint-Guilhem - Courreau,5,3,8,2022,01-18,21:38
059 Sud De France,0,8,8,2022,01-18,21:38
001 Rue Jules Ferry - Gare Saint-Roch,3,9,12,2022,01-18,21:49
002 Com�die,10,14,24,2022,01-18,21:49
003 Esplanade,10,22,32,2022,01-18,21:49
004 H�tel de Ville,15,1,16,2022,01-18,21:49
005 Corum,8,4,12,2022,01-18,21:49
006 Place Albert 1er - St Charles,20,11,31,2022,01-18,21:49
007 Foch,2,6,8,2022,01-18,21:49
008 Halles Castellane,1,11,12,2022,01-18,21:49
009 Observatoire,6,2,8,2022,01-18,21:49
010 Rondelet,2,14,16,2022,01-18,21:49
011 Plan Cabanes,9,3,12,2022,01-18,21:49
012 Boutonnet,3,9,12,2022,01-18,21:49
013 Emile Combes,4,4,8,2022,01-18,21:49
014 Beaux-Arts,4,4,8,2022,01-18,21:49
015 Les Aubes,6,2,8,2022,01-18,21:49
016 Antigone centre,16,0,16,2022,01-18,21:49
017 M�diath�que Emile Zola,13,3,16,2022,01-18,21:49
018 Nombre d'Or,16,0,16,2022,01-18,21:49
019 Louis Blanc,7,9,16,2022,01-18,21:49
020 Gambetta,3,5,8,2022,01-18,21:49
021 Port Marianne,14,2,16,2022,01-18,21:49
022 Clemenceau,4,8,12,2022,01-18,21:49
023 Les Arceaux,4,12,16,2022,01-18,21:49
024 Cit� Mion,2,6,8,2022,01-18,21:49
025 Nouveau Saint-Roch,4,4,8,2022,01-18,21:49
026 Renouvier,6,2,8,2022,01-18,21:49
027 Odysseum,4,4,8,2022,01-18,21:49
028 Saint-Denis,4,4,8,2022,01-18,21:49
029 Richter,10,6,16,2022,01-18,21:49
030 Charles Flahault,6,2,8,2022,01-18,21:49
031 Voltaire,2,6,8,2022,01-18,21:49
032 Pr�s d'Ar�nes,8,0,8,2022,01-18,21:49
033 Garcia Lorca,8,0,8,2022,01-18,21:49
034 Vert Bois,0,16,16,2022,01-18,21:49
035 Malbosc,0,8,8,2022,01-18,21:49
036 Occitanie,1,31,32,2022,01-18,21:49
037 FacdesSciences,0,24,24,2022,01-18,21:49
038 Fac de Lettres,0,16,16,2022,01-18,21:49
039 Aiguelongue,5,3,8,2022,01-18,21:49
040 Jeu de Mail des Abb�s,8,0,8,2022,01-18,21:49
041 Eurom�decine,0,8,8,2022,01-18,21:49
042 Marie Caizergues,1,7,8,2022,01-18,21:49
043 Sabines,3,5,8,2022,01-18,21:49
044 Celleneuve,0,8,8,2022,01-18,21:49
045 Jardin de la Lironde,1,7,8,2022,01-18,21:49
046 P�re Soulas,6,2,8,2022,01-18,21:49
047 Place Viala,2,6,8,2022,01-18,21:49
048 H�tel du D�partement,0,8,8,2022,01-18,21:49
049 Tonnelles,1,7,8,2022,01-18,21:49
050 Parvis Jules Ferry - Gare Saint-Roch,1,7,8,2022,01-18,21:49
051 Pont de Lattes - Gare Saint-Roch,4,8,12,2022,01-18,21:49
053 Deux Ponts - Gare Saint-Roch,2,6,8,2022,01-18,21:49
054 Providence - Ovalie,4,4,8,2022,01-18,21:49
055 P�rols Etang de l'Or,23,45,68,2022,01-18,21:49
056 Albert 1er - Cath�drale,5,7,12,2022,01-18,21:49
057 Saint-Guilhem - Courreau,5,3,8,2022,01-18,21:49
059 Sud De France,0,8,8,2022,01-18,21:49
001 Rue Jules Ferry - Gare Saint-Roch,2,10,12,2022,01-18,21:59
002 Com�die,12,12,24,2022,01-18,21:59
003 Esplanade,10,22,32,2022,01-18,21:59
004 H�tel de Ville,16,0,16,2022,01-18,21:59
005 Corum,8,4,12,2022,01-18,21:59
006 Place Albert 1er - St Charles,21,10,31,2022,01-18,21:59
007 Foch,2,6,8,2022,01-18,21:59
008 Halles Castellane,1,11,12,2022,01-18,21:59
009 Observatoire,6,2,8,2022,01-18,21:59
010 Rondelet,2,14,16,2022,01-18,21:59
011 Plan Cabanes,9,3,12,2022,01-18,21:59
012 Boutonnet,3,9,12,2022,01-18,21:59
013 Emile Combes,4,4,8,2022,01-18,21:59
014 Beaux-Arts,4,4,8,2022,01-18,21:59
015 Les Aubes,6,2,8,2022,01-18,21:59
016 Antigone centre,16,0,16,2022,01-18,21:59
017 M�diath�que Emile Zola,13,3,16,2022,01-18,21:59
018 Nombre d'Or,16,0,16,2022,01-18,21:59
019 Louis Blanc,7,9,16,2022,01-18,21:59
020 Gambetta,3,5,8,2022,01-18,21:59
021 Port Marianne,14,2,16,2022,01-18,21:59
022 Clemenceau,3,9,12,2022,01-18,21:59
023 Les Arceaux,4,12,16,2022,01-18,21:59
024 Cit� Mion,2,6,8,2022,01-18,21:59
025 Nouveau Saint-Roch,4,4,8,2022,01-18,21:59
026 Renouvier,5,3,8,2022,01-18,21:59
027 Odysseum,4,4,8,2022,01-18,21:59
028 Saint-Denis,3,5,8,2022,01-18,21:59
029 Richter,10,6,16,2022,01-18,21:59
030 Charles Flahault,6,2,8,2022,01-18,21:59
031 Voltaire,2,6,8,2022,01-18,21:59
032 Pr�s d'Ar�nes,8,0,8,2022,01-18,21:59
033 Garcia Lorca,8,0,8,2022,01-18,21:59
034 Vert Bois,0,16,16,2022,01-18,21:59
035 Malbosc,0,8,8,2022,01-18,21:59
036 Occitanie,1,31,32,2022,01-18,21:59
037 FacdesSciences,0,24,24,2022,01-18,21:59
038 Fac de Lettres,0,16,16,2022,01-18,21:59
039 Aiguelongue,5,3,8,2022,01-18,21:59
040 Jeu de Mail des Abb�s,8,0,8,2022,01-18,21:59
041 Eurom�decine,0,8,8,2022,01-18,21:59
042 Marie Caizergues,0,8,8,2022,01-18,21:59
043 Sabines,3,5,8,2022,01-18,21:59
044 Celleneuve,0,8,8,2022,01-18,21:59
045 Jardin de la Lironde,1,7,8,2022,01-18,21:59
046 P�re Soulas,6,2,8,2022,01-18,21:59
047 Place Viala,2,6,8,2022,01-18,21:59
048 H�tel du D�partement,0,8,8,2022,01-18,21:59
049 Tonnelles,1,7,8,2022,01-18,21:59
050 Parvis Jules Ferry - Gare Saint-Roch,1,7,8,2022,01-18,21:59
051 Pont de Lattes - Gare Saint-Roch,4,8,12,2022,01-18,21:59
053 Deux Ponts - Gare Saint-Roch,2,6,8,2022,01-18,21:59
054 Providence - Ovalie,4,4,8,2022,01-18,21:59
055 P�rols Etang de l'Or,23,45,68,2022,01-18,21:59
056 Albert 1er - Cath�drale,4,8,12,2022,01-18,21:59
057 Saint-Guilhem - Courreau,5,3,8,2022,01-18,21:59
059 Sud De France,0,8,8,2022,01-18,21:59
001 Rue Jules Ferry - Gare Saint-Roch,1,11,12,2022,01-18,22:09
002 Com�die,12,12,24,2022,01-18,22:09
003 Esplanade,11,21,32,2022,01-18,22:09
004 H�tel de Ville,16,0,16,2022,01-18,22:09
005 Corum,8,4,12,2022,01-18,22:09
006 Place Albert 1er - St Charles,19,12,31,2022,01-18,22:09
007 Foch,2,6,8,2022,01-18,22:09
008 Halles Castellane,0,12,12,2022,01-18,22:09
009 Observatoire,6,2,8,2022,01-18,22:09
010 Rondelet,2,14,16,2022,01-18,22:09
011 Plan Cabanes,9,3,12,2022,01-18,22:09
012 Boutonnet,1,11,12,2022,01-18,22:09
013 Emile Combes,4,4,8,2022,01-18,22:09
014 Beaux-Arts,4,4,8,2022,01-18,22:09
015 Les Aubes,6,2,8,2022,01-18,22:09
016 Antigone centre,16,0,16,2022,01-18,22:09
017 M�diath�que Emile Zola,13,3,16,2022,01-18,22:09
018 Nombre d'Or,16,0,16,2022,01-18,22:09
019 Louis Blanc,7,9,16,2022,01-18,22:09
020 Gambetta,3,5,8,2022,01-18,22:09
021 Port Marianne,14,2,16,2022,01-18,22:09
022 Clemenceau,3,9,12,2022,01-18,22:09
023 Les Arceaux,4,12,16,2022,01-18,22:09
024 Cit� Mion,3,5,8,2022,01-18,22:09
025 Nouveau Saint-Roch,5,3,8,2022,01-18,22:09
026 Renouvier,5,3,8,2022,01-18,22:09
027 Odysseum,4,4,8,2022,01-18,22:09
028 Saint-Denis,3,5,8,2022,01-18,22:09
029 Richter,10,6,16,2022,01-18,22:09
030 Charles Flahault,6,2,8,2022,01-18,22:09
031 Voltaire,2,6,8,2022,01-18,22:09
032 Pr�s d'Ar�nes,8,0,8,2022,01-18,22:09
033 Garcia Lorca,8,0,8,2022,01-18,22:09
034 Vert Bois,0,16,16,2022,01-18,22:09
035 Malbosc,0,8,8,2022,01-18,22:09
036 Occitanie,1,31,32,2022,01-18,22:09
037 FacdesSciences,0,24,24,2022,01-18,22:09
038 Fac de Lettres,0,16,16,2022,01-18,22:09
039 Aiguelongue,5,3,8,2022,01-18,22:09
040 Jeu de Mail des Abb�s,8,0,8,2022,01-18,22:09
041 Eurom�decine,0,8,8,2022,01-18,22:09
042 Marie Caizergues,3,5,8,2022,01-18,22:09
043 Sabines,3,5,8,2022,01-18,22:09
044 Celleneuve,0,8,8,2022,01-18,22:09
045 Jardin de la Lironde,1,7,8,2022,01-18,22:09
046 P�re Soulas,6,2,8,2022,01-18,22:09
047 Place Viala,2,6,8,2022,01-18,22:09
048 H�tel du D�partement,0,8,8,2022,01-18,22:09
049 Tonnelles,1,7,8,2022,01-18,22:09
050 Parvis Jules Ferry - Gare Saint-Roch,0,8,8,2022,01-18,22:09
051 Pont de Lattes - Gare Saint-Roch,4,8,12,2022,01-18,22:09
053 Deux Ponts - Gare Saint-Roch,2,6,8,2022,01-18,22:09
054 Providence - Ovalie,4,4,8,2022,01-18,22:09
055 P�rols Etang de l'Or,23,45,68,2022,01-18,22:09
056 Albert 1er - Cath�drale,4,8,12,2022,01-18,22:09
057 Saint-Guilhem - Courreau,5,3,8,2022,01-18,22:09
059 Sud De France,0,8,8,2022,01-18,22:09
001 Rue Jules Ferry - Gare Saint-Roch,1,11,12,2022,01-18,22:20
002 Com�die,11,13,24,2022,01-18,22:20
003 Esplanade,11,21,32,2022,01-18,22:20
004 H�tel de Ville,16,0,16,2022,01-18,22:20
005 Corum,8,4,12,2022,01-18,22:20
006 Place Albert 1er - St Charles,19,12,31,2022,01-18,22:20
007 Foch,2,6,8,2022,01-18,22:20
008 Halles Castellane,0,12,12,2022,01-18,22:20
009 Observatoire,6,2,8,2022,01-18,22:20
010 Rondelet,3,13,16,2022,01-18,22:20
011 Plan Cabanes,9,3,12,2022,01-18,22:20
012 Boutonnet,1,11,12,2022,01-18,22:20
013 Emile Combes,4,4,8,2022,01-18,22:20
014 Beaux-Arts,5,3,8,2022,01-18,22:20
015 Les Aubes,6,2,8,2022,01-18,22:20
016 Antigone centre,16,0,16,2022,01-18,22:20
017 M�diath�que Emile Zola,13,3,16,2022,01-18,22:20
018 Nombre d'Or,16,0,16,2022,01-18,22:20
019 Louis Blanc,7,9,16,2022,01-18,22:20
020 Gambetta,3,5,8,2022,01-18,22:20
021 Port Marianne,14,2,16,2022,01-18,22:20
022 Clemenceau,3,9,12,2022,01-18,22:20
023 Les Arceaux,4,12,16,2022,01-18,22:20
024 Cit� Mion,3,5,8,2022,01-18,22:20
025 Nouveau Saint-Roch,4,4,8,2022,01-18,22:20
026 Renouvier,5,3,8,2022,01-18,22:20
027 Odysseum,4,4,8,2022,01-18,22:20
028 Saint-Denis,3,5,8,2022,01-18,22:20
029 Richter,10,6,16,2022,01-18,22:20
030 Charles Flahault,6,2,8,2022,01-18,22:20
031 Voltaire,3,5,8,2022,01-18,22:20
032 Pr�s d'Ar�nes,8,0,8,2022,01-18,22:20
033 Garcia Lorca,8,0,8,2022,01-18,22:20
034 Vert Bois,0,16,16,2022,01-18,22:20
035 Malbosc,0,8,8,2022,01-18,22:20
036 Occitanie,2,30,32,2022,01-18,22:20
037 FacdesSciences,0,24,24,2022,01-18,22:20
038 Fac de Lettres,0,16,16,2022,01-18,22:20
039 Aiguelongue,6,2,8,2022,01-18,22:20
040 Jeu de Mail des Abb�s,8,0,8,2022,01-18,22:20
041 Eurom�decine,0,8,8,2022,01-18,22:20
042 Marie Caizergues,3,5,8,2022,01-18,22:20
043 Sabines,3,5,8,2022,01-18,22:20
044 Celleneuve,0,8,8,2022,01-18,22:20
045 Jardin de la Lironde,1,7,8,2022,01-18,22:20
046 P�re Soulas,8,0,8,2022,01-18,22:20
047 Place Viala,2,6,8,2022,01-18,22:20
048 H�tel du D�partement,0,8,8,2022,01-18,22:20
049 Tonnelles,1,7,8,2022,01-18,22:20
050 Parvis Jules Ferry - Gare Saint-Roch,0,8,8,2022,01-18,22:20
051 Pont de Lattes - Gare Saint-Roch,4,8,12,2022,01-18,22:20
053 Deux Ponts - Gare Saint-Roch,2,6,8,2022,01-18,22:20
054 Providence - Ovalie,4,4,8,2022,01-18,22:20
055 P�rols Etang de l'Or,23,45,68,2022,01-18,22:20
056 Albert 1er - Cath�drale,4,8,12,2022,01-18,22:20
057 Saint-Guilhem - Courreau,5,3,8,2022,01-18,22:20
059 Sud De France,0,8,8,2022,01-18,22:20
001 Rue Jules Ferry - Gare Saint-Roch,1,11,12,2022,01-18,22:30
002 Com�die,11,13,24,2022,01-18,22:30
003 Esplanade,11,21,32,2022,01-18,22:30
004 H�tel de Ville,16,0,16,2022,01-18,22:30
005 Corum,8,4,12,2022,01-18,22:30
006 Place Albert 1er - St Charles,18,13,31,2022,01-18,22:30
007 Foch,2,6,8,2022,01-18,22:30
008 Halles Castellane,0,12,12,2022,01-18,22:30
009 Observatoire,7,1,8,2022,01-18,22:30
010 Rondelet,3,13,16,2022,01-18,22:30
011 Plan Cabanes,9,3,12,2022,01-18,22:30
012 Boutonnet,1,11,12,2022,01-18,22:30
013 Emile Combes,4,4,8,2022,01-18,22:30
014 Beaux-Arts,5,3,8,2022,01-18,22:30
015 Les Aubes,6,2,8,2022,01-18,22:30
016 Antigone centre,16,0,16,2022,01-18,22:30
017 M�diath�que Emile Zola,13,3,16,2022,01-18,22:30
018 Nombre d'Or,16,0,16,2022,01-18,22:30
019 Louis Blanc,6,10,16,2022,01-18,22:30
020 Gambetta,3,5,8,2022,01-18,22:30
021 Port Marianne,14,2,16,2022,01-18,22:30
022 Clemenceau,3,9,12,2022,01-18,22:30
023 Les Arceaux,4,12,16,2022,01-18,22:30
024 Cit� Mion,3,5,8,2022,01-18,22:30
025 Nouveau Saint-Roch,4,4,8,2022,01-18,22:30
026 Renouvier,5,3,8,2022,01-18,22:30
027 Odysseum,4,4,8,2022,01-18,22:30
028 Saint-Denis,3,5,8,2022,01-18,22:30
029 Richter,10,6,16,2022,01-18,22:30
030 Charles Flahault,6,2,8,2022,01-18,22:30
031 Voltaire,3,5,8,2022,01-18,22:30
032 Pr�s d'Ar�nes,8,0,8,2022,01-18,22:30
033 Garcia Lorca,8,0,8,2022,01-18,22:30
034 Vert Bois,0,16,16,2022,01-18,22:30
035 Malbosc,0,8,8,2022,01-18,22:30
036 Occitanie,2,30,32,2022,01-18,22:30
037 FacdesSciences,0,24,24,2022,01-18,22:30
038 Fac de Lettres,0,16,16,2022,01-18,22:30
039 Aiguelongue,6,2,8,2022,01-18,22:30
040 Jeu de Mail des Abb�s,8,0,8,2022,01-18,22:30
041 Eurom�decine,0,8,8,2022,01-18,22:30
042 Marie Caizergues,3,5,8,2022,01-18,22:30
043 Sabines,3,5,8,2022,01-18,22:30
044 Celleneuve,0,8,8,2022,01-18,22:30
045 Jardin de la Lironde,1,7,8,2022,01-18,22:30
046 P�re Soulas,8,0,8,2022,01-18,22:30
047 Place Viala,2,6,8,2022,01-18,22:30
048 H�tel du D�partement,0,8,8,2022,01-18,22:30
049 Tonnelles,1,7,8,2022,01-18,22:30
050 Parvis Jules Ferry - Gare Saint-Roch,0,8,8,2022,01-18,22:30
051 Pont de Lattes - Gare Saint-Roch,4,8,12,2022,01-18,22:30
053 Deux Ponts - Gare Saint-Roch,2,6,8,2022,01-18,22:30
054 Providence - Ovalie,4,4,8,2022,01-18,22:30
055 P�rols Etang de l'Or,23,45,68,2022,01-18,22:30
056 Albert 1er - Cath�drale,4,8,12,2022,01-18,22:30
057 Saint-Guilhem - Courreau,5,3,8,2022,01-18,22:30
059 Sud De France,0,8,8,2022,01-18,22:30
001 Rue Jules Ferry - Gare Saint-Roch,1,11,12,2022,01-18,22:40
002 Com�die,9,15,24,2022,01-18,22:40
003 Esplanade,11,21,32,2022,01-18,22:40
004 H�tel de Ville,16,0,16,2022,01-18,22:40
005 Corum,8,4,12,2022,01-18,22:40
006 Place Albert 1er - St Charles,18,13,31,2022,01-18,22:40
007 Foch,2,6,8,2022,01-18,22:40
008 Halles Castellane,0,12,12,2022,01-18,22:40
009 Observatoire,7,1,8,2022,01-18,22:40
010 Rondelet,3,13,16,2022,01-18,22:40
011 Plan Cabanes,10,2,12,2022,01-18,22:40
012 Boutonnet,2,10,12,2022,01-18,22:40
013 Emile Combes,4,4,8,2022,01-18,22:40
014 Beaux-Arts,5,3,8,2022,01-18,22:40
015 Les Aubes,6,2,8,2022,01-18,22:40
016 Antigone centre,16,0,16,2022,01-18,22:40
017 M�diath�que Emile Zola,12,4,16,2022,01-18,22:40
018 Nombre d'Or,16,0,16,2022,01-18,22:40
019 Louis Blanc,6,10,16,2022,01-18,22:40
020 Gambetta,3,5,8,2022,01-18,22:40
021 Port Marianne,15,1,16,2022,01-18,22:40
022 Clemenceau,3,9,12,2022,01-18,22:40
023 Les Arceaux,4,12,16,2022,01-18,22:40
024 Cit� Mion,3,5,8,2022,01-18,22:40
025 Nouveau Saint-Roch,4,4,8,2022,01-18,22:40
026 Renouvier,5,3,8,2022,01-18,22:40
027 Odysseum,4,4,8,2022,01-18,22:40
028 Saint-Denis,3,5,8,2022,01-18,22:40
029 Richter,10,6,16,2022,01-18,22:40
030 Charles Flahault,6,2,8,2022,01-18,22:40
031 Voltaire,3,5,8,2022,01-18,22:40
032 Pr�s d'Ar�nes,8,0,8,2022,01-18,22:40
033 Garcia Lorca,8,0,8,2022,01-18,22:40
034 Vert Bois,0,16,16,2022,01-18,22:40
035 Malbosc,0,8,8,2022,01-18,22:40
036 Occitanie,2,30,32,2022,01-18,22:40
037 FacdesSciences,0,24,24,2022,01-18,22:40
038 Fac de Lettres,0,16,16,2022,01-18,22:40
039 Aiguelongue,6,2,8,2022,01-18,22:40
040 Jeu de Mail des Abb�s,8,0,8,2022,01-18,22:40
041 Eurom�decine,0,8,8,2022,01-18,22:40
042 Marie Caizergues,3,5,8,2022,01-18,22:40
043 Sabines,3,5,8,2022,01-18,22:40
044 Celleneuve,0,8,8,2022,01-18,22:40
045 Jardin de la Lironde,1,7,8,2022,01-18,22:40
046 P�re Soulas,8,0,8,2022,01-18,22:40
047 Place Viala,2,6,8,2022,01-18,22:40
048 H�tel du D�partement,0,8,8,2022,01-18,22:40
049 Tonnelles,1,7,8,2022,01-18,22:40
050 Parvis Jules Ferry - Gare Saint-Roch,0,8,8,2022,01-18,22:40
051 Pont de Lattes - Gare Saint-Roch,4,8,12,2022,01-18,22:40
053 Deux Ponts - Gare Saint-Roch,2,6,8,2022,01-18,22:40
054 Providence - Ovalie,4,4,8,2022,01-18,22:40
055 P�rols Etang de l'Or,23,45,68,2022,01-18,22:40
056 Albert 1er - Cath�drale,4,8,12,2022,01-18,22:40
057 Saint-Guilhem - Courreau,5,3,8,2022,01-18,22:40
059 Sud De France,0,8,8,2022,01-18,22:40
001 Rue Jules Ferry - Gare Saint-Roch,1,11,12,2022,01-18,22:51
002 Com�die,7,17,24,2022,01-18,22:51
003 Esplanade,11,21,32,2022,01-18,22:51
004 H�tel de Ville,16,0,16,2022,01-18,22:51
005 Corum,9,3,12,2022,01-18,22:51
006 Place Albert 1er - St Charles,18,13,31,2022,01-18,22:51
007 Foch,2,6,8,2022,01-18,22:51
008 Halles Castellane,0,12,12,2022,01-18,22:51
009 Observatoire,7,1,8,2022,01-18,22:51
010 Rondelet,3,13,16,2022,01-18,22:51
011 Plan Cabanes,9,3,12,2022,01-18,22:51
012 Boutonnet,1,11,12,2022,01-18,22:51
013 Emile Combes,4,4,8,2022,01-18,22:51
014 Beaux-Arts,5,3,8,2022,01-18,22:51
015 Les Aubes,6,2,8,2022,01-18,22:51
016 Antigone centre,16,0,16,2022,01-18,22:51
017 M�diath�que Emile Zola,12,4,16,2022,01-18,22:51
018 Nombre d'Or,16,0,16,2022,01-18,22:51
019 Louis Blanc,6,10,16,2022,01-18,22:51
020 Gambetta,3,5,8,2022,01-18,22:51
021 Port Marianne,15,1,16,2022,01-18,22:51
022 Clemenceau,3,9,12,2022,01-18,22:51
023 Les Arceaux,4,12,16,2022,01-18,22:51
024 Cit� Mion,3,5,8,2022,01-18,22:51
025 Nouveau Saint-Roch,3,5,8,2022,01-18,22:51
026 Renouvier,5,3,8,2022,01-18,22:51
027 Odysseum,3,5,8,2022,01-18,22:51
028 Saint-Denis,3,5,8,2022,01-18,22:51
029 Richter,10,6,16,2022,01-18,22:51
030 Charles Flahault,6,2,8,2022,01-18,22:51
031 Voltaire,3,5,8,2022,01-18,22:51
032 Pr�s d'Ar�nes,8,0,8,2022,01-18,22:51
033 Garcia Lorca,8,0,8,2022,01-18,22:51
034 Vert Bois,0,16,16,2022,01-18,22:51
035 Malbosc,0,8,8,2022,01-18,22:51
036 Occitanie,1,31,32,2022,01-18,22:51
037 FacdesSciences,0,24,24,2022,01-18,22:51
038 Fac de Lettres,0,16,16,2022,01-18,22:51
039 Aiguelongue,7,1,8,2022,01-18,22:51
040 Jeu de Mail des Abb�s,8,0,8,2022,01-18,22:51
041 Eurom�decine,0,8,8,2022,01-18,22:51
042 Marie Caizergues,3,5,8,2022,01-18,22:51
043 Sabines,3,5,8,2022,01-18,22:51
044 Celleneuve,0,8,8,2022,01-18,22:51
045 Jardin de la Lironde,1,7,8,2022,01-18,22:51
046 P�re Soulas,8,0,8,2022,01-18,22:51
047 Place Viala,2,6,8,2022,01-18,22:51
048 H�tel du D�partement,0,8,8,2022,01-18,22:51
049 Tonnelles,1,7,8,2022,01-18,22:51
050 Parvis Jules Ferry - Gare Saint-Roch,0,8,8,2022,01-18,22:51
051 Pont de Lattes - Gare Saint-Roch,4,8,12,2022,01-18,22:51
053 Deux Ponts - Gare Saint-Roch,2,6,8,2022,01-18,22:51
054 Providence - Ovalie,4,4,8,2022,01-18,22:51
055 P�rols Etang de l'Or,23,45,68,2022,01-18,22:51
056 Albert 1er - Cath�drale,4,8,12,2022,01-18,22:51
057 Saint-Guilhem - Courreau,5,3,8,2022,01-18,22:51
059 Sud De France,0,8,8,2022,01-18,22:51
001 Rue Jules Ferry - Gare Saint-Roch,1,11,12,2022,01-18,23:01
002 Com�die,7,17,24,2022,01-18,23:01
003 Esplanade,11,21,32,2022,01-18,23:01
004 H�tel de Ville,16,0,16,2022,01-18,23:01
005 Corum,9,3,12,2022,01-18,23:01
006 Place Albert 1er - St Charles,18,13,31,2022,01-18,23:01
007 Foch,2,6,8,2022,01-18,23:01
008 Halles Castellane,0,12,12,2022,01-18,23:01
009 Observatoire,7,1,8,2022,01-18,23:01
010 Rondelet,3,13,16,2022,01-18,23:01
011 Plan Cabanes,9,3,12,2022,01-18,23:01
012 Boutonnet,1,11,12,2022,01-18,23:01
013 Emile Combes,3,5,8,2022,01-18,23:01
014 Beaux-Arts,4,4,8,2022,01-18,23:01
015 Les Aubes,6,2,8,2022,01-18,23:01
016 Antigone centre,16,0,16,2022,01-18,23:01
017 M�diath�que Emile Zola,12,4,16,2022,01-18,23:01
018 Nombre d'Or,16,0,16,2022,01-18,23:01
019 Louis Blanc,6,10,16,2022,01-18,23:01
020 Gambetta,3,5,8,2022,01-18,23:01
021 Port Marianne,15,1,16,2022,01-18,23:01
022 Clemenceau,3,9,12,2022,01-18,23:01
023 Les Arceaux,4,12,16,2022,01-18,23:01
024 Cit� Mion,3,5,8,2022,01-18,23:01
025 Nouveau Saint-Roch,4,4,8,2022,01-18,23:01
026 Renouvier,5,3,8,2022,01-18,23:01
027 Odysseum,3,5,8,2022,01-18,23:01
028 Saint-Denis,3,5,8,2022,01-18,23:01
029 Richter,11,5,16,2022,01-18,23:01
030 Charles Flahault,6,2,8,2022,01-18,23:01
031 Voltaire,3,5,8,2022,01-18,23:01
032 Pr�s d'Ar�nes,8,0,8,2022,01-18,23:01
033 Garcia Lorca,8,0,8,2022,01-18,23:01
034 Vert Bois,0,16,16,2022,01-18,23:01
035 Malbosc,0,8,8,2022,01-18,23:01
036 Occitanie,1,31,32,2022,01-18,23:01
037 FacdesSciences,0,24,24,2022,01-18,23:01
038 Fac de Lettres,1,15,16,2022,01-18,23:01
039 Aiguelongue,7,1,8,2022,01-18,23:01
040 Jeu de Mail des Abb�s,8,0,8,2022,01-18,23:01
041 Eurom�decine,0,8,8,2022,01-18,23:01
042 Marie Caizergues,3,5,8,2022,01-18,23:01
043 Sabines,3,5,8,2022,01-18,23:01
044 Celleneuve,0,8,8,2022,01-18,23:01
045 Jardin de la Lironde,1,7,8,2022,01-18,23:01
046 P�re Soulas,8,0,8,2022,01-18,23:01
047 Place Viala,2,6,8,2022,01-18,23:01
048 H�tel du D�partement,0,8,8,2022,01-18,23:01
049 Tonnelles,1,7,8,2022,01-18,23:01
050 Parvis Jules Ferry - Gare Saint-Roch,0,8,8,2022,01-18,23:01
051 Pont de Lattes - Gare Saint-Roch,4,8,12,2022,01-18,23:01
053 Deux Ponts - Gare Saint-Roch,2,6,8,2022,01-18,23:01
054 Providence - Ovalie,4,4,8,2022,01-18,23:01
055 P�rols Etang de l'Or,23,45,68,2022,01-18,23:01
056 Albert 1er - Cath�drale,4,8,12,2022,01-18,23:01
057 Saint-Guilhem - Courreau,5,3,8,2022,01-18,23:01
059 Sud De France,0,8,8,2022,01-18,23:01
001 Rue Jules Ferry - Gare Saint-Roch,1,11,12,2022,01-18,23:12
002 Com�die,7,17,24,2022,01-18,23:12
003 Esplanade,11,21,32,2022,01-18,23:12
004 H�tel de Ville,16,0,16,2022,01-18,23:12
005 Corum,9,3,12,2022,01-18,23:12
006 Place Albert 1er - St Charles,19,12,31,2022,01-18,23:12
007 Foch,2,6,8,2022,01-18,23:12
008 Halles Castellane,0,12,12,2022,01-18,23:12
009 Observatoire,7,1,8,2022,01-18,23:12
010 Rondelet,3,13,16,2022,01-18,23:12
011 Plan Cabanes,9,3,12,2022,01-18,23:12
012 Boutonnet,1,11,12,2022,01-18,23:12
013 Emile Combes,3,5,8,2022,01-18,23:12
014 Beaux-Arts,4,4,8,2022,01-18,23:12
015 Les Aubes,4,4,8,2022,01-18,23:12
016 Antigone centre,16,0,16,2022,01-18,23:12
017 M�diath�que Emile Zola,12,4,16,2022,01-18,23:12
018 Nombre d'Or,16,0,16,2022,01-18,23:12
019 Louis Blanc,6,10,16,2022,01-18,23:12
020 Gambetta,3,5,8,2022,01-18,23:12
021 Port Marianne,16,0,16,2022,01-18,23:12
022 Clemenceau,3,9,12,2022,01-18,23:12
023 Les Arceaux,4,12,16,2022,01-18,23:12
024 Cit� Mion,3,5,8,2022,01-18,23:12
025 Nouveau Saint-Roch,4,4,8,2022,01-18,23:12
026 Renouvier,5,3,8,2022,01-18,23:12
027 Odysseum,3,5,8,2022,01-18,23:12
028 Saint-Denis,3,5,8,2022,01-18,23:12
029 Richter,11,5,16,2022,01-18,23:12
030 Charles Flahault,7,1,8,2022,01-18,23:12
031 Voltaire,3,5,8,2022,01-18,23:12
032 Pr�s d'Ar�nes,8,0,8,2022,01-18,23:12
033 Garcia Lorca,8,0,8,2022,01-18,23:12
034 Vert Bois,0,16,16,2022,01-18,23:12
035 Malbosc,0,8,8,2022,01-18,23:12
036 Occitanie,1,31,32,2022,01-18,23:12
037 FacdesSciences,0,24,24,2022,01-18,23:12
038 Fac de Lettres,1,15,16,2022,01-18,23:12
039 Aiguelongue,7,1,8,2022,01-18,23:12
040 Jeu de Mail des Abb�s,8,0,8,2022,01-18,23:12
041 Eurom�decine,0,8,8,2022,01-18,23:12
042 Marie Caizergues,5,3,8,2022,01-18,23:12
043 Sabines,3,5,8,2022,01-18,23:12
044 Celleneuve,0,8,8,2022,01-18,23:12
045 Jardin de la Lironde,1,7,8,2022,01-18,23:12
046 P�re Soulas,8,0,8,2022,01-18,23:12
047 Place Viala,2,6,8,2022,01-18,23:12
048 H�tel du D�partement,0,8,8,2022,01-18,23:12
049 Tonnelles,1,7,8,2022,01-18,23:12
050 Parvis Jules Ferry - Gare Saint-Roch,0,8,8,2022,01-18,23:12
051 Pont de Lattes - Gare Saint-Roch,4,8,12,2022,01-18,23:12
053 Deux Ponts - Gare Saint-Roch,2,6,8,2022,01-18,23:12
054 Providence - Ovalie,4,4,8,2022,01-18,23:12
055 P�rols Etang de l'Or,23,45,68,2022,01-18,23:12
056 Albert 1er - Cath�drale,4,8,12,2022,01-18,23:12
057 Saint-Guilhem - Courreau,5,3,8,2022,01-18,23:12
059 Sud De France,0,8,8,2022,01-18,23:12
001 Rue Jules Ferry - Gare Saint-Roch,0,12,12,2022,01-18,23:22
002 Com�die,7,17,24,2022,01-18,23:22
003 Esplanade,11,21,32,2022,01-18,23:22
004 H�tel de Ville,16,0,16,2022,01-18,23:22
005 Corum,9,3,12,2022,01-18,23:22
006 Place Albert 1er - St Charles,19,12,31,2022,01-18,23:22
007 Foch,2,6,8,2022,01-18,23:22
008 Halles Castellane,0,12,12,2022,01-18,23:22
009 Observatoire,7,1,8,2022,01-18,23:22
010 Rondelet,3,13,16,2022,01-18,23:22
011 Plan Cabanes,9,3,12,2022,01-18,23:22
012 Boutonnet,1,11,12,2022,01-18,23:22
013 Emile Combes,3,5,8,2022,01-18,23:22
014 Beaux-Arts,4,4,8,2022,01-18,23:22
015 Les Aubes,4,4,8,2022,01-18,23:22
016 Antigone centre,16,0,16,2022,01-18,23:22
017 M�diath�que Emile Zola,12,4,16,2022,01-18,23:22
018 Nombre d'Or,16,0,16,2022,01-18,23:22
019 Louis Blanc,8,8,16,2022,01-18,23:22
020 Gambetta,3,5,8,2022,01-18,23:22
021 Port Marianne,16,0,16,2022,01-18,23:22
022 Clemenceau,3,9,12,2022,01-18,23:22
023 Les Arceaux,4,12,16,2022,01-18,23:22
024 Cit� Mion,3,5,8,2022,01-18,23:22
025 Nouveau Saint-Roch,4,4,8,2022,01-18,23:22
026 Renouvier,5,3,8,2022,01-18,23:22
027 Odysseum,2,6,8,2022,01-18,23:22
028 Saint-Denis,3,5,8,2022,01-18,23:22
029 Richter,11,5,16,2022,01-18,23:22
030 Charles Flahault,7,1,8,2022,01-18,23:22
031 Voltaire,3,5,8,2022,01-18,23:22
032 Pr�s d'Ar�nes,8,0,8,2022,01-18,23:22
033 Garcia Lorca,8,0,8,2022,01-18,23:22
034 Vert Bois,0,16,16,2022,01-18,23:22
035 Malbosc,0,8,8,2022,01-18,23:22
036 Occitanie,1,31,32,2022,01-18,23:22
037 FacdesSciences,0,24,24,2022,01-18,23:22
038 Fac de Lettres,1,15,16,2022,01-18,23:22
039 Aiguelongue,7,1,8,2022,01-18,23:22
040 Jeu de Mail des Abb�s,8,0,8,2022,01-18,23:22
041 Eurom�decine,0,8,8,2022,01-18,23:22
042 Marie Caizergues,5,3,8,2022,01-18,23:22
043 Sabines,3,5,8,2022,01-18,23:22
044 Celleneuve,0,8,8,2022,01-18,23:22
045 Jardin de la Lironde,1,7,8,2022,01-18,23:22
046 P�re Soulas,8,0,8,2022,01-18,23:22
047 Place Viala,2,6,8,2022,01-18,23:22
048 H�tel du D�partement,0,8,8,2022,01-18,23:22
049 Tonnelles,1,7,8,2022,01-18,23:22
050 Parvis Jules Ferry - Gare Saint-Roch,0,8,8,2022,01-18,23:22
051 Pont de Lattes - Gare Saint-Roch,4,8,12,2022,01-18,23:22
053 Deux Ponts - Gare Saint-Roch,2,6,8,2022,01-18,23:22
054 Providence - Ovalie,4,4,8,2022,01-18,23:22
055 P�rols Etang de l'Or,23,45,68,2022,01-18,23:22
056 Albert 1er - Cath�drale,4,8,12,2022,01-18,23:22
057 Saint-Guilhem - Courreau,5,3,8,2022,01-18,23:22
059 Sud De France,0,8,8,2022,01-18,23:22
001 Rue Jules Ferry - Gare Saint-Roch,0,12,12,2022,01-18,23:32
002 Com�die,7,17,24,2022,01-18,23:32
003 Esplanade,11,21,32,2022,01-18,23:32
004 H�tel de Ville,16,0,16,2022,01-18,23:32
005 Corum,9,3,12,2022,01-18,23:32
006 Place Albert 1er - St Charles,19,12,31,2022,01-18,23:32
007 Foch,2,6,8,2022,01-18,23:32
008 Halles Castellane,0,12,12,2022,01-18,23:32
009 Observatoire,7,1,8,2022,01-18,23:32
010 Rondelet,2,14,16,2022,01-18,23:32
011 Plan Cabanes,9,3,12,2022,01-18,23:32
012 Boutonnet,1,11,12,2022,01-18,23:32
013 Emile Combes,3,5,8,2022,01-18,23:32
014 Beaux-Arts,4,4,8,2022,01-18,23:32
015 Les Aubes,4,4,8,2022,01-18,23:32
016 Antigone centre,16,0,16,2022,01-18,23:32
017 M�diath�que Emile Zola,12,4,16,2022,01-18,23:32
018 Nombre d'Or,16,0,16,2022,01-18,23:32
019 Louis Blanc,9,7,16,2022,01-18,23:32
020 Gambetta,3,5,8,2022,01-18,23:32
021 Port Marianne,16,0,16,2022,01-18,23:32
022 Clemenceau,3,9,12,2022,01-18,23:32
023 Les Arceaux,4,12,16,2022,01-18,23:32
024 Cit� Mion,3,5,8,2022,01-18,23:32
025 Nouveau Saint-Roch,4,4,8,2022,01-18,23:32
026 Renouvier,5,3,8,2022,01-18,23:32
027 Odysseum,2,6,8,2022,01-18,23:32
028 Saint-Denis,3,5,8,2022,01-18,23:32
029 Richter,11,5,16,2022,01-18,23:32
030 Charles Flahault,7,1,8,2022,01-18,23:32
031 Voltaire,3,5,8,2022,01-18,23:32
032 Pr�s d'Ar�nes,8,0,8,2022,01-18,23:32
033 Garcia Lorca,7,1,8,2022,01-18,23:32
034 Vert Bois,0,16,16,2022,01-18,23:32
035 Malbosc,0,8,8,2022,01-18,23:32
036 Occitanie,1,31,32,2022,01-18,23:32
037 FacdesSciences,0,24,24,2022,01-18,23:32
038 Fac de Lettres,1,15,16,2022,01-18,23:32
039 Aiguelongue,7,1,8,2022,01-18,23:32
040 Jeu de Mail des Abb�s,8,0,8,2022,01-18,23:32
041 Eurom�decine,0,8,8,2022,01-18,23:32
042 Marie Caizergues,5,3,8,2022,01-18,23:32
043 Sabines,3,5,8,2022,01-18,23:32
044 Celleneuve,0,8,8,2022,01-18,23:32
045 Jardin de la Lironde,1,7,8,2022,01-18,23:32
046 P�re Soulas,8,0,8,2022,01-18,23:32
047 Place Viala,2,6,8,2022,01-18,23:32
048 H�tel du D�partement,0,8,8,2022,01-18,23:32
049 Tonnelles,1,7,8,2022,01-18,23:32
050 Parvis Jules Ferry - Gare Saint-Roch,0,8,8,2022,01-18,23:32
051 Pont de Lattes - Gare Saint-Roch,4,8,12,2022,01-18,23:32
053 Deux Ponts - Gare Saint-Roch,2,6,8,2022,01-18,23:32
054 Providence - Ovalie,4,4,8,2022,01-18,23:32
055 P�rols Etang de l'Or,23,45,68,2022,01-18,23:32
056 Albert 1er - Cath�drale,4,8,12,2022,01-18,23:32
057 Saint-Guilhem - Courreau,5,3,8,2022,01-18,23:32
059 Sud De France,0,8,8,2022,01-18,23:32
001 Rue Jules Ferry - Gare Saint-Roch,0,12,12,2022,01-18,23:42
002 Com�die,7,17,24,2022,01-18,23:42
003 Esplanade,10,22,32,2022,01-18,23:42
004 H�tel de Ville,16,0,16,2022,01-18,23:42
005 Corum,9,3,12,2022,01-18,23:42
006 Place Albert 1er - St Charles,19,12,31,2022,01-18,23:42
007 Foch,2,6,8,2022,01-18,23:42
008 Halles Castellane,0,12,12,2022,01-18,23:42
009 Observatoire,7,1,8,2022,01-18,23:42
010 Rondelet,2,14,16,2022,01-18,23:42
011 Plan Cabanes,9,3,12,2022,01-18,23:42
012 Boutonnet,1,11,12,2022,01-18,23:42
013 Emile Combes,4,4,8,2022,01-18,23:42
014 Beaux-Arts,4,4,8,2022,01-18,23:42
015 Les Aubes,4,4,8,2022,01-18,23:42
016 Antigone centre,16,0,16,2022,01-18,23:42
017 M�diath�que Emile Zola,12,4,16,2022,01-18,23:42
018 Nombre d'Or,16,0,16,2022,01-18,23:42
019 Louis Blanc,9,7,16,2022,01-18,23:42
020 Gambetta,3,5,8,2022,01-18,23:42
021 Port Marianne,16,0,16,2022,01-18,23:42
022 Clemenceau,3,9,12,2022,01-18,23:42
023 Les Arceaux,4,12,16,2022,01-18,23:42
024 Cit� Mion,3,5,8,2022,01-18,23:42
025 Nouveau Saint-Roch,4,4,8,2022,01-18,23:42
026 Renouvier,5,3,8,2022,01-18,23:42
027 Odysseum,2,6,8,2022,01-18,23:42
028 Saint-Denis,3,5,8,2022,01-18,23:42
029 Richter,11,5,16,2022,01-18,23:42
030 Charles Flahault,7,1,8,2022,01-18,23:42
031 Voltaire,3,5,8,2022,01-18,23:42
032 Pr�s d'Ar�nes,8,0,8,2022,01-18,23:42
033 Garcia Lorca,7,1,8,2022,01-18,23:42
034 Vert Bois,0,16,16,2022,01-18,23:42
035 Malbosc,0,8,8,2022,01-18,23:42
036 Occitanie,1,31,32,2022,01-18,23:42
037 FacdesSciences,0,24,24,2022,01-18,23:42
038 Fac de Lettres,1,15,16,2022,01-18,23:42
039 Aiguelongue,7,1,8,2022,01-18,23:42
040 Jeu de Mail des Abb�s,8,0,8,2022,01-18,23:42
041 Eurom�decine,0,8,8,2022,01-18,23:42
042 Marie Caizergues,5,3,8,2022,01-18,23:42
043 Sabines,3,5,8,2022,01-18,23:42
044 Celleneuve,0,8,8,2022,01-18,23:42
045 Jardin de la Lironde,1,7,8,2022,01-18,23:42
046 P�re Soulas,8,0,8,2022,01-18,23:42
047 Place Viala,2,6,8,2022,01-18,23:42
048 H�tel du D�partement,0,8,8,2022,01-18,23:42
049 Tonnelles,1,7,8,2022,01-18,23:42
050 Parvis Jules Ferry - Gare Saint-Roch,0,8,8,2022,01-18,23:42
051 Pont de Lattes - Gare Saint-Roch,3,9,12,2022,01-18,23:42
053 Deux Ponts - Gare Saint-Roch,3,5,8,2022,01-18,23:42
054 Providence - Ovalie,4,4,8,2022,01-18,23:42
055 P�rols Etang de l'Or,23,45,68,2022,01-18,23:42
056 Albert 1er - Cath�drale,4,8,12,2022,01-18,23:42
057 Saint-Guilhem - Courreau,4,4,8,2022,01-18,23:42
059 Sud De France,0,8,8,2022,01-18,23:42
001 Rue Jules Ferry - Gare Saint-Roch,0,12,12,2022,01-18,23:52
002 Com�die,6,18,24,2022,01-18,23:52
003 Esplanade,10,22,32,2022,01-18,23:52
004 H�tel de Ville,16,0,16,2022,01-18,23:52
005 Corum,9,3,12,2022,01-18,23:52
006 Place Albert 1er - St Charles,19,12,31,2022,01-18,23:52
007 Foch,2,6,8,2022,01-18,23:52
008 Halles Castellane,0,12,12,2022,01-18,23:52
009 Observatoire,7,1,8,2022,01-18,23:52
010 Rondelet,2,14,16,2022,01-18,23:52
011 Plan Cabanes,9,3,12,2022,01-18,23:52
012 Boutonnet,1,11,12,2022,01-18,23:52
013 Emile Combes,4,4,8,2022,01-18,23:52
014 Beaux-Arts,4,4,8,2022,01-18,23:52
015 Les Aubes,4,4,8,2022,01-18,23:52
016 Antigone centre,16,0,16,2022,01-18,23:52
017 M�diath�que Emile Zola,12,4,16,2022,01-18,23:52
018 Nombre d'Or,16,0,16,2022,01-18,23:52
019 Louis Blanc,8,8,16,2022,01-18,23:52
020 Gambetta,4,4,8,2022,01-18,23:52
021 Port Marianne,16,0,16,2022,01-18,23:52
022 Clemenceau,3,9,12,2022,01-18,23:52
023 Les Arceaux,4,12,16,2022,01-18,23:52
024 Cit� Mion,3,5,8,2022,01-18,23:52
025 Nouveau Saint-Roch,4,4,8,2022,01-18,23:52
026 Renouvier,5,3,8,2022,01-18,23:52
027 Odysseum,2,6,8,2022,01-18,23:52
028 Saint-Denis,3,5,8,2022,01-18,23:52
029 Richter,12,4,16,2022,01-18,23:52
030 Charles Flahault,8,0,8,2022,01-18,23:52
031 Voltaire,3,5,8,2022,01-18,23:52
032 Pr�s d'Ar�nes,8,0,8,2022,01-18,23:52
033 Garcia Lorca,7,1,8,2022,01-18,23:52
034 Vert Bois,0,16,16,2022,01-18,23:52
035 Malbosc,0,8,8,2022,01-18,23:52
036 Occitanie,1,31,32,2022,01-18,23:52
037 FacdesSciences,0,24,24,2022,01-18,23:52
038 Fac de Lettres,1,15,16,2022,01-18,23:52
039 Aiguelongue,6,2,8,2022,01-18,23:52
040 Jeu de Mail des Abb�s,8,0,8,2022,01-18,23:52
041 Eurom�decine,0,8,8,2022,01-18,23:52
042 Marie Caizergues,5,3,8,2022,01-18,23:52
043 Sabines,3,5,8,2022,01-18,23:52
044 Celleneuve,0,8,8,2022,01-18,23:52
045 Jardin de la Lironde,1,7,8,2022,01-18,23:52
046 P�re Soulas,7,1,8,2022,01-18,23:52
047 Place Viala,2,6,8,2022,01-18,23:52
048 H�tel du D�partement,0,8,8,2022,01-18,23:52
049 Tonnelles,1,7,8,2022,01-18,23:52
050 Parvis Jules Ferry - Gare Saint-Roch,0,8,8,2022,01-18,23:52
051 Pont de Lattes - Gare Saint-Roch,3,9,12,2022,01-18,23:52
053 Deux Ponts - Gare Saint-Roch,3,5,8,2022,01-18,23:52
054 Providence - Ovalie,4,4,8,2022,01-18,23:52
055 P�rols Etang de l'Or,23,45,68,2022,01-18,23:52
056 Albert 1er - Cath�drale,4,8,12,2022,01-18,23:52
057 Saint-Guilhem - Courreau,5,3,8,2022,01-18,23:52
059 Sud De France,0,8,8,2022,01-18,23:52
001 Rue Jules Ferry - Gare Saint-Roch,0,12,12,2022,01-19,00:02
002 Com�die,6,18,24,2022,01-19,00:02
003 Esplanade,10,22,32,2022,01-19,00:02
004 H�tel de Ville,16,0,16,2022,01-19,00:02
005 Corum,9,3,12,2022,01-19,00:02
006 Place Albert 1er - St Charles,20,11,31,2022,01-19,00:02
007 Foch,2,6,8,2022,01-19,00:02
008 Halles Castellane,0,12,12,2022,01-19,00:02
009 Observatoire,7,1,8,2022,01-19,00:02
010 Rondelet,2,14,16,2022,01-19,00:02
011 Plan Cabanes,9,3,12,2022,01-19,00:02
012 Boutonnet,1,11,12,2022,01-19,00:02
013 Emile Combes,4,4,8,2022,01-19,00:02
014 Beaux-Arts,4,4,8,2022,01-19,00:02
015 Les Aubes,4,4,8,2022,01-19,00:02
016 Antigone centre,16,0,16,2022,01-19,00:02
017 M�diath�que Emile Zola,12,4,16,2022,01-19,00:02
018 Nombre d'Or,16,0,16,2022,01-19,00:02
019 Louis Blanc,8,8,16,2022,01-19,00:02
020 Gambetta,4,4,8,2022,01-19,00:02
021 Port Marianne,16,0,16,2022,01-19,00:02
022 Clemenceau,3,9,12,2022,01-19,00:02
023 Les Arceaux,4,12,16,2022,01-19,00:02
024 Cit� Mion,1,7,8,2022,01-19,00:02
025 Nouveau Saint-Roch,4,4,8,2022,01-19,00:02
026 Renouvier,5,3,8,2022,01-19,00:02
027 Odysseum,2,6,8,2022,01-19,00:02
028 Saint-Denis,3,5,8,2022,01-19,00:02
029 Richter,12,4,16,2022,01-19,00:02
030 Charles Flahault,8,0,8,2022,01-19,00:02
031 Voltaire,3,5,8,2022,01-19,00:02
032 Pr�s d'Ar�nes,8,0,8,2022,01-19,00:02
033 Garcia Lorca,7,1,8,2022,01-19,00:02
034 Vert Bois,0,16,16,2022,01-19,00:02
035 Malbosc,0,8,8,2022,01-19,00:02
036 Occitanie,1,31,32,2022,01-19,00:02
037 FacdesSciences,0,24,24,2022,01-19,00:02
038 Fac de Lettres,1,15,16,2022,01-19,00:02
039 Aiguelongue,7,1,8,2022,01-19,00:02
040 Jeu de Mail des Abb�s,8,0,8,2022,01-19,00:02
041 Eurom�decine,0,8,8,2022,01-19,00:02
042 Marie Caizergues,5,3,8,2022,01-19,00:02
043 Sabines,3,5,8,2022,01-19,00:02
044 Celleneuve,0,8,8,2022,01-19,00:02
045 Jardin de la Lironde,1,7,8,2022,01-19,00:02
046 P�re Soulas,7,1,8,2022,01-19,00:02
047 Place Viala,2,6,8,2022,01-19,00:02
048 H�tel du D�partement,0,8,8,2022,01-19,00:02
049 Tonnelles,1,7,8,2022,01-19,00:02
050 Parvis Jules Ferry - Gare Saint-Roch,0,8,8,2022,01-19,00:02
051 Pont de Lattes - Gare Saint-Roch,3,9,12,2022,01-19,00:02
053 Deux Ponts - Gare Saint-Roch,3,5,8,2022,01-19,00:02
054 Providence - Ovalie,4,4,8,2022,01-19,00:02
055 P�rols Etang de l'Or,23,45,68,2022,01-19,00:02
056 Albert 1er - Cath�drale,4,8,12,2022,01-19,00:02
057 Saint-Guilhem - Courreau,5,3,8,2022,01-19,00:02
059 Sud De France,0,8,8,2022,01-19,00:02
001 Rue Jules Ferry - Gare Saint-Roch,0,12,12,2022,01-19,00:13
002 Com�die,6,18,24,2022,01-19,00:13
003 Esplanade,9,23,32,2022,01-19,00:13
004 H�tel de Ville,16,0,16,2022,01-19,00:13
005 Corum,9,3,12,2022,01-19,00:13
006 Place Albert 1er - St Charles,21,10,31,2022,01-19,00:13
007 Foch,2,6,8,2022,01-19,00:13
008 Halles Castellane,0,12,12,2022,01-19,00:13
009 Observatoire,7,1,8,2022,01-19,00:13
010 Rondelet,2,14,16,2022,01-19,00:13
011 Plan Cabanes,9,3,12,2022,01-19,00:13
012 Boutonnet,1,11,12,2022,01-19,00:13
013 Emile Combes,4,4,8,2022,01-19,00:13
014 Beaux-Arts,3,5,8,2022,01-19,00:13
015 Les Aubes,4,4,8,2022,01-19,00:13
016 Antigone centre,16,0,16,2022,01-19,00:13
017 M�diath�que Emile Zola,12,4,16,2022,01-19,00:13
018 Nombre d'Or,16,0,16,2022,01-19,00:13
019 Louis Blanc,8,8,16,2022,01-19,00:13
020 Gambetta,4,4,8,2022,01-19,00:13
021 Port Marianne,16,0,16,2022,01-19,00:13
022 Clemenceau,3,9,12,2022,01-19,00:13
023 Les Arceaux,5,11,16,2022,01-19,00:13
024 Cit� Mion,3,5,8,2022,01-19,00:13
025 Nouveau Saint-Roch,4,4,8,2022,01-19,00:13
026 Renouvier,5,3,8,2022,01-19,00:13
027 Odysseum,2,6,8,2022,01-19,00:13
028 Saint-Denis,3,5,8,2022,01-19,00:13
029 Richter,12,4,16,2022,01-19,00:13
030 Charles Flahault,8,0,8,2022,01-19,00:13
031 Voltaire,3,5,8,2022,01-19,00:13
032 Pr�s d'Ar�nes,8,0,8,2022,01-19,00:13
033 Garcia Lorca,7,1,8,2022,01-19,00:13
034 Vert Bois,0,16,16,2022,01-19,00:13
035 Malbosc,1,7,8,2022,01-19,00:13
036 Occitanie,1,31,32,2022,01-19,00:13
037 FacdesSciences,0,24,24,2022,01-19,00:13
038 Fac de Lettres,1,15,16,2022,01-19,00:13
039 Aiguelongue,7,1,8,2022,01-19,00:13
040 Jeu de Mail des Abb�s,8,0,8,2022,01-19,00:13
041 Eurom�decine,0,8,8,2022,01-19,00:13
042 Marie Caizergues,5,3,8,2022,01-19,00:13
043 Sabines,3,5,8,2022,01-19,00:13
044 Celleneuve,0,8,8,2022,01-19,00:13
045 Jardin de la Lironde,1,7,8,2022,01-19,00:13
046 P�re Soulas,7,1,8,2022,01-19,00:13
047 Place Viala,2,6,8,2022,01-19,00:13
048 H�tel du D�partement,0,8,8,2022,01-19,00:13
049 Tonnelles,1,7,8,2022,01-19,00:13
050 Parvis Jules Ferry - Gare Saint-Roch,0,8,8,2022,01-19,00:13
051 Pont de Lattes - Gare Saint-Roch,3,9,12,2022,01-19,00:13
053 Deux Ponts - Gare Saint-Roch,3,5,8,2022,01-19,00:13
054 Providence - Ovalie,4,4,8,2022,01-19,00:13
055 P�rols Etang de l'Or,23,45,68,2022,01-19,00:13
056 Albert 1er - Cath�drale,4,8,12,2022,01-19,00:13
057 Saint-Guilhem - Courreau,5,3,8,2022,01-19,00:13
059 Sud De France,0,8,8,2022,01-19,00:13
001 Rue Jules Ferry - Gare Saint-Roch,0,12,12,2022,01-19,00:23
002 Com�die,6,18,24,2022,01-19,00:23
003 Esplanade,9,23,32,2022,01-19,00:23
004 H�tel de Ville,16,0,16,2022,01-19,00:23
005 Corum,9,3,12,2022,01-19,00:23
006 Place Albert 1er - St Charles,20,11,31,2022,01-19,00:23
007 Foch,2,6,8,2022,01-19,00:23
008 Halles Castellane,0,12,12,2022,01-19,00:23
009 Observatoire,7,1,8,2022,01-19,00:23
010 Rondelet,2,14,16,2022,01-19,00:23
011 Plan Cabanes,9,3,12,2022,01-19,00:23
012 Boutonnet,1,11,12,2022,01-19,00:23
013 Emile Combes,4,4,8,2022,01-19,00:23
014 Beaux-Arts,3,5,8,2022,01-19,00:23
015 Les Aubes,5,3,8,2022,01-19,00:23
016 Antigone centre,16,0,16,2022,01-19,00:23
017 M�diath�que Emile Zola,12,4,16,2022,01-19,00:23
018 Nombre d'Or,16,0,16,2022,01-19,00:23
019 Louis Blanc,8,8,16,2022,01-19,00:23
020 Gambetta,4,4,8,2022,01-19,00:23
021 Port Marianne,16,0,16,2022,01-19,00:23
022 Clemenceau,3,9,12,2022,01-19,00:23
023 Les Arceaux,5,11,16,2022,01-19,00:23
024 Cit� Mion,3,5,8,2022,01-19,00:23
025 Nouveau Saint-Roch,4,4,8,2022,01-19,00:23
026 Renouvier,5,3,8,2022,01-19,00:23
027 Odysseum,2,6,8,2022,01-19,00:23
028 Saint-Denis,3,5,8,2022,01-19,00:23
029 Richter,12,4,16,2022,01-19,00:23
030 Charles Flahault,8,0,8,2022,01-19,00:23
031 Voltaire,3,5,8,2022,01-19,00:23
032 Pr�s d'Ar�nes,8,0,8,2022,01-19,00:23
033 Garcia Lorca,7,1,8,2022,01-19,00:23
034 Vert Bois,0,16,16,2022,01-19,00:23
035 Malbosc,1,7,8,2022,01-19,00:23
036 Occitanie,1,31,32,2022,01-19,00:23
037 FacdesSciences,1,23,24,2022,01-19,00:23
038 Fac de Lettres,1,15,16,2022,01-19,00:23
039 Aiguelongue,7,1,8,2022,01-19,00:23
040 Jeu de Mail des Abb�s,8,0,8,2022,01-19,00:23
041 Eurom�decine,0,8,8,2022,01-19,00:23
042 Marie Caizergues,4,4,8,2022,01-19,00:23
043 Sabines,3,5,8,2022,01-19,00:23
044 Celleneuve,0,8,8,2022,01-19,00:23
045 Jardin de la Lironde,1,7,8,2022,01-19,00:23
046 P�re Soulas,7,1,8,2022,01-19,00:23
047 Place Viala,2,6,8,2022,01-19,00:23
048 H�tel du D�partement,0,8,8,2022,01-19,00:23
049 Tonnelles,1,7,8,2022,01-19,00:23
050 Parvis Jules Ferry - Gare Saint-Roch,0,8,8,2022,01-19,00:23
051 Pont de Lattes - Gare Saint-Roch,3,9,12,2022,01-19,00:23
053 Deux Ponts - Gare Saint-Roch,2,6,8,2022,01-19,00:23
054 Providence - Ovalie,4,4,8,2022,01-19,00:23
055 P�rols Etang de l'Or,23,45,68,2022,01-19,00:23
056 Albert 1er - Cath�drale,4,8,12,2022,01-19,00:23
057 Saint-Guilhem - Courreau,5,3,8,2022,01-19,00:23
059 Sud De France,0,8,8,2022,01-19,00:23
001 Rue Jules Ferry - Gare Saint-Roch,0,12,12,2022,01-19,00:33
002 Com�die,6,18,24,2022,01-19,00:33
003 Esplanade,8,24,32,2022,01-19,00:33
004 H�tel de Ville,16,0,16,2022,01-19,00:33
005 Corum,9,3,12,2022,01-19,00:33
006 Place Albert 1er - St Charles,20,11,31,2022,01-19,00:33
007 Foch,2,6,8,2022,01-19,00:33
008 Halles Castellane,0,12,12,2022,01-19,00:33
009 Observatoire,7,1,8,2022,01-19,00:33
010 Rondelet,2,14,16,2022,01-19,00:33
011 Plan Cabanes,10,2,12,2022,01-19,00:33
012 Boutonnet,1,11,12,2022,01-19,00:33
013 Emile Combes,4,4,8,2022,01-19,00:33
014 Beaux-Arts,3,5,8,2022,01-19,00:33
015 Les Aubes,5,3,8,2022,01-19,00:33
016 Antigone centre,16,0,16,2022,01-19,00:33
017 M�diath�que Emile Zola,12,4,16,2022,01-19,00:33
018 Nombre d'Or,16,0,16,2022,01-19,00:33
019 Louis Blanc,9,7,16,2022,01-19,00:33
020 Gambetta,4,4,8,2022,01-19,00:33
021 Port Marianne,16,0,16,2022,01-19,00:33
022 Clemenceau,3,9,12,2022,01-19,00:33
023 Les Arceaux,5,11,16,2022,01-19,00:33
024 Cit� Mion,3,5,8,2022,01-19,00:33
025 Nouveau Saint-Roch,4,4,8,2022,01-19,00:33
026 Renouvier,5,3,8,2022,01-19,00:33
027 Odysseum,2,6,8,2022,01-19,00:33
028 Saint-Denis,3,5,8,2022,01-19,00:33
029 Richter,12,4,16,2022,01-19,00:33
030 Charles Flahault,8,0,8,2022,01-19,00:33
031 Voltaire,3,5,8,2022,01-19,00:33
032 Pr�s d'Ar�nes,8,0,8,2022,01-19,00:33
033 Garcia Lorca,7,1,8,2022,01-19,00:33
034 Vert Bois,0,16,16,2022,01-19,00:33
035 Malbosc,1,7,8,2022,01-19,00:33
036 Occitanie,1,31,32,2022,01-19,00:33
037 FacdesSciences,1,23,24,2022,01-19,00:33
038 Fac de Lettres,1,15,16,2022,01-19,00:33
039 Aiguelongue,7,1,8,2022,01-19,00:33
040 Jeu de Mail des Abb�s,8,0,8,2022,01-19,00:33
041 Eurom�decine,0,8,8,2022,01-19,00:33
042 Marie Caizergues,4,4,8,2022,01-19,00:33
043 Sabines,3,5,8,2022,01-19,00:33
044 Celleneuve,0,8,8,2022,01-19,00:33
045 Jardin de la Lironde,1,7,8,2022,01-19,00:33
046 P�re Soulas,7,1,8,2022,01-19,00:33
047 Place Viala,2,6,8,2022,01-19,00:33
048 H�tel du D�partement,0,8,8,2022,01-19,00:33
049 Tonnelles,1,7,8,2022,01-19,00:33
050 Parvis Jules Ferry - Gare Saint-Roch,0,8,8,2022,01-19,00:33
051 Pont de Lattes - Gare Saint-Roch,3,9,12,2022,01-19,00:33
053 Deux Ponts - Gare Saint-Roch,2,6,8,2022,01-19,00:33
054 Providence - Ovalie,4,4,8,2022,01-19,00:33
055 P�rols Etang de l'Or,23,45,68,2022,01-19,00:33
056 Albert 1er - Cath�drale,4,8,12,2022,01-19,00:33
057 Saint-Guilhem - Courreau,5,3,8,2022,01-19,00:33
059 Sud De France,0,8,8,2022,01-19,00:33
001 Rue Jules Ferry - Gare Saint-Roch,0,12,12,2022,01-19,00:43
002 Com�die,6,18,24,2022,01-19,00:43
003 Esplanade,8,24,32,2022,01-19,00:43
004 H�tel de Ville,16,0,16,2022,01-19,00:43
005 Corum,9,3,12,2022,01-19,00:43
006 Place Albert 1er - St Charles,18,13,31,2022,01-19,00:43
007 Foch,2,6,8,2022,01-19,00:43
008 Halles Castellane,0,12,12,2022,01-19,00:43
009 Observatoire,7,1,8,2022,01-19,00:43
010 Rondelet,2,14,16,2022,01-19,00:43
011 Plan Cabanes,10,2,12,2022,01-19,00:43
012 Boutonnet,1,11,12,2022,01-19,00:43
013 Emile Combes,4,4,8,2022,01-19,00:43
014 Beaux-Arts,3,5,8,2022,01-19,00:43
015 Les Aubes,5,3,8,2022,01-19,00:43
016 Antigone centre,16,0,16,2022,01-19,00:43
017 M�diath�que Emile Zola,11,5,16,2022,01-19,00:43
018 Nombre d'Or,16,0,16,2022,01-19,00:43
019 Louis Blanc,9,7,16,2022,01-19,00:43
020 Gambetta,4,4,8,2022,01-19,00:43
021 Port Marianne,16,0,16,2022,01-19,00:43
022 Clemenceau,3,9,12,2022,01-19,00:43
023 Les Arceaux,5,11,16,2022,01-19,00:43
024 Cit� Mion,3,5,8,2022,01-19,00:43
025 Nouveau Saint-Roch,4,4,8,2022,01-19,00:43
026 Renouvier,4,4,8,2022,01-19,00:43
027 Odysseum,2,6,8,2022,01-19,00:43
028 Saint-Denis,3,5,8,2022,01-19,00:43
029 Richter,12,4,16,2022,01-19,00:43
030 Charles Flahault,8,0,8,2022,01-19,00:43
031 Voltaire,3,5,8,2022,01-19,00:43
032 Pr�s d'Ar�nes,8,0,8,2022,01-19,00:43
033 Garcia Lorca,7,1,8,2022,01-19,00:43
034 Vert Bois,0,16,16,2022,01-19,00:43
035 Malbosc,1,7,8,2022,01-19,00:43
036 Occitanie,1,31,32,2022,01-19,00:43
037 FacdesSciences,1,23,24,2022,01-19,00:43
038 Fac de Lettres,1,15,16,2022,01-19,00:43
039 Aiguelongue,7,1,8,2022,01-19,00:43
040 Jeu de Mail des Abb�s,8,0,8,2022,01-19,00:43
041 Eurom�decine,0,8,8,2022,01-19,00:43
042 Marie Caizergues,4,4,8,2022,01-19,00:43
043 Sabines,3,5,8,2022,01-19,00:43
044 Celleneuve,0,8,8,2022,01-19,00:43
045 Jardin de la Lironde,1,7,8,2022,01-19,00:43
046 P�re Soulas,7,1,8,2022,01-19,00:43
047 Place Viala,2,6,8,2022,01-19,00:43
048 H�tel du D�partement,0,8,8,2022,01-19,00:43
049 Tonnelles,1,7,8,2022,01-19,00:43
050 Parvis Jules Ferry - Gare Saint-Roch,0,8,8,2022,01-19,00:43
051 Pont de Lattes - Gare Saint-Roch,3,9,12,2022,01-19,00:43
053 Deux Ponts - Gare Saint-Roch,2,6,8,2022,01-19,00:43
054 Providence - Ovalie,4,4,8,2022,01-19,00:43
055 P�rols Etang de l'Or,23,45,68,2022,01-19,00:43
056 Albert 1er - Cath�drale,4,8,12,2022,01-19,00:43
057 Saint-Guilhem - Courreau,5,3,8,2022,01-19,00:43
059 Sud De France,0,8,8,2022,01-19,00:43
001 Rue Jules Ferry - Gare Saint-Roch,0,12,12,2022,01-19,00:53
002 Com�die,6,18,24,2022,01-19,00:53
003 Esplanade,7,25,32,2022,01-19,00:53
004 H�tel de Ville,16,0,16,2022,01-19,00:53
005 Corum,9,3,12,2022,01-19,00:53
006 Place Albert 1er - St Charles,18,13,31,2022,01-19,00:53
007 Foch,2,6,8,2022,01-19,00:53
008 Halles Castellane,0,12,12,2022,01-19,00:53
009 Observatoire,7,1,8,2022,01-19,00:53
010 Rondelet,2,14,16,2022,01-19,00:53
011 Plan Cabanes,10,2,12,2022,01-19,00:53
012 Boutonnet,3,9,12,2022,01-19,00:53
013 Emile Combes,4,4,8,2022,01-19,00:53
014 Beaux-Arts,3,5,8,2022,01-19,00:53
015 Les Aubes,5,3,8,2022,01-19,00:53
016 Antigone centre,16,0,16,2022,01-19,00:53
017 M�diath�que Emile Zola,10,6,16,2022,01-19,00:53
018 Nombre d'Or,16,0,16,2022,01-19,00:53
019 Louis Blanc,8,8,16,2022,01-19,00:53
020 Gambetta,4,4,8,2022,01-19,00:53
021 Port Marianne,16,0,16,2022,01-19,00:53
022 Clemenceau,3,9,12,2022,01-19,00:53
023 Les Arceaux,5,11,16,2022,01-19,00:53
024 Cit� Mion,3,5,8,2022,01-19,00:53
025 Nouveau Saint-Roch,4,4,8,2022,01-19,00:53
026 Renouvier,4,4,8,2022,01-19,00:53
027 Odysseum,2,6,8,2022,01-19,00:53
028 Saint-Denis,3,5,8,2022,01-19,00:53
029 Richter,12,4,16,2022,01-19,00:53
030 Charles Flahault,8,0,8,2022,01-19,00:53
031 Voltaire,3,5,8,2022,01-19,00:53
032 Pr�s d'Ar�nes,8,0,8,2022,01-19,00:53
033 Garcia Lorca,8,0,8,2022,01-19,00:53
034 Vert Bois,0,16,16,2022,01-19,00:53
035 Malbosc,1,7,8,2022,01-19,00:53
036 Occitanie,1,31,32,2022,01-19,00:53
037 FacdesSciences,1,23,24,2022,01-19,00:53
038 Fac de Lettres,1,15,16,2022,01-19,00:53
039 Aiguelongue,7,1,8,2022,01-19,00:53
040 Jeu de Mail des Abb�s,8,0,8,2022,01-19,00:53
041 Eurom�decine,0,8,8,2022,01-19,00:53
042 Marie Caizergues,4,4,8,2022,01-19,00:53
043 Sabines,3,5,8,2022,01-19,00:53
044 Celleneuve,0,8,8,2022,01-19,00:53
045 Jardin de la Lironde,1,7,8,2022,01-19,00:53
046 P�re Soulas,7,1,8,2022,01-19,00:53
047 Place Viala,2,6,8,2022,01-19,00:53
048 H�tel du D�partement,0,8,8,2022,01-19,00:53
049 Tonnelles,1,7,8,2022,01-19,00:53
050 Parvis Jules Ferry - Gare Saint-Roch,0,8,8,2022,01-19,00:53
051 Pont de Lattes - Gare Saint-Roch,3,9,12,2022,01-19,00:53
053 Deux Ponts - Gare Saint-Roch,2,6,8,2022,01-19,00:53
054 Providence - Ovalie,4,4,8,2022,01-19,00:53
055 P�rols Etang de l'Or,23,45,68,2022,01-19,00:53
056 Albert 1er - Cath�drale,4,8,12,2022,01-19,00:53
057 Saint-Guilhem - Courreau,5,3,8,2022,01-19,00:53
059 Sud De France,0,8,8,2022,01-19,00:53
001 Rue Jules Ferry - Gare Saint-Roch,0,12,12,2022,01-19,01:03
002 Com�die,6,18,24,2022,01-19,01:03
003 Esplanade,7,25,32,2022,01-19,01:03
004 H�tel de Ville,16,0,16,2022,01-19,01:03
005 Corum,9,3,12,2022,01-19,01:03
006 Place Albert 1er - St Charles,18,13,31,2022,01-19,01:03
007 Foch,2,6,8,2022,01-19,01:03
008 Halles Castellane,0,12,12,2022,01-19,01:03
009 Observatoire,7,1,8,2022,01-19,01:03
010 Rondelet,2,14,16,2022,01-19,01:03
011 Plan Cabanes,10,2,12,2022,01-19,01:03
012 Boutonnet,3,9,12,2022,01-19,01:03
013 Emile Combes,4,4,8,2022,01-19,01:03
014 Beaux-Arts,3,5,8,2022,01-19,01:03
015 Les Aubes,5,3,8,2022,01-19,01:03
016 Antigone centre,16,0,16,2022,01-19,01:03
017 M�diath�que Emile Zola,10,6,16,2022,01-19,01:03
018 Nombre d'Or,16,0,16,2022,01-19,01:03
019 Louis Blanc,8,8,16,2022,01-19,01:03
020 Gambetta,4,4,8,2022,01-19,01:03
021 Port Marianne,16,0,16,2022,01-19,01:03
022 Clemenceau,3,9,12,2022,01-19,01:03
023 Les Arceaux,5,11,16,2022,01-19,01:03
024 Cit� Mion,3,5,8,2022,01-19,01:03
025 Nouveau Saint-Roch,4,4,8,2022,01-19,01:03
026 Renouvier,4,4,8,2022,01-19,01:03
027 Odysseum,2,6,8,2022,01-19,01:03
028 Saint-Denis,4,4,8,2022,01-19,01:03
029 Richter,12,4,16,2022,01-19,01:03
030 Charles Flahault,8,0,8,2022,01-19,01:03
031 Voltaire,3,5,8,2022,01-19,01:03
032 Pr�s d'Ar�nes,8,0,8,2022,01-19,01:03
033 Garcia Lorca,8,0,8,2022,01-19,01:03
034 Vert Bois,0,16,16,2022,01-19,01:03
035 Malbosc,1,7,8,2022,01-19,01:03
036 Occitanie,1,31,32,2022,01-19,01:03
037 FacdesSciences,1,23,24,2022,01-19,01:03
038 Fac de Lettres,1,15,16,2022,01-19,01:03
039 Aiguelongue,8,0,8,2022,01-19,01:03
040 Jeu de Mail des Abb�s,8,0,8,2022,01-19,01:03
041 Eurom�decine,0,8,8,2022,01-19,01:03
042 Marie Caizergues,4,4,8,2022,01-19,01:03
043 Sabines,3,5,8,2022,01-19,01:03
044 Celleneuve,0,8,8,2022,01-19,01:03
045 Jardin de la Lironde,1,7,8,2022,01-19,01:03
046 P�re Soulas,7,1,8,2022,01-19,01:03
047 Place Viala,2,6,8,2022,01-19,01:03
048 H�tel du D�partement,0,8,8,2022,01-19,01:03
049 Tonnelles,1,7,8,2022,01-19,01:03
050 Parvis Jules Ferry - Gare Saint-Roch,0,8,8,2022,01-19,01:03
051 Pont de Lattes - Gare Saint-Roch,3,9,12,2022,01-19,01:03
053 Deux Ponts - Gare Saint-Roch,2,6,8,2022,01-19,01:03
054 Providence - Ovalie,4,4,8,2022,01-19,01:03
055 P�rols Etang de l'Or,23,45,68,2022,01-19,01:03
056 Albert 1er - Cath�drale,4,8,12,2022,01-19,01:03
057 Saint-Guilhem - Courreau,5,3,8,2022,01-19,01:03
059 Sud De France,0,8,8,2022,01-19,01:03
001 Rue Jules Ferry - Gare Saint-Roch,0,12,12,2022,01-19,01:14
002 Com�die,5,19,24,2022,01-19,01:14
003 Esplanade,5,27,32,2022,01-19,01:14
004 H�tel de Ville,16,0,16,2022,01-19,01:14
005 Corum,9,3,12,2022,01-19,01:14
006 Place Albert 1er - St Charles,18,13,31,2022,01-19,01:14
007 Foch,2,6,8,2022,01-19,01:14
008 Halles Castellane,0,12,12,2022,01-19,01:14
009 Observatoire,7,1,8,2022,01-19,01:14
010 Rondelet,2,14,16,2022,01-19,01:14
011 Plan Cabanes,10,2,12,2022,01-19,01:14
012 Boutonnet,3,9,12,2022,01-19,01:14
013 Emile Combes,4,4,8,2022,01-19,01:14
014 Beaux-Arts,3,5,8,2022,01-19,01:14
015 Les Aubes,5,3,8,2022,01-19,01:14
016 Antigone centre,16,0,16,2022,01-19,01:14
017 M�diath�que Emile Zola,10,6,16,2022,01-19,01:14
018 Nombre d'Or,16,0,16,2022,01-19,01:14
019 Louis Blanc,8,8,16,2022,01-19,01:14
020 Gambetta,4,4,8,2022,01-19,01:14
021 Port Marianne,16,0,16,2022,01-19,01:14
022 Clemenceau,3,9,12,2022,01-19,01:14
023 Les Arceaux,5,11,16,2022,01-19,01:14
024 Cit� Mion,3,5,8,2022,01-19,01:14
025 Nouveau Saint-Roch,4,4,8,2022,01-19,01:14
026 Renouvier,4,4,8,2022,01-19,01:14
027 Odysseum,2,6,8,2022,01-19,01:14
028 Saint-Denis,4,4,8,2022,01-19,01:14
029 Richter,12,4,16,2022,01-19,01:14
030 Charles Flahault,8,0,8,2022,01-19,01:14
031 Voltaire,3,5,8,2022,01-19,01:14
032 Pr�s d'Ar�nes,8,0,8,2022,01-19,01:14
033 Garcia Lorca,8,0,8,2022,01-19,01:14
034 Vert Bois,0,16,16,2022,01-19,01:14
035 Malbosc,1,7,8,2022,01-19,01:14
036 Occitanie,1,31,32,2022,01-19,01:14
037 FacdesSciences,1,23,24,2022,01-19,01:14
038 Fac de Lettres,1,15,16,2022,01-19,01:14
039 Aiguelongue,8,0,8,2022,01-19,01:14
040 Jeu de Mail des Abb�s,8,0,8,2022,01-19,01:14
041 Eurom�decine,0,8,8,2022,01-19,01:14
042 Marie Caizergues,4,4,8,2022,01-19,01:14
043 Sabines,3,5,8,2022,01-19,01:14
044 Celleneuve,0,8,8,2022,01-19,01:14
045 Jardin de la Lironde,1,7,8,2022,01-19,01:14
046 P�re Soulas,7,1,8,2022,01-19,01:14
047 Place Viala,2,6,8,2022,01-19,01:14
048 H�tel du D�partement,0,8,8,2022,01-19,01:14
049 Tonnelles,1,7,8,2022,01-19,01:14
050 Parvis Jules Ferry - Gare Saint-Roch,0,8,8,2022,01-19,01:14
051 Pont de Lattes - Gare Saint-Roch,3,9,12,2022,01-19,01:14
053 Deux Ponts - Gare Saint-Roch,2,6,8,2022,01-19,01:14
054 Providence - Ovalie,4,4,8,2022,01-19,01:14
055 P�rols Etang de l'Or,23,45,68,2022,01-19,01:14
056 Albert 1er - Cath�drale,4,8,12,2022,01-19,01:14
057 Saint-Guilhem - Courreau,5,3,8,2022,01-19,01:14
059 Sud De France,0,8,8,2022,01-19,01:14
001 Rue Jules Ferry - Gare Saint-Roch,0,12,12,2022,01-19,01:24
002 Com�die,5,19,24,2022,01-19,01:24
003 Esplanade,5,27,32,2022,01-19,01:24
004 H�tel de Ville,16,0,16,2022,01-19,01:24
005 Corum,9,3,12,2022,01-19,01:24
006 Place Albert 1er - St Charles,18,13,31,2022,01-19,01:24
007 Foch,2,6,8,2022,01-19,01:24
008 Halles Castellane,0,12,12,2022,01-19,01:24
009 Observatoire,7,1,8,2022,01-19,01:24
010 Rondelet,2,14,16,2022,01-19,01:24
011 Plan Cabanes,10,2,12,2022,01-19,01:24
012 Boutonnet,3,9,12,2022,01-19,01:24
013 Emile Combes,4,4,8,2022,01-19,01:24
014 Beaux-Arts,3,5,8,2022,01-19,01:24
015 Les Aubes,5,3,8,2022,01-19,01:24
016 Antigone centre,16,0,16,2022,01-19,01:24
017 M�diath�que Emile Zola,11,5,16,2022,01-19,01:24
018 Nombre d'Or,15,1,16,2022,01-19,01:24
019 Louis Blanc,8,8,16,2022,01-19,01:24
020 Gambetta,4,4,8,2022,01-19,01:24
021 Port Marianne,16,0,16,2022,01-19,01:24
022 Clemenceau,3,9,12,2022,01-19,01:24
023 Les Arceaux,5,11,16,2022,01-19,01:24
024 Cit� Mion,3,5,8,2022,01-19,01:24
025 Nouveau Saint-Roch,4,4,8,2022,01-19,01:24
026 Renouvier,4,4,8,2022,01-19,01:24
027 Odysseum,2,6,8,2022,01-19,01:24
028 Saint-Denis,4,4,8,2022,01-19,01:24
029 Richter,14,2,16,2022,01-19,01:24
030 Charles Flahault,8,0,8,2022,01-19,01:24
031 Voltaire,3,5,8,2022,01-19,01:24
032 Pr�s d'Ar�nes,8,0,8,2022,01-19,01:24
033 Garcia Lorca,8,0,8,2022,01-19,01:24
034 Vert Bois,0,16,16,2022,01-19,01:24
035 Malbosc,2,6,8,2022,01-19,01:24
036 Occitanie,1,31,32,2022,01-19,01:24
037 FacdesSciences,1,23,24,2022,01-19,01:24
038 Fac de Lettres,1,15,16,2022,01-19,01:24
039 Aiguelongue,8,0,8,2022,01-19,01:24
040 Jeu de Mail des Abb�s,8,0,8,2022,01-19,01:24
041 Eurom�decine,0,8,8,2022,01-19,01:24
042 Marie Caizergues,4,4,8,2022,01-19,01:24
043 Sabines,3,5,8,2022,01-19,01:24
044 Celleneuve,0,8,8,2022,01-19,01:24
045 Jardin de la Lironde,1,7,8,2022,01-19,01:24
046 P�re Soulas,7,1,8,2022,01-19,01:24
047 Place Viala,2,6,8,2022,01-19,01:24
048 H�tel du D�partement,0,8,8,2022,01-19,01:24
049 Tonnelles,1,7,8,2022,01-19,01:24
050 Parvis Jules Ferry - Gare Saint-Roch,0,8,8,2022,01-19,01:24
051 Pont de Lattes - Gare Saint-Roch,3,9,12,2022,01-19,01:24
053 Deux Ponts - Gare Saint-Roch,2,6,8,2022,01-19,01:24
054 Providence - Ovalie,4,4,8,2022,01-19,01:24
055 P�rols Etang de l'Or,23,45,68,2022,01-19,01:24
056 Albert 1er - Cath�drale,4,8,12,2022,01-19,01:24
057 Saint-Guilhem - Courreau,5,3,8,2022,01-19,01:24
059 Sud De France,0,8,8,2022,01-19,01:24
001 Rue Jules Ferry - Gare Saint-Roch,0,12,12,2022,01-19,01:34
002 Com�die,5,19,24,2022,01-19,01:34
003 Esplanade,5,27,32,2022,01-19,01:34
004 H�tel de Ville,16,0,16,2022,01-19,01:34
005 Corum,9,3,12,2022,01-19,01:34
006 Place Albert 1er - St Charles,18,13,31,2022,01-19,01:34
007 Foch,2,6,8,2022,01-19,01:34
008 Halles Castellane,0,12,12,2022,01-19,01:34
009 Observatoire,7,1,8,2022,01-19,01:34
010 Rondelet,2,14,16,2022,01-19,01:34
011 Plan Cabanes,10,2,12,2022,01-19,01:34
012 Boutonnet,3,9,12,2022,01-19,01:34
013 Emile Combes,4,4,8,2022,01-19,01:34
014 Beaux-Arts,3,5,8,2022,01-19,01:34
015 Les Aubes,5,3,8,2022,01-19,01:34
016 Antigone centre,16,0,16,2022,01-19,01:34
017 M�diath�que Emile Zola,11,5,16,2022,01-19,01:34
018 Nombre d'Or,15,1,16,2022,01-19,01:34
019 Louis Blanc,8,8,16,2022,01-19,01:34
020 Gambetta,4,4,8,2022,01-19,01:34
021 Port Marianne,16,0,16,2022,01-19,01:34
022 Clemenceau,3,9,12,2022,01-19,01:34
023 Les Arceaux,5,11,16,2022,01-19,01:34
024 Cit� Mion,3,5,8,2022,01-19,01:34
025 Nouveau Saint-Roch,4,4,8,2022,01-19,01:34
026 Renouvier,4,4,8,2022,01-19,01:34
027 Odysseum,2,6,8,2022,01-19,01:34
028 Saint-Denis,4,4,8,2022,01-19,01:34
029 Richter,14,2,16,2022,01-19,01:34
030 Charles Flahault,8,0,8,2022,01-19,01:34
031 Voltaire,3,5,8,2022,01-19,01:34
032 Pr�s d'Ar�nes,8,0,8,2022,01-19,01:34
033 Garcia Lorca,8,0,8,2022,01-19,01:34
034 Vert Bois,0,16,16,2022,01-19,01:34
035 Malbosc,2,6,8,2022,01-19,01:34
036 Occitanie,2,30,32,2022,01-19,01:34
037 FacdesSciences,1,23,24,2022,01-19,01:34
038 Fac de Lettres,1,15,16,2022,01-19,01:34
039 Aiguelongue,8,0,8,2022,01-19,01:34
040 Jeu de Mail des Abb�s,8,0,8,2022,01-19,01:34
041 Eurom�decine,0,8,8,2022,01-19,01:34
042 Marie Caizergues,4,4,8,2022,01-19,01:34
043 Sabines,3,5,8,2022,01-19,01:34
044 Celleneuve,0,8,8,2022,01-19,01:34
045 Jardin de la Lironde,1,7,8,2022,01-19,01:34
046 P�re Soulas,7,1,8,2022,01-19,01:34
047 Place Viala,2,6,8,2022,01-19,01:34
048 H�tel du D�partement,0,8,8,2022,01-19,01:34
049 Tonnelles,1,7,8,2022,01-19,01:34
050 Parvis Jules Ferry - Gare Saint-Roch,0,8,8,2022,01-19,01:34
051 Pont de Lattes - Gare Saint-Roch,3,9,12,2022,01-19,01:34
053 Deux Ponts - Gare Saint-Roch,2,6,8,2022,01-19,01:34
054 Providence - Ovalie,4,4,8,2022,01-19,01:34
055 P�rols Etang de l'Or,23,45,68,2022,01-19,01:34
056 Albert 1er - Cath�drale,4,8,12,2022,01-19,01:34
057 Saint-Guilhem - Courreau,5,3,8,2022,01-19,01:34
059 Sud De France,0,8,8,2022,01-19,01:34
001 Rue Jules Ferry - Gare Saint-Roch,0,12,12,2022,01-19,01:44
002 Com�die,5,19,24,2022,01-19,01:44
003 Esplanade,3,29,32,2022,01-19,01:44
004 H�tel de Ville,16,0,16,2022,01-19,01:44
005 Corum,9,3,12,2022,01-19,01:44
006 Place Albert 1er - St Charles,18,13,31,2022,01-19,01:44
007 Foch,2,6,8,2022,01-19,01:44
008 Halles Castellane,0,12,12,2022,01-19,01:44
009 Observatoire,7,1,8,2022,01-19,01:44
010 Rondelet,2,14,16,2022,01-19,01:44
011 Plan Cabanes,10,2,12,2022,01-19,01:44
012 Boutonnet,3,9,12,2022,01-19,01:44
013 Emile Combes,4,4,8,2022,01-19,01:44
014 Beaux-Arts,3,5,8,2022,01-19,01:44
015 Les Aubes,5,3,8,2022,01-19,01:44
016 Antigone centre,16,0,16,2022,01-19,01:44
017 M�diath�que Emile Zola,11,5,16,2022,01-19,01:44
018 Nombre d'Or,15,1,16,2022,01-19,01:44
019 Louis Blanc,8,8,16,2022,01-19,01:44
020 Gambetta,4,4,8,2022,01-19,01:44
021 Port Marianne,16,0,16,2022,01-19,01:44
022 Clemenceau,3,9,12,2022,01-19,01:44
023 Les Arceaux,5,11,16,2022,01-19,01:44
024 Cit� Mion,3,5,8,2022,01-19,01:44
025 Nouveau Saint-Roch,4,4,8,2022,01-19,01:44
026 Renouvier,4,4,8,2022,01-19,01:44
027 Odysseum,2,6,8,2022,01-19,01:44
028 Saint-Denis,4,4,8,2022,01-19,01:44
029 Richter,14,2,16,2022,01-19,01:44
030 Charles Flahault,8,0,8,2022,01-19,01:44
031 Voltaire,3,5,8,2022,01-19,01:44
032 Pr�s d'Ar�nes,8,0,8,2022,01-19,01:44
033 Garcia Lorca,8,0,8,2022,01-19,01:44
034 Vert Bois,0,16,16,2022,01-19,01:44
035 Malbosc,2,6,8,2022,01-19,01:44
036 Occitanie,2,30,32,2022,01-19,01:44
037 FacdesSciences,1,23,24,2022,01-19,01:44
038 Fac de Lettres,1,15,16,2022,01-19,01:44
039 Aiguelongue,8,0,8,2022,01-19,01:44
040 Jeu de Mail des Abb�s,8,0,8,2022,01-19,01:44
041 Eurom�decine,0,8,8,2022,01-19,01:44
042 Marie Caizergues,4,4,8,2022,01-19,01:44
043 Sabines,3,5,8,2022,01-19,01:44
044 Celleneuve,0,8,8,2022,01-19,01:44
045 Jardin de la Lironde,1,7,8,2022,01-19,01:44
046 P�re Soulas,7,1,8,2022,01-19,01:44
047 Place Viala,2,6,8,2022,01-19,01:44
048 H�tel du D�partement,0,8,8,2022,01-19,01:44
049 Tonnelles,1,7,8,2022,01-19,01:44
050 Parvis Jules Ferry - Gare Saint-Roch,0,8,8,2022,01-19,01:44
051 Pont de Lattes - Gare Saint-Roch,3,9,12,2022,01-19,01:44
053 Deux Ponts - Gare Saint-Roch,2,6,8,2022,01-19,01:44
054 Providence - Ovalie,4,4,8,2022,01-19,01:44
055 P�rols Etang de l'Or,23,45,68,2022,01-19,01:44
056 Albert 1er - Cath�drale,4,8,12,2022,01-19,01:44
057 Saint-Guilhem - Courreau,5,3,8,2022,01-19,01:44
059 Sud De France,0,8,8,2022,01-19,01:44
001 Rue Jules Ferry - Gare Saint-Roch,0,12,12,2022,01-19,01:54
002 Com�die,5,19,24,2022,01-19,01:54
003 Esplanade,0,32,32,2022,01-19,01:54
004 H�tel de Ville,16,0,16,2022,01-19,01:54
005 Corum,10,2,12,2022,01-19,01:54
006 Place Albert 1er - St Charles,19,12,31,2022,01-19,01:54
007 Foch,2,6,8,2022,01-19,01:54
008 Halles Castellane,0,12,12,2022,01-19,01:54
009 Observatoire,7,1,8,2022,01-19,01:54
010 Rondelet,2,14,16,2022,01-19,01:54
011 Plan Cabanes,10,2,12,2022,01-19,01:54
012 Boutonnet,3,9,12,2022,01-19,01:54
013 Emile Combes,4,4,8,2022,01-19,01:54
014 Beaux-Arts,3,5,8,2022,01-19,01:54
015 Les Aubes,5,3,8,2022,01-19,01:54
016 Antigone centre,16,0,16,2022,01-19,01:54
017 M�diath�que Emile Zola,11,5,16,2022,01-19,01:54
018 Nombre d'Or,15,1,16,2022,01-19,01:54
019 Louis Blanc,8,8,16,2022,01-19,01:54
020 Gambetta,4,4,8,2022,01-19,01:54
021 Port Marianne,16,0,16,2022,01-19,01:54
022 Clemenceau,3,9,12,2022,01-19,01:54
023 Les Arceaux,6,10,16,2022,01-19,01:54
024 Cit� Mion,3,5,8,2022,01-19,01:54
025 Nouveau Saint-Roch,4,4,8,2022,01-19,01:54
026 Renouvier,4,4,8,2022,01-19,01:54
027 Odysseum,2,6,8,2022,01-19,01:54
028 Saint-Denis,4,4,8,2022,01-19,01:54
029 Richter,14,2,16,2022,01-19,01:54
030 Charles Flahault,8,0,8,2022,01-19,01:54
031 Voltaire,3,5,8,2022,01-19,01:54
032 Pr�s d'Ar�nes,8,0,8,2022,01-19,01:54
033 Garcia Lorca,8,0,8,2022,01-19,01:54
034 Vert Bois,0,16,16,2022,01-19,01:54
035 Malbosc,2,6,8,2022,01-19,01:54
036 Occitanie,2,30,32,2022,01-19,01:54
037 FacdesSciences,1,23,24,2022,01-19,01:54
038 Fac de Lettres,1,15,16,2022,01-19,01:54
039 Aiguelongue,8,0,8,2022,01-19,01:54
040 Jeu de Mail des Abb�s,8,0,8,2022,01-19,01:54
041 Eurom�decine,0,8,8,2022,01-19,01:54
042 Marie Caizergues,4,4,8,2022,01-19,01:54
043 Sabines,3,5,8,2022,01-19,01:54
044 Celleneuve,1,7,8,2022,01-19,01:54
045 Jardin de la Lironde,1,7,8,2022,01-19,01:54
046 P�re Soulas,7,1,8,2022,01-19,01:54
047 Place Viala,2,6,8,2022,01-19,01:54
048 H�tel du D�partement,0,8,8,2022,01-19,01:54
049 Tonnelles,1,7,8,2022,01-19,01:54
050 Parvis Jules Ferry - Gare Saint-Roch,0,8,8,2022,01-19,01:54
051 Pont de Lattes - Gare Saint-Roch,3,9,12,2022,01-19,01:54
053 Deux Ponts - Gare Saint-Roch,2,6,8,2022,01-19,01:54
054 Providence - Ovalie,4,4,8,2022,01-19,01:54
055 P�rols Etang de l'Or,23,45,68,2022,01-19,01:54
056 Albert 1er - Cath�drale,4,8,12,2022,01-19,01:54
057 Saint-Guilhem - Courreau,5,3,8,2022,01-19,01:54
059 Sud De France,0,8,8,2022,01-19,01:54
001 Rue Jules Ferry - Gare Saint-Roch,0,12,12,2022,01-19,02:04
002 Com�die,5,19,24,2022,01-19,02:04
003 Esplanade,0,32,32,2022,01-19,02:04
004 H�tel de Ville,16,0,16,2022,01-19,02:04
005 Corum,10,2,12,2022,01-19,02:04
006 Place Albert 1er - St Charles,20,11,31,2022,01-19,02:04
007 Foch,2,6,8,2022,01-19,02:04
008 Halles Castellane,0,12,12,2022,01-19,02:04
009 Observatoire,7,1,8,2022,01-19,02:04
010 Rondelet,2,14,16,2022,01-19,02:04
011 Plan Cabanes,10,2,12,2022,01-19,02:04
012 Boutonnet,3,9,12,2022,01-19,02:04
013 Emile Combes,4,4,8,2022,01-19,02:04
014 Beaux-Arts,3,5,8,2022,01-19,02:04
015 Les Aubes,5,3,8,2022,01-19,02:04
016 Antigone centre,16,0,16,2022,01-19,02:04
017 M�diath�que Emile Zola,11,5,16,2022,01-19,02:04
018 Nombre d'Or,15,1,16,2022,01-19,02:04
019 Louis Blanc,8,8,16,2022,01-19,02:04
020 Gambetta,4,4,8,2022,01-19,02:04
021 Port Marianne,16,0,16,2022,01-19,02:04
022 Clemenceau,3,9,12,2022,01-19,02:04
023 Les Arceaux,6,10,16,2022,01-19,02:04
024 Cit� Mion,3,5,8,2022,01-19,02:04
025 Nouveau Saint-Roch,4,4,8,2022,01-19,02:04
026 Renouvier,4,4,8,2022,01-19,02:04
027 Odysseum,2,6,8,2022,01-19,02:04
028 Saint-Denis,4,4,8,2022,01-19,02:04
029 Richter,14,2,16,2022,01-19,02:04
030 Charles Flahault,8,0,8,2022,01-19,02:04
031 Voltaire,3,5,8,2022,01-19,02:04
032 Pr�s d'Ar�nes,8,0,8,2022,01-19,02:04
033 Garcia Lorca,8,0,8,2022,01-19,02:04
034 Vert Bois,0,16,16,2022,01-19,02:04
035 Malbosc,2,6,8,2022,01-19,02:04
036 Occitanie,2,30,32,2022,01-19,02:04
037 FacdesSciences,1,23,24,2022,01-19,02:04
038 Fac de Lettres,1,15,16,2022,01-19,02:04
039 Aiguelongue,8,0,8,2022,01-19,02:04
040 Jeu de Mail des Abb�s,8,0,8,2022,01-19,02:04
041 Eurom�decine,0,8,8,2022,01-19,02:04
042 Marie Caizergues,4,4,8,2022,01-19,02:04
043 Sabines,3,5,8,2022,01-19,02:04
044 Celleneuve,1,7,8,2022,01-19,02:04
045 Jardin de la Lironde,1,7,8,2022,01-19,02:04
046 P�re Soulas,7,1,8,2022,01-19,02:04
047 Place Viala,2,6,8,2022,01-19,02:04
048 H�tel du D�partement,0,8,8,2022,01-19,02:04
049 Tonnelles,1,7,8,2022,01-19,02:04
050 Parvis Jules Ferry - Gare Saint-Roch,0,8,8,2022,01-19,02:04
051 Pont de Lattes - Gare Saint-Roch,3,9,12,2022,01-19,02:04
053 Deux Ponts - Gare Saint-Roch,2,6,8,2022,01-19,02:04
054 Providence - Ovalie,4,4,8,2022,01-19,02:04
055 P�rols Etang de l'Or,23,45,68,2022,01-19,02:04
056 Albert 1er - Cath�drale,1,11,12,2022,01-19,02:04
057 Saint-Guilhem - Courreau,5,3,8,2022,01-19,02:04
059 Sud De France,0,8,8,2022,01-19,02:04
001 Rue Jules Ferry - Gare Saint-Roch,0,12,12,2022,01-19,02:15
002 Com�die,5,19,24,2022,01-19,02:15
003 Esplanade,0,32,32,2022,01-19,02:15
004 H�tel de Ville,16,0,16,2022,01-19,02:15
005 Corum,10,2,12,2022,01-19,02:15
006 Place Albert 1er - St Charles,20,11,31,2022,01-19,02:15
007 Foch,2,6,8,2022,01-19,02:15
008 Halles Castellane,0,12,12,2022,01-19,02:15
009 Observatoire,7,1,8,2022,01-19,02:15
010 Rondelet,2,14,16,2022,01-19,02:15
011 Plan Cabanes,11,1,12,2022,01-19,02:15
012 Boutonnet,3,9,12,2022,01-19,02:15
013 Emile Combes,4,4,8,2022,01-19,02:15
014 Beaux-Arts,3,5,8,2022,01-19,02:15
015 Les Aubes,5,3,8,2022,01-19,02:15
016 Antigone centre,16,0,16,2022,01-19,02:15
017 M�diath�que Emile Zola,11,5,16,2022,01-19,02:15
018 Nombre d'Or,15,1,16,2022,01-19,02:15
019 Louis Blanc,8,8,16,2022,01-19,02:15
020 Gambetta,4,4,8,2022,01-19,02:15
021 Port Marianne,16,0,16,2022,01-19,02:15
022 Clemenceau,3,9,12,2022,01-19,02:15
023 Les Arceaux,6,10,16,2022,01-19,02:15
024 Cit� Mion,3,5,8,2022,01-19,02:15
025 Nouveau Saint-Roch,4,4,8,2022,01-19,02:15
026 Renouvier,4,4,8,2022,01-19,02:15
027 Odysseum,4,4,8,2022,01-19,02:15
028 Saint-Denis,4,4,8,2022,01-19,02:15
029 Richter,14,2,16,2022,01-19,02:15
030 Charles Flahault,8,0,8,2022,01-19,02:15
031 Voltaire,3,5,8,2022,01-19,02:15
032 Pr�s d'Ar�nes,8,0,8,2022,01-19,02:15
033 Garcia Lorca,8,0,8,2022,01-19,02:15
034 Vert Bois,0,16,16,2022,01-19,02:15
035 Malbosc,2,6,8,2022,01-19,02:15
036 Occitanie,2,30,32,2022,01-19,02:15
037 FacdesSciences,1,23,24,2022,01-19,02:15
038 Fac de Lettres,1,15,16,2022,01-19,02:15
039 Aiguelongue,8,0,8,2022,01-19,02:15
040 Jeu de Mail des Abb�s,8,0,8,2022,01-19,02:15
041 Eurom�decine,0,8,8,2022,01-19,02:15
042 Marie Caizergues,4,4,8,2022,01-19,02:15
043 Sabines,3,5,8,2022,01-19,02:15
044 Celleneuve,1,7,8,2022,01-19,02:15
045 Jardin de la Lironde,1,7,8,2022,01-19,02:15
046 P�re Soulas,7,1,8,2022,01-19,02:15
047 Place Viala,2,6,8,2022,01-19,02:15
048 H�tel du D�partement,0,8,8,2022,01-19,02:15
049 Tonnelles,1,7,8,2022,01-19,02:15
050 Parvis Jules Ferry - Gare Saint-Roch,0,8,8,2022,01-19,02:15
051 Pont de Lattes - Gare Saint-Roch,3,9,12,2022,01-19,02:15
053 Deux Ponts - Gare Saint-Roch,2,6,8,2022,01-19,02:15
054 Providence - Ovalie,4,4,8,2022,01-19,02:15
055 P�rols Etang de l'Or,23,45,68,2022,01-19,02:15
056 Albert 1er - Cath�drale,1,11,12,2022,01-19,02:15
057 Saint-Guilhem - Courreau,5,3,8,2022,01-19,02:15
059 Sud De France,0,8,8,2022,01-19,02:15
001 Rue Jules Ferry - Gare Saint-Roch,0,12,12,2022,01-19,02:25
002 Com�die,5,19,24,2022,01-19,02:25
003 Esplanade,0,32,32,2022,01-19,02:25
004 H�tel de Ville,16,0,16,2022,01-19,02:25
005 Corum,10,2,12,2022,01-19,02:25
006 Place Albert 1er - St Charles,20,11,31,2022,01-19,02:25
007 Foch,2,6,8,2022,01-19,02:25
008 Halles Castellane,0,12,12,2022,01-19,02:25
009 Observatoire,7,1,8,2022,01-19,02:25
010 Rondelet,2,14,16,2022,01-19,02:25
011 Plan Cabanes,11,1,12,2022,01-19,02:25
012 Boutonnet,3,9,12,2022,01-19,02:25
013 Emile Combes,4,4,8,2022,01-19,02:25
014 Beaux-Arts,3,5,8,2022,01-19,02:25
015 Les Aubes,5,3,8,2022,01-19,02:25
016 Antigone centre,16,0,16,2022,01-19,02:25
017 M�diath�que Emile Zola,11,5,16,2022,01-19,02:25
018 Nombre d'Or,15,1,16,2022,01-19,02:25
019 Louis Blanc,8,8,16,2022,01-19,02:25
020 Gambetta,4,4,8,2022,01-19,02:25
021 Port Marianne,16,0,16,2022,01-19,02:25
022 Clemenceau,3,9,12,2022,01-19,02:25
023 Les Arceaux,6,10,16,2022,01-19,02:25
024 Cit� Mion,3,5,8,2022,01-19,02:25
025 Nouveau Saint-Roch,4,4,8,2022,01-19,02:25
026 Renouvier,4,4,8,2022,01-19,02:25
027 Odysseum,4,4,8,2022,01-19,02:25
028 Saint-Denis,4,4,8,2022,01-19,02:25
029 Richter,14,2,16,2022,01-19,02:25
030 Charles Flahault,8,0,8,2022,01-19,02:25
031 Voltaire,3,5,8,2022,01-19,02:25
032 Pr�s d'Ar�nes,8,0,8,2022,01-19,02:25
033 Garcia Lorca,8,0,8,2022,01-19,02:25
034 Vert Bois,0,16,16,2022,01-19,02:25
035 Malbosc,2,6,8,2022,01-19,02:25
036 Occitanie,5,27,32,2022,01-19,02:25
037 FacdesSciences,1,23,24,2022,01-19,02:25
038 Fac de Lettres,1,15,16,2022,01-19,02:25
039 Aiguelongue,8,0,8,2022,01-19,02:25
040 Jeu de Mail des Abb�s,8,0,8,2022,01-19,02:25
041 Eurom�decine,0,8,8,2022,01-19,02:25
042 Marie Caizergues,4,4,8,2022,01-19,02:25
043 Sabines,3,5,8,2022,01-19,02:25
044 Celleneuve,1,7,8,2022,01-19,02:25
045 Jardin de la Lironde,1,7,8,2022,01-19,02:25
046 P�re Soulas,7,1,8,2022,01-19,02:25
047 Place Viala,2,6,8,2022,01-19,02:25
048 H�tel du D�partement,0,8,8,2022,01-19,02:25
049 Tonnelles,1,7,8,2022,01-19,02:25
050 Parvis Jules Ferry - Gare Saint-Roch,0,8,8,2022,01-19,02:25
051 Pont de Lattes - Gare Saint-Roch,3,9,12,2022,01-19,02:25
053 Deux Ponts - Gare Saint-Roch,2,6,8,2022,01-19,02:25
054 Providence - Ovalie,4,4,8,2022,01-19,02:25
055 P�rols Etang de l'Or,23,45,68,2022,01-19,02:25
056 Albert 1er - Cath�drale,1,11,12,2022,01-19,02:25
057 Saint-Guilhem - Courreau,5,3,8,2022,01-19,02:25
059 Sud De France,0,8,8,2022,01-19,02:25
001 Rue Jules Ferry - Gare Saint-Roch,0,12,12,2022,01-19,02:35
002 Com�die,4,20,24,2022,01-19,02:35
003 Esplanade,0,32,32,2022,01-19,02:35
004 H�tel de Ville,16,0,16,2022,01-19,02:35
005 Corum,10,2,12,2022,01-19,02:35
006 Place Albert 1er - St Charles,20,11,31,2022,01-19,02:35
007 Foch,2,6,8,2022,01-19,02:35
008 Halles Castellane,0,12,12,2022,01-19,02:35
009 Observatoire,7,1,8,2022,01-19,02:35
010 Rondelet,2,14,16,2022,01-19,02:35
011 Plan Cabanes,11,1,12,2022,01-19,02:35
012 Boutonnet,3,9,12,2022,01-19,02:35
013 Emile Combes,4,4,8,2022,01-19,02:35
014 Beaux-Arts,3,5,8,2022,01-19,02:35
015 Les Aubes,5,3,8,2022,01-19,02:35
016 Antigone centre,16,0,16,2022,01-19,02:35
017 M�diath�que Emile Zola,11,5,16,2022,01-19,02:35
018 Nombre d'Or,15,1,16,2022,01-19,02:35
019 Louis Blanc,8,8,16,2022,01-19,02:35
020 Gambetta,4,4,8,2022,01-19,02:35
021 Port Marianne,16,0,16,2022,01-19,02:35
022 Clemenceau,3,9,12,2022,01-19,02:35
023 Les Arceaux,6,10,16,2022,01-19,02:35
024 Cit� Mion,3,5,8,2022,01-19,02:35
025 Nouveau Saint-Roch,4,4,8,2022,01-19,02:35
026 Renouvier,4,4,8,2022,01-19,02:35
027 Odysseum,4,4,8,2022,01-19,02:35
028 Saint-Denis,4,4,8,2022,01-19,02:35
029 Richter,14,2,16,2022,01-19,02:35
030 Charles Flahault,8,0,8,2022,01-19,02:35
031 Voltaire,3,5,8,2022,01-19,02:35
032 Pr�s d'Ar�nes,8,0,8,2022,01-19,02:35
033 Garcia Lorca,8,0,8,2022,01-19,02:35
034 Vert Bois,0,16,16,2022,01-19,02:35
035 Malbosc,2,6,8,2022,01-19,02:35
036 Occitanie,5,27,32,2022,01-19,02:35
037 FacdesSciences,1,23,24,2022,01-19,02:35
038 Fac de Lettres,1,15,16,2022,01-19,02:35
039 Aiguelongue,8,0,8,2022,01-19,02:35
040 Jeu de Mail des Abb�s,8,0,8,2022,01-19,02:35
041 Eurom�decine,0,8,8,2022,01-19,02:35
042 Marie Caizergues,4,4,8,2022,01-19,02:35
043 Sabines,3,5,8,2022,01-19,02:35
044 Celleneuve,1,7,8,2022,01-19,02:35
045 Jardin de la Lironde,1,7,8,2022,01-19,02:35
046 P�re Soulas,7,1,8,2022,01-19,02:35
047 Place Viala,2,6,8,2022,01-19,02:35
048 H�tel du D�partement,0,8,8,2022,01-19,02:35
049 Tonnelles,1,7,8,2022,01-19,02:35
050 Parvis Jules Ferry - Gare Saint-Roch,0,8,8,2022,01-19,02:35
051 Pont de Lattes - Gare Saint-Roch,3,9,12,2022,01-19,02:35
053 Deux Ponts - Gare Saint-Roch,2,6,8,2022,01-19,02:35
054 Providence - Ovalie,4,4,8,2022,01-19,02:35
055 P�rols Etang de l'Or,23,45,68,2022,01-19,02:35
056 Albert 1er - Cath�drale,1,11,12,2022,01-19,02:35
057 Saint-Guilhem - Courreau,5,3,8,2022,01-19,02:35
059 Sud De France,0,8,8,2022,01-19,02:35
001 Rue Jules Ferry - Gare Saint-Roch,0,12,12,2022,01-19,02:45
002 Com�die,4,20,24,2022,01-19,02:45
003 Esplanade,0,32,32,2022,01-19,02:45
004 H�tel de Ville,16,0,16,2022,01-19,02:45
005 Corum,10,2,12,2022,01-19,02:45
006 Place Albert 1er - St Charles,21,10,31,2022,01-19,02:45
007 Foch,2,6,8,2022,01-19,02:45
008 Halles Castellane,0,12,12,2022,01-19,02:45
009 Observatoire,7,1,8,2022,01-19,02:45
010 Rondelet,2,14,16,2022,01-19,02:45
011 Plan Cabanes,11,1,12,2022,01-19,02:45
012 Boutonnet,1,11,12,2022,01-19,02:45
013 Emile Combes,3,5,8,2022,01-19,02:45
014 Beaux-Arts,3,5,8,2022,01-19,02:45
015 Les Aubes,5,3,8,2022,01-19,02:45
016 Antigone centre,15,1,16,2022,01-19,02:45
017 M�diath�que Emile Zola,11,5,16,2022,01-19,02:45
018 Nombre d'Or,15,1,16,2022,01-19,02:45
019 Louis Blanc,8,8,16,2022,01-19,02:45
020 Gambetta,4,4,8,2022,01-19,02:45
021 Port Marianne,16,0,16,2022,01-19,02:45
022 Clemenceau,3,9,12,2022,01-19,02:45
023 Les Arceaux,6,10,16,2022,01-19,02:45
024 Cit� Mion,3,5,8,2022,01-19,02:45
025 Nouveau Saint-Roch,4,4,8,2022,01-19,02:45
026 Renouvier,4,4,8,2022,01-19,02:45
027 Odysseum,4,4,8,2022,01-19,02:45
028 Saint-Denis,4,4,8,2022,01-19,02:45
029 Richter,14,2,16,2022,01-19,02:45
030 Charles Flahault,8,0,8,2022,01-19,02:45
031 Voltaire,3,5,8,2022,01-19,02:45
032 Pr�s d'Ar�nes,8,0,8,2022,01-19,02:45
033 Garcia Lorca,8,0,8,2022,01-19,02:45
034 Vert Bois,0,16,16,2022,01-19,02:45
035 Malbosc,2,6,8,2022,01-19,02:45
036 Occitanie,5,27,32,2022,01-19,02:45
037 FacdesSciences,1,23,24,2022,01-19,02:45
038 Fac de Lettres,1,15,16,2022,01-19,02:45
039 Aiguelongue,8,0,8,2022,01-19,02:45
040 Jeu de Mail des Abb�s,8,0,8,2022,01-19,02:45
041 Eurom�decine,0,8,8,2022,01-19,02:45
042 Marie Caizergues,4,4,8,2022,01-19,02:45
043 Sabines,3,5,8,2022,01-19,02:45
044 Celleneuve,1,7,8,2022,01-19,02:45
045 Jardin de la Lironde,1,7,8,2022,01-19,02:45
046 P�re Soulas,7,1,8,2022,01-19,02:45
047 Place Viala,2,6,8,2022,01-19,02:45
048 H�tel du D�partement,0,8,8,2022,01-19,02:45
049 Tonnelles,1,7,8,2022,01-19,02:45
050 Parvis Jules Ferry - Gare Saint-Roch,0,8,8,2022,01-19,02:45
051 Pont de Lattes - Gare Saint-Roch,3,9,12,2022,01-19,02:45
053 Deux Ponts - Gare Saint-Roch,2,6,8,2022,01-19,02:45
054 Providence - Ovalie,4,4,8,2022,01-19,02:45
055 P�rols Etang de l'Or,23,45,68,2022,01-19,02:45
056 Albert 1er - Cath�drale,1,11,12,2022,01-19,02:45
057 Saint-Guilhem - Courreau,5,3,8,2022,01-19,02:45
059 Sud De France,0,8,8,2022,01-19,02:45
001 Rue Jules Ferry - Gare Saint-Roch,0,12,12,2022,01-19,02:55
002 Com�die,4,20,24,2022,01-19,02:55
003 Esplanade,0,32,32,2022,01-19,02:55
004 H�tel de Ville,16,0,16,2022,01-19,02:55
005 Corum,10,2,12,2022,01-19,02:55
006 Place Albert 1er - St Charles,21,10,31,2022,01-19,02:55
007 Foch,2,6,8,2022,01-19,02:55
008 Halles Castellane,0,12,12,2022,01-19,02:55
009 Observatoire,7,1,8,2022,01-19,02:55
010 Rondelet,2,14,16,2022,01-19,02:55
011 Plan Cabanes,11,1,12,2022,01-19,02:55
012 Boutonnet,1,11,12,2022,01-19,02:55
013 Emile Combes,3,5,8,2022,01-19,02:55
014 Beaux-Arts,3,5,8,2022,01-19,02:55
015 Les Aubes,5,3,8,2022,01-19,02:55
016 Antigone centre,15,1,16,2022,01-19,02:55
017 M�diath�que Emile Zola,11,5,16,2022,01-19,02:55
018 Nombre d'Or,15,1,16,2022,01-19,02:55
019 Louis Blanc,8,8,16,2022,01-19,02:55
020 Gambetta,4,4,8,2022,01-19,02:55
021 Port Marianne,16,0,16,2022,01-19,02:55
022 Clemenceau,4,8,12,2022,01-19,02:55
023 Les Arceaux,6,10,16,2022,01-19,02:55
024 Cit� Mion,3,5,8,2022,01-19,02:55
025 Nouveau Saint-Roch,4,4,8,2022,01-19,02:55
026 Renouvier,4,4,8,2022,01-19,02:55
027 Odysseum,4,4,8,2022,01-19,02:55
028 Saint-Denis,4,4,8,2022,01-19,02:55
029 Richter,14,2,16,2022,01-19,02:55
030 Charles Flahault,8,0,8,2022,01-19,02:55
031 Voltaire,3,5,8,2022,01-19,02:55
032 Pr�s d'Ar�nes,8,0,8,2022,01-19,02:55
033 Garcia Lorca,8,0,8,2022,01-19,02:55
034 Vert Bois,0,16,16,2022,01-19,02:55
035 Malbosc,2,6,8,2022,01-19,02:55
036 Occitanie,5,27,32,2022,01-19,02:55
037 FacdesSciences,3,21,24,2022,01-19,02:55
038 Fac de Lettres,1,15,16,2022,01-19,02:55
039 Aiguelongue,8,0,8,2022,01-19,02:55
040 Jeu de Mail des Abb�s,8,0,8,2022,01-19,02:55
041 Eurom�decine,0,8,8,2022,01-19,02:55
042 Marie Caizergues,4,4,8,2022,01-19,02:55
043 Sabines,3,5,8,2022,01-19,02:55
044 Celleneuve,1,7,8,2022,01-19,02:55
045 Jardin de la Lironde,1,7,8,2022,01-19,02:55
046 P�re Soulas,7,1,8,2022,01-19,02:55
047 Place Viala,2,6,8,2022,01-19,02:55
048 H�tel du D�partement,0,8,8,2022,01-19,02:55
049 Tonnelles,1,7,8,2022,01-19,02:55
050 Parvis Jules Ferry - Gare Saint-Roch,0,8,8,2022,01-19,02:55
051 Pont de Lattes - Gare Saint-Roch,3,9,12,2022,01-19,02:55
053 Deux Ponts - Gare Saint-Roch,2,6,8,2022,01-19,02:55
054 Providence - Ovalie,4,4,8,2022,01-19,02:55
055 P�rols Etang de l'Or,23,45,68,2022,01-19,02:55
056 Albert 1er - Cath�drale,1,11,12,2022,01-19,02:55
057 Saint-Guilhem - Courreau,5,3,8,2022,01-19,02:55
059 Sud De France,0,8,8,2022,01-19,02:55
001 Rue Jules Ferry - Gare Saint-Roch,0,12,12,2022,01-19,03:05
002 Com�die,4,20,24,2022,01-19,03:05
003 Esplanade,0,32,32,2022,01-19,03:05
004 H�tel de Ville,16,0,16,2022,01-19,03:05
005 Corum,10,2,12,2022,01-19,03:05
006 Place Albert 1er - St Charles,21,10,31,2022,01-19,03:05
007 Foch,2,6,8,2022,01-19,03:05
008 Halles Castellane,0,12,12,2022,01-19,03:05
009 Observatoire,7,1,8,2022,01-19,03:05
010 Rondelet,2,14,16,2022,01-19,03:05
011 Plan Cabanes,11,1,12,2022,01-19,03:05
012 Boutonnet,2,10,12,2022,01-19,03:05
013 Emile Combes,3,5,8,2022,01-19,03:05
014 Beaux-Arts,3,5,8,2022,01-19,03:05
015 Les Aubes,5,3,8,2022,01-19,03:05
016 Antigone centre,15,1,16,2022,01-19,03:05
017 M�diath�que Emile Zola,11,5,16,2022,01-19,03:05
018 Nombre d'Or,15,1,16,2022,01-19,03:05
019 Louis Blanc,8,8,16,2022,01-19,03:05
020 Gambetta,4,4,8,2022,01-19,03:05
021 Port Marianne,16,0,16,2022,01-19,03:05
022 Clemenceau,4,8,12,2022,01-19,03:05
023 Les Arceaux,6,10,16,2022,01-19,03:05
024 Cit� Mion,3,5,8,2022,01-19,03:05
025 Nouveau Saint-Roch,4,4,8,2022,01-19,03:05
026 Renouvier,4,4,8,2022,01-19,03:05
027 Odysseum,4,4,8,2022,01-19,03:05
028 Saint-Denis,4,4,8,2022,01-19,03:05
029 Richter,14,2,16,2022,01-19,03:05
030 Charles Flahault,8,0,8,2022,01-19,03:05
031 Voltaire,3,5,8,2022,01-19,03:05
032 Pr�s d'Ar�nes,8,0,8,2022,01-19,03:05
033 Garcia Lorca,8,0,8,2022,01-19,03:05
034 Vert Bois,0,16,16,2022,01-19,03:05
035 Malbosc,2,6,8,2022,01-19,03:05
036 Occitanie,6,26,32,2022,01-19,03:05
037 FacdesSciences,3,21,24,2022,01-19,03:05
038 Fac de Lettres,1,15,16,2022,01-19,03:05
039 Aiguelongue,8,0,8,2022,01-19,03:05
040 Jeu de Mail des Abb�s,8,0,8,2022,01-19,03:05
041 Eurom�decine,0,8,8,2022,01-19,03:05
042 Marie Caizergues,4,4,8,2022,01-19,03:05
043 Sabines,3,5,8,2022,01-19,03:05
044 Celleneuve,1,7,8,2022,01-19,03:05
045 Jardin de la Lironde,1,7,8,2022,01-19,03:05
046 P�re Soulas,7,1,8,2022,01-19,03:05
047 Place Viala,2,6,8,2022,01-19,03:05
048 H�tel du D�partement,0,8,8,2022,01-19,03:05
049 Tonnelles,1,7,8,2022,01-19,03:05
050 Parvis Jules Ferry - Gare Saint-Roch,0,8,8,2022,01-19,03:05
051 Pont de Lattes - Gare Saint-Roch,3,9,12,2022,01-19,03:05
053 Deux Ponts - Gare Saint-Roch,2,6,8,2022,01-19,03:05
054 Providence - Ovalie,4,4,8,2022,01-19,03:05
055 P�rols Etang de l'Or,23,45,68,2022,01-19,03:05
056 Albert 1er - Cath�drale,1,11,12,2022,01-19,03:05
057 Saint-Guilhem - Courreau,5,3,8,2022,01-19,03:05
059 Sud De France,0,8,8,2022,01-19,03:05
001 Rue Jules Ferry - Gare Saint-Roch,0,12,12,2022,01-19,03:15
002 Com�die,4,20,24,2022,01-19,03:15
003 Esplanade,0,32,32,2022,01-19,03:15
004 H�tel de Ville,16,0,16,2022,01-19,03:15
005 Corum,10,2,12,2022,01-19,03:15
006 Place Albert 1er - St Charles,21,10,31,2022,01-19,03:15
007 Foch,2,6,8,2022,01-19,03:15
008 Halles Castellane,0,12,12,2022,01-19,03:15
009 Observatoire,7,1,8,2022,01-19,03:15
010 Rondelet,2,14,16,2022,01-19,03:15
011 Plan Cabanes,12,0,12,2022,01-19,03:15
012 Boutonnet,1,11,12,2022,01-19,03:15
013 Emile Combes,3,5,8,2022,01-19,03:15
014 Beaux-Arts,3,5,8,2022,01-19,03:15
015 Les Aubes,5,3,8,2022,01-19,03:15
016 Antigone centre,15,1,16,2022,01-19,03:15
017 M�diath�que Emile Zola,11,5,16,2022,01-19,03:15
018 Nombre d'Or,15,1,16,2022,01-19,03:15
019 Louis Blanc,8,8,16,2022,01-19,03:15
020 Gambetta,4,4,8,2022,01-19,03:15
021 Port Marianne,16,0,16,2022,01-19,03:15
022 Clemenceau,4,8,12,2022,01-19,03:15
023 Les Arceaux,6,10,16,2022,01-19,03:15
024 Cit� Mion,3,5,8,2022,01-19,03:15
025 Nouveau Saint-Roch,4,4,8,2022,01-19,03:15
026 Renouvier,4,4,8,2022,01-19,03:15
027 Odysseum,4,4,8,2022,01-19,03:15
028 Saint-Denis,4,4,8,2022,01-19,03:15
029 Richter,14,2,16,2022,01-19,03:15
030 Charles Flahault,8,0,8,2022,01-19,03:15
031 Voltaire,3,5,8,2022,01-19,03:15
032 Pr�s d'Ar�nes,8,0,8,2022,01-19,03:15
033 Garcia Lorca,8,0,8,2022,01-19,03:15
034 Vert Bois,0,16,16,2022,01-19,03:15
035 Malbosc,2,6,8,2022,01-19,03:15
036 Occitanie,6,26,32,2022,01-19,03:15
037 FacdesSciences,3,21,24,2022,01-19,03:15
038 Fac de Lettres,1,15,16,2022,01-19,03:15
039 Aiguelongue,8,0,8,2022,01-19,03:15
040 Jeu de Mail des Abb�s,8,0,8,2022,01-19,03:15
041 Eurom�decine,0,8,8,2022,01-19,03:15
042 Marie Caizergues,4,4,8,2022,01-19,03:15
043 Sabines,3,5,8,2022,01-19,03:15
044 Celleneuve,1,7,8,2022,01-19,03:15
045 Jardin de la Lironde,1,7,8,2022,01-19,03:15
046 P�re Soulas,7,1,8,2022,01-19,03:15
047 Place Viala,2,6,8,2022,01-19,03:15
048 H�tel du D�partement,0,8,8,2022,01-19,03:15
049 Tonnelles,1,7,8,2022,01-19,03:15
050 Parvis Jules Ferry - Gare Saint-Roch,0,8,8,2022,01-19,03:15
051 Pont de Lattes - Gare Saint-Roch,3,9,12,2022,01-19,03:15
053 Deux Ponts - Gare Saint-Roch,2,6,8,2022,01-19,03:15
054 Providence - Ovalie,4,4,8,2022,01-19,03:15
055 P�rols Etang de l'Or,23,45,68,2022,01-19,03:15
056 Albert 1er - Cath�drale,1,11,12,2022,01-19,03:15
057 Saint-Guilhem - Courreau,5,3,8,2022,01-19,03:15
059 Sud De France,0,8,8,2022,01-19,03:15
001 Rue Jules Ferry - Gare Saint-Roch,0,12,12,2022,01-19,03:26
002 Com�die,4,20,24,2022,01-19,03:26
003 Esplanade,0,32,32,2022,01-19,03:26
004 H�tel de Ville,16,0,16,2022,01-19,03:26
005 Corum,10,2,12,2022,01-19,03:26
006 Place Albert 1er - St Charles,21,10,31,2022,01-19,03:26
007 Foch,2,6,8,2022,01-19,03:26
008 Halles Castellane,0,12,12,2022,01-19,03:26
009 Observatoire,7,1,8,2022,01-19,03:26
010 Rondelet,2,14,16,2022,01-19,03:26
011 Plan Cabanes,12,0,12,2022,01-19,03:26
012 Boutonnet,1,11,12,2022,01-19,03:26
013 Emile Combes,1,7,8,2022,01-19,03:26
014 Beaux-Arts,3,5,8,2022,01-19,03:26
015 Les Aubes,5,3,8,2022,01-19,03:26
016 Antigone centre,15,1,16,2022,01-19,03:26
017 M�diath�que Emile Zola,11,5,16,2022,01-19,03:26
018 Nombre d'Or,15,1,16,2022,01-19,03:26
019 Louis Blanc,8,8,16,2022,01-19,03:26
020 Gambetta,4,4,8,2022,01-19,03:26
021 Port Marianne,16,0,16,2022,01-19,03:26
022 Clemenceau,4,8,12,2022,01-19,03:26
023 Les Arceaux,6,10,16,2022,01-19,03:26
024 Cit� Mion,3,5,8,2022,01-19,03:26
025 Nouveau Saint-Roch,4,4,8,2022,01-19,03:26
026 Renouvier,4,4,8,2022,01-19,03:26
027 Odysseum,4,4,8,2022,01-19,03:26
028 Saint-Denis,4,4,8,2022,01-19,03:26
029 Richter,14,2,16,2022,01-19,03:26
030 Charles Flahault,8,0,8,2022,01-19,03:26
031 Voltaire,3,5,8,2022,01-19,03:26
032 Pr�s d'Ar�nes,8,0,8,2022,01-19,03:26
033 Garcia Lorca,8,0,8,2022,01-19,03:26
034 Vert Bois,0,16,16,2022,01-19,03:26
035 Malbosc,2,6,8,2022,01-19,03:26
036 Occitanie,6,26,32,2022,01-19,03:26
037 FacdesSciences,3,21,24,2022,01-19,03:26
038 Fac de Lettres,1,15,16,2022,01-19,03:26
039 Aiguelongue,8,0,8,2022,01-19,03:26
040 Jeu de Mail des Abb�s,8,0,8,2022,01-19,03:26
041 Eurom�decine,0,8,8,2022,01-19,03:26
042 Marie Caizergues,4,4,8,2022,01-19,03:26
043 Sabines,3,5,8,2022,01-19,03:26
044 Celleneuve,1,7,8,2022,01-19,03:26
045 Jardin de la Lironde,1,7,8,2022,01-19,03:26
046 P�re Soulas,7,1,8,2022,01-19,03:26
047 Place Viala,2,6,8,2022,01-19,03:26
048 H�tel du D�partement,0,8,8,2022,01-19,03:26
049 Tonnelles,1,7,8,2022,01-19,03:26
050 Parvis Jules Ferry - Gare Saint-Roch,0,8,8,2022,01-19,03:26
051 Pont de Lattes - Gare Saint-Roch,3,9,12,2022,01-19,03:26
053 Deux Ponts - Gare Saint-Roch,2,6,8,2022,01-19,03:26
054 Providence - Ovalie,4,4,8,2022,01-19,03:26
055 P�rols Etang de l'Or,23,45,68,2022,01-19,03:26
056 Albert 1er - Cath�drale,1,11,12,2022,01-19,03:26
057 Saint-Guilhem - Courreau,5,3,8,2022,01-19,03:26
059 Sud De France,0,8,8,2022,01-19,03:26
001 Rue Jules Ferry - Gare Saint-Roch,1,11,12,2022,01-19,03:36
002 Com�die,4,20,24,2022,01-19,03:36
003 Esplanade,0,32,32,2022,01-19,03:36
004 H�tel de Ville,16,0,16,2022,01-19,03:36
005 Corum,10,2,12,2022,01-19,03:36
006 Place Albert 1er - St Charles,21,10,31,2022,01-19,03:36
007 Foch,2,6,8,2022,01-19,03:36
008 Halles Castellane,0,12,12,2022,01-19,03:36
009 Observatoire,7,1,8,2022,01-19,03:36
010 Rondelet,2,14,16,2022,01-19,03:36
011 Plan Cabanes,12,0,12,2022,01-19,03:36
012 Boutonnet,1,11,12,2022,01-19,03:36
013 Emile Combes,1,7,8,2022,01-19,03:36
014 Beaux-Arts,3,5,8,2022,01-19,03:36
015 Les Aubes,5,3,8,2022,01-19,03:36
016 Antigone centre,15,1,16,2022,01-19,03:36
017 M�diath�que Emile Zola,11,5,16,2022,01-19,03:36
018 Nombre d'Or,15,1,16,2022,01-19,03:36
019 Louis Blanc,8,8,16,2022,01-19,03:36
020 Gambetta,4,4,8,2022,01-19,03:36
021 Port Marianne,16,0,16,2022,01-19,03:36
022 Clemenceau,4,8,12,2022,01-19,03:36
023 Les Arceaux,6,10,16,2022,01-19,03:36
024 Cit� Mion,3,5,8,2022,01-19,03:36
025 Nouveau Saint-Roch,4,4,8,2022,01-19,03:36
026 Renouvier,4,4,8,2022,01-19,03:36
027 Odysseum,4,4,8,2022,01-19,03:36
028 Saint-Denis,4,4,8,2022,01-19,03:36
029 Richter,15,1,16,2022,01-19,03:36
030 Charles Flahault,7,1,8,2022,01-19,03:36
031 Voltaire,3,5,8,2022,01-19,03:36
032 Pr�s d'Ar�nes,8,0,8,2022,01-19,03:36
033 Garcia Lorca,8,0,8,2022,01-19,03:36
034 Vert Bois,0,16,16,2022,01-19,03:36
035 Malbosc,2,6,8,2022,01-19,03:36
036 Occitanie,6,26,32,2022,01-19,03:36
037 FacdesSciences,3,21,24,2022,01-19,03:36
038 Fac de Lettres,1,15,16,2022,01-19,03:36
039 Aiguelongue,8,0,8,2022,01-19,03:36
040 Jeu de Mail des Abb�s,8,0,8,2022,01-19,03:36
041 Eurom�decine,0,8,8,2022,01-19,03:36
042 Marie Caizergues,4,4,8,2022,01-19,03:36
043 Sabines,3,5,8,2022,01-19,03:36
044 Celleneuve,1,7,8,2022,01-19,03:36
045 Jardin de la Lironde,1,7,8,2022,01-19,03:36
046 P�re Soulas,7,1,8,2022,01-19,03:36
047 Place Viala,2,6,8,2022,01-19,03:36
048 H�tel du D�partement,0,8,8,2022,01-19,03:36
049 Tonnelles,1,7,8,2022,01-19,03:36
050 Parvis Jules Ferry - Gare Saint-Roch,0,8,8,2022,01-19,03:36
051 Pont de Lattes - Gare Saint-Roch,3,9,12,2022,01-19,03:36
053 Deux Ponts - Gare Saint-Roch,2,6,8,2022,01-19,03:36
054 Providence - Ovalie,4,4,8,2022,01-19,03:36
055 P�rols Etang de l'Or,23,45,68,2022,01-19,03:36
056 Albert 1er - Cath�drale,1,11,12,2022,01-19,03:36
057 Saint-Guilhem - Courreau,5,3,8,2022,01-19,03:36
059 Sud De France,0,8,8,2022,01-19,03:36
001 Rue Jules Ferry - Gare Saint-Roch,1,11,12,2022,01-19,03:46
002 Com�die,4,20,24,2022,01-19,03:46
003 Esplanade,0,32,32,2022,01-19,03:46
004 H�tel de Ville,16,0,16,2022,01-19,03:46
005 Corum,10,2,12,2022,01-19,03:46
006 Place Albert 1er - St Charles,21,10,31,2022,01-19,03:46
007 Foch,2,6,8,2022,01-19,03:46
008 Halles Castellane,0,12,12,2022,01-19,03:46
009 Observatoire,7,1,8,2022,01-19,03:46
010 Rondelet,2,14,16,2022,01-19,03:46
011 Plan Cabanes,12,0,12,2022,01-19,03:46
012 Boutonnet,1,11,12,2022,01-19,03:46
013 Emile Combes,1,7,8,2022,01-19,03:46
014 Beaux-Arts,3,5,8,2022,01-19,03:46
015 Les Aubes,5,3,8,2022,01-19,03:46
016 Antigone centre,15,1,16,2022,01-19,03:46
017 M�diath�que Emile Zola,11,5,16,2022,01-19,03:46
018 Nombre d'Or,15,1,16,2022,01-19,03:46
019 Louis Blanc,7,9,16,2022,01-19,03:46
020 Gambetta,4,4,8,2022,01-19,03:46
021 Port Marianne,16,0,16,2022,01-19,03:46
022 Clemenceau,4,8,12,2022,01-19,03:46
023 Les Arceaux,6,10,16,2022,01-19,03:46
024 Cit� Mion,3,5,8,2022,01-19,03:46
025 Nouveau Saint-Roch,4,4,8,2022,01-19,03:46
026 Renouvier,4,4,8,2022,01-19,03:46
027 Odysseum,4,4,8,2022,01-19,03:46
028 Saint-Denis,4,4,8,2022,01-19,03:46
029 Richter,15,1,16,2022,01-19,03:46
030 Charles Flahault,7,1,8,2022,01-19,03:46
031 Voltaire,3,5,8,2022,01-19,03:46
032 Pr�s d'Ar�nes,8,0,8,2022,01-19,03:46
033 Garcia Lorca,8,0,8,2022,01-19,03:46
034 Vert Bois,0,16,16,2022,01-19,03:46
035 Malbosc,2,6,8,2022,01-19,03:46
036 Occitanie,6,26,32,2022,01-19,03:46
037 FacdesSciences,4,20,24,2022,01-19,03:46
038 Fac de Lettres,1,15,16,2022,01-19,03:46
039 Aiguelongue,8,0,8,2022,01-19,03:46
040 Jeu de Mail des Abb�s,8,0,8,2022,01-19,03:46
041 Eurom�decine,0,8,8,2022,01-19,03:46
042 Marie Caizergues,4,4,8,2022,01-19,03:46
043 Sabines,3,5,8,2022,01-19,03:46
044 Celleneuve,1,7,8,2022,01-19,03:46
045 Jardin de la Lironde,1,7,8,2022,01-19,03:46
046 P�re Soulas,8,0,8,2022,01-19,03:46
047 Place Viala,2,6,8,2022,01-19,03:46
048 H�tel du D�partement,0,8,8,2022,01-19,03:46
049 Tonnelles,1,7,8,2022,01-19,03:46
050 Parvis Jules Ferry - Gare Saint-Roch,0,8,8,2022,01-19,03:46
051 Pont de Lattes - Gare Saint-Roch,3,9,12,2022,01-19,03:46
053 Deux Ponts - Gare Saint-Roch,2,6,8,2022,01-19,03:46
054 Providence - Ovalie,4,4,8,2022,01-19,03:46
055 P�rols Etang de l'Or,23,45,68,2022,01-19,03:46
056 Albert 1er - Cath�drale,1,11,12,2022,01-19,03:46
057 Saint-Guilhem - Courreau,5,3,8,2022,01-19,03:46
059 Sud De France,0,8,8,2022,01-19,03:46
001 Rue Jules Ferry - Gare Saint-Roch,1,11,12,2022,01-19,03:56
002 Com�die,4,20,24,2022,01-19,03:56
003 Esplanade,0,32,32,2022,01-19,03:56
004 H�tel de Ville,16,0,16,2022,01-19,03:56
005 Corum,10,2,12,2022,01-19,03:56
006 Place Albert 1er - St Charles,21,10,31,2022,01-19,03:56
007 Foch,2,6,8,2022,01-19,03:56
008 Halles Castellane,0,12,12,2022,01-19,03:56
009 Observatoire,7,1,8,2022,01-19,03:56
010 Rondelet,2,14,16,2022,01-19,03:56
011 Plan Cabanes,12,0,12,2022,01-19,03:56
012 Boutonnet,1,11,12,2022,01-19,03:56
013 Emile Combes,1,7,8,2022,01-19,03:56
014 Beaux-Arts,3,5,8,2022,01-19,03:56
015 Les Aubes,5,3,8,2022,01-19,03:56
016 Antigone centre,15,1,16,2022,01-19,03:56
017 M�diath�que Emile Zola,11,5,16,2022,01-19,03:56
018 Nombre d'Or,15,1,16,2022,01-19,03:56
019 Louis Blanc,7,9,16,2022,01-19,03:56
020 Gambetta,4,4,8,2022,01-19,03:56
021 Port Marianne,16,0,16,2022,01-19,03:56
022 Clemenceau,4,8,12,2022,01-19,03:56
023 Les Arceaux,6,10,16,2022,01-19,03:56
024 Cit� Mion,3,5,8,2022,01-19,03:56
025 Nouveau Saint-Roch,4,4,8,2022,01-19,03:56
026 Renouvier,4,4,8,2022,01-19,03:56
027 Odysseum,4,4,8,2022,01-19,03:56
028 Saint-Denis,4,4,8,2022,01-19,03:56
029 Richter,15,1,16,2022,01-19,03:56
030 Charles Flahault,7,1,8,2022,01-19,03:56
031 Voltaire,3,5,8,2022,01-19,03:56
032 Pr�s d'Ar�nes,8,0,8,2022,01-19,03:56
033 Garcia Lorca,8,0,8,2022,01-19,03:56
034 Vert Bois,0,16,16,2022,01-19,03:56
035 Malbosc,2,6,8,2022,01-19,03:56
036 Occitanie,6,26,32,2022,01-19,03:56
037 FacdesSciences,4,20,24,2022,01-19,03:56
038 Fac de Lettres,1,15,16,2022,01-19,03:56
039 Aiguelongue,8,0,8,2022,01-19,03:56
040 Jeu de Mail des Abb�s,8,0,8,2022,01-19,03:56
041 Eurom�decine,0,8,8,2022,01-19,03:56
042 Marie Caizergues,4,4,8,2022,01-19,03:56
043 Sabines,3,5,8,2022,01-19,03:56
044 Celleneuve,1,7,8,2022,01-19,03:56
045 Jardin de la Lironde,1,7,8,2022,01-19,03:56
046 P�re Soulas,8,0,8,2022,01-19,03:56
047 Place Viala,2,6,8,2022,01-19,03:56
048 H�tel du D�partement,0,8,8,2022,01-19,03:56
049 Tonnelles,1,7,8,2022,01-19,03:56
050 Parvis Jules Ferry - Gare Saint-Roch,0,8,8,2022,01-19,03:56
051 Pont de Lattes - Gare Saint-Roch,3,9,12,2022,01-19,03:56
053 Deux Ponts - Gare Saint-Roch,2,6,8,2022,01-19,03:56
054 Providence - Ovalie,4,4,8,2022,01-19,03:56
055 P�rols Etang de l'Or,23,45,68,2022,01-19,03:56
056 Albert 1er - Cath�drale,1,11,12,2022,01-19,03:56
057 Saint-Guilhem - Courreau,5,3,8,2022,01-19,03:56
059 Sud De France,0,8,8,2022,01-19,03:56
001 Rue Jules Ferry - Gare Saint-Roch,1,11,12,2022,01-19,04:06
002 Com�die,4,20,24,2022,01-19,04:06
003 Esplanade,0,32,32,2022,01-19,04:06
004 H�tel de Ville,16,0,16,2022,01-19,04:06
005 Corum,10,2,12,2022,01-19,04:06
006 Place Albert 1er - St Charles,21,10,31,2022,01-19,04:06
007 Foch,2,6,8,2022,01-19,04:06
008 Halles Castellane,0,12,12,2022,01-19,04:06
009 Observatoire,7,1,8,2022,01-19,04:06
010 Rondelet,2,14,16,2022,01-19,04:06
011 Plan Cabanes,12,0,12,2022,01-19,04:06
012 Boutonnet,1,11,12,2022,01-19,04:06
013 Emile Combes,1,7,8,2022,01-19,04:06
014 Beaux-Arts,3,5,8,2022,01-19,04:06
015 Les Aubes,5,3,8,2022,01-19,04:06
016 Antigone centre,15,1,16,2022,01-19,04:06
017 M�diath�que Emile Zola,11,5,16,2022,01-19,04:06
018 Nombre d'Or,15,1,16,2022,01-19,04:06
019 Louis Blanc,7,9,16,2022,01-19,04:06
020 Gambetta,4,4,8,2022,01-19,04:06
021 Port Marianne,16,0,16,2022,01-19,04:06
022 Clemenceau,4,8,12,2022,01-19,04:06
023 Les Arceaux,6,10,16,2022,01-19,04:06
024 Cit� Mion,3,5,8,2022,01-19,04:06
025 Nouveau Saint-Roch,4,4,8,2022,01-19,04:06
026 Renouvier,4,4,8,2022,01-19,04:06
027 Odysseum,4,4,8,2022,01-19,04:06
028 Saint-Denis,4,4,8,2022,01-19,04:06
029 Richter,15,1,16,2022,01-19,04:06
030 Charles Flahault,7,1,8,2022,01-19,04:06
031 Voltaire,3,5,8,2022,01-19,04:06
032 Pr�s d'Ar�nes,8,0,8,2022,01-19,04:06
033 Garcia Lorca,8,0,8,2022,01-19,04:06
034 Vert Bois,0,16,16,2022,01-19,04:06
035 Malbosc,2,6,8,2022,01-19,04:06
036 Occitanie,6,26,32,2022,01-19,04:06
037 FacdesSciences,4,20,24,2022,01-19,04:06
038 Fac de Lettres,1,15,16,2022,01-19,04:06
039 Aiguelongue,8,0,8,2022,01-19,04:06
040 Jeu de Mail des Abb�s,8,0,8,2022,01-19,04:06
041 Eurom�decine,0,8,8,2022,01-19,04:06
042 Marie Caizergues,4,4,8,2022,01-19,04:06
043 Sabines,3,5,8,2022,01-19,04:06
044 Celleneuve,1,7,8,2022,01-19,04:06
045 Jardin de la Lironde,1,7,8,2022,01-19,04:06
046 P�re Soulas,8,0,8,2022,01-19,04:06
047 Place Viala,2,6,8,2022,01-19,04:06
048 H�tel du D�partement,0,8,8,2022,01-19,04:06
049 Tonnelles,1,7,8,2022,01-19,04:06
050 Parvis Jules Ferry - Gare Saint-Roch,0,8,8,2022,01-19,04:06
051 Pont de Lattes - Gare Saint-Roch,3,9,12,2022,01-19,04:06
053 Deux Ponts - Gare Saint-Roch,2,6,8,2022,01-19,04:06
054 Providence - Ovalie,4,4,8,2022,01-19,04:06
055 P�rols Etang de l'Or,23,45,68,2022,01-19,04:06
056 Albert 1er - Cath�drale,1,11,12,2022,01-19,04:06
057 Saint-Guilhem - Courreau,5,3,8,2022,01-19,04:06
059 Sud De France,0,8,8,2022,01-19,04:06
001 Rue Jules Ferry - Gare Saint-Roch,1,11,12,2022,01-19,04:16
002 Com�die,4,20,24,2022,01-19,04:16
003 Esplanade,0,32,32,2022,01-19,04:16
004 H�tel de Ville,16,0,16,2022,01-19,04:16
005 Corum,10,2,12,2022,01-19,04:16
006 Place Albert 1er - St Charles,21,10,31,2022,01-19,04:16
007 Foch,2,6,8,2022,01-19,04:16
008 Halles Castellane,0,12,12,2022,01-19,04:16
009 Observatoire,7,1,8,2022,01-19,04:16
010 Rondelet,2,14,16,2022,01-19,04:16
011 Plan Cabanes,12,0,12,2022,01-19,04:16
012 Boutonnet,1,11,12,2022,01-19,04:16
013 Emile Combes,1,7,8,2022,01-19,04:16
014 Beaux-Arts,3,5,8,2022,01-19,04:16
015 Les Aubes,5,3,8,2022,01-19,04:16
016 Antigone centre,15,1,16,2022,01-19,04:16
017 M�diath�que Emile Zola,11,5,16,2022,01-19,04:16
018 Nombre d'Or,15,1,16,2022,01-19,04:16
019 Louis Blanc,7,9,16,2022,01-19,04:16
020 Gambetta,4,4,8,2022,01-19,04:16
021 Port Marianne,16,0,16,2022,01-19,04:16
022 Clemenceau,4,8,12,2022,01-19,04:16
023 Les Arceaux,5,11,16,2022,01-19,04:16
024 Cit� Mion,3,5,8,2022,01-19,04:16
025 Nouveau Saint-Roch,4,4,8,2022,01-19,04:16
026 Renouvier,4,4,8,2022,01-19,04:16
027 Odysseum,4,4,8,2022,01-19,04:16
028 Saint-Denis,4,4,8,2022,01-19,04:16
029 Richter,15,1,16,2022,01-19,04:16
030 Charles Flahault,7,1,8,2022,01-19,04:16
031 Voltaire,3,5,8,2022,01-19,04:16
032 Pr�s d'Ar�nes,8,0,8,2022,01-19,04:16
033 Garcia Lorca,8,0,8,2022,01-19,04:16
034 Vert Bois,0,16,16,2022,01-19,04:16
035 Malbosc,2,6,8,2022,01-19,04:16
036 Occitanie,6,26,32,2022,01-19,04:16
037 FacdesSciences,4,20,24,2022,01-19,04:16
038 Fac de Lettres,1,15,16,2022,01-19,04:16
039 Aiguelongue,8,0,8,2022,01-19,04:16
040 Jeu de Mail des Abb�s,8,0,8,2022,01-19,04:16
041 Eurom�decine,0,8,8,2022,01-19,04:16
042 Marie Caizergues,4,4,8,2022,01-19,04:16
043 Sabines,3,5,8,2022,01-19,04:16
044 Celleneuve,1,7,8,2022,01-19,04:16
045 Jardin de la Lironde,1,7,8,2022,01-19,04:16
046 P�re Soulas,8,0,8,2022,01-19,04:16
047 Place Viala,3,5,8,2022,01-19,04:16
048 H�tel du D�partement,0,8,8,2022,01-19,04:16
049 Tonnelles,1,7,8,2022,01-19,04:16
050 Parvis Jules Ferry - Gare Saint-Roch,0,8,8,2022,01-19,04:16
051 Pont de Lattes - Gare Saint-Roch,3,9,12,2022,01-19,04:16
053 Deux Ponts - Gare Saint-Roch,2,6,8,2022,01-19,04:16
054 Providence - Ovalie,4,4,8,2022,01-19,04:16
055 P�rols Etang de l'Or,23,45,68,2022,01-19,04:16
056 Albert 1er - Cath�drale,1,11,12,2022,01-19,04:16
057 Saint-Guilhem - Courreau,5,3,8,2022,01-19,04:16
059 Sud De France,0,8,8,2022,01-19,04:16
001 Rue Jules Ferry - Gare Saint-Roch,1,11,12,2022,01-19,04:26
002 Com�die,4,20,24,2022,01-19,04:26
003 Esplanade,0,32,32,2022,01-19,04:26
004 H�tel de Ville,16,0,16,2022,01-19,04:26
005 Corum,10,2,12,2022,01-19,04:26
006 Place Albert 1er - St Charles,21,10,31,2022,01-19,04:26
007 Foch,2,6,8,2022,01-19,04:26
008 Halles Castellane,0,12,12,2022,01-19,04:26
009 Observatoire,7,1,8,2022,01-19,04:26
010 Rondelet,2,14,16,2022,01-19,04:26
011 Plan Cabanes,12,0,12,2022,01-19,04:26
012 Boutonnet,1,11,12,2022,01-19,04:26
013 Emile Combes,1,7,8,2022,01-19,04:26
014 Beaux-Arts,3,5,8,2022,01-19,04:26
015 Les Aubes,5,3,8,2022,01-19,04:26
016 Antigone centre,15,1,16,2022,01-19,04:26
017 M�diath�que Emile Zola,11,5,16,2022,01-19,04:26
018 Nombre d'Or,15,1,16,2022,01-19,04:26
019 Louis Blanc,7,9,16,2022,01-19,04:26
020 Gambetta,4,4,8,2022,01-19,04:26
021 Port Marianne,16,0,16,2022,01-19,04:26
022 Clemenceau,4,8,12,2022,01-19,04:26
023 Les Arceaux,5,11,16,2022,01-19,04:26
024 Cit� Mion,3,5,8,2022,01-19,04:26
025 Nouveau Saint-Roch,4,4,8,2022,01-19,04:26
026 Renouvier,4,4,8,2022,01-19,04:26
027 Odysseum,4,4,8,2022,01-19,04:26
028 Saint-Denis,4,4,8,2022,01-19,04:26
029 Richter,15,1,16,2022,01-19,04:26
030 Charles Flahault,7,1,8,2022,01-19,04:26
031 Voltaire,3,5,8,2022,01-19,04:26
032 Pr�s d'Ar�nes,8,0,8,2022,01-19,04:26
033 Garcia Lorca,8,0,8,2022,01-19,04:26
034 Vert Bois,0,16,16,2022,01-19,04:26
035 Malbosc,2,6,8,2022,01-19,04:26
036 Occitanie,5,27,32,2022,01-19,04:26
037 FacdesSciences,4,20,24,2022,01-19,04:26
038 Fac de Lettres,1,15,16,2022,01-19,04:26
039 Aiguelongue,8,0,8,2022,01-19,04:26
040 Jeu de Mail des Abb�s,8,0,8,2022,01-19,04:26
041 Eurom�decine,0,8,8,2022,01-19,04:26
042 Marie Caizergues,4,4,8,2022,01-19,04:26
043 Sabines,3,5,8,2022,01-19,04:26
044 Celleneuve,1,7,8,2022,01-19,04:26
045 Jardin de la Lironde,1,7,8,2022,01-19,04:26
046 P�re Soulas,8,0,8,2022,01-19,04:26
047 Place Viala,3,5,8,2022,01-19,04:26
048 H�tel du D�partement,0,8,8,2022,01-19,04:26
049 Tonnelles,1,7,8,2022,01-19,04:26
050 Parvis Jules Ferry - Gare Saint-Roch,0,8,8,2022,01-19,04:26
051 Pont de Lattes - Gare Saint-Roch,3,9,12,2022,01-19,04:26
053 Deux Ponts - Gare Saint-Roch,2,6,8,2022,01-19,04:26
054 Providence - Ovalie,4,4,8,2022,01-19,04:26
055 P�rols Etang de l'Or,23,45,68,2022,01-19,04:26
056 Albert 1er - Cath�drale,1,11,12,2022,01-19,04:26
057 Saint-Guilhem - Courreau,5,3,8,2022,01-19,04:26
059 Sud De France,0,8,8,2022,01-19,04:26
001 Rue Jules Ferry - Gare Saint-Roch,1,11,12,2022,01-19,04:37
002 Com�die,4,20,24,2022,01-19,04:37
003 Esplanade,0,32,32,2022,01-19,04:37
004 H�tel de Ville,16,0,16,2022,01-19,04:37
005 Corum,10,2,12,2022,01-19,04:37
006 Place Albert 1er - St Charles,21,10,31,2022,01-19,04:37
007 Foch,2,6,8,2022,01-19,04:37
008 Halles Castellane,0,12,12,2022,01-19,04:37
009 Observatoire,7,1,8,2022,01-19,04:37
010 Rondelet,2,14,16,2022,01-19,04:37
011 Plan Cabanes,12,0,12,2022,01-19,04:37
012 Boutonnet,1,11,12,2022,01-19,04:37
013 Emile Combes,1,7,8,2022,01-19,04:37
014 Beaux-Arts,3,5,8,2022,01-19,04:37
015 Les Aubes,5,3,8,2022,01-19,04:37
016 Antigone centre,15,1,16,2022,01-19,04:37
017 M�diath�que Emile Zola,11,5,16,2022,01-19,04:37
018 Nombre d'Or,15,1,16,2022,01-19,04:37
019 Louis Blanc,7,9,16,2022,01-19,04:37
020 Gambetta,4,4,8,2022,01-19,04:37
021 Port Marianne,16,0,16,2022,01-19,04:37
022 Clemenceau,4,8,12,2022,01-19,04:37
023 Les Arceaux,5,11,16,2022,01-19,04:37
024 Cit� Mion,3,5,8,2022,01-19,04:37
025 Nouveau Saint-Roch,4,4,8,2022,01-19,04:37
026 Renouvier,4,4,8,2022,01-19,04:37
027 Odysseum,4,4,8,2022,01-19,04:37
028 Saint-Denis,4,4,8,2022,01-19,04:37
029 Richter,15,1,16,2022,01-19,04:37
030 Charles Flahault,7,1,8,2022,01-19,04:37
031 Voltaire,3,5,8,2022,01-19,04:37
032 Pr�s d'Ar�nes,8,0,8,2022,01-19,04:37
033 Garcia Lorca,8,0,8,2022,01-19,04:37
034 Vert Bois,0,16,16,2022,01-19,04:37
035 Malbosc,2,6,8,2022,01-19,04:37
036 Occitanie,5,27,32,2022,01-19,04:37
037 FacdesSciences,3,21,24,2022,01-19,04:37
038 Fac de Lettres,1,15,16,2022,01-19,04:37
039 Aiguelongue,8,0,8,2022,01-19,04:37
040 Jeu de Mail des Abb�s,8,0,8,2022,01-19,04:37
041 Eurom�decine,0,8,8,2022,01-19,04:37
042 Marie Caizergues,4,4,8,2022,01-19,04:37
043 Sabines,3,5,8,2022,01-19,04:37
044 Celleneuve,1,7,8,2022,01-19,04:37
045 Jardin de la Lironde,1,7,8,2022,01-19,04:37
046 P�re Soulas,8,0,8,2022,01-19,04:37
047 Place Viala,3,5,8,2022,01-19,04:37
048 H�tel du D�partement,0,8,8,2022,01-19,04:37
049 Tonnelles,1,7,8,2022,01-19,04:37
050 Parvis Jules Ferry - Gare Saint-Roch,0,8,8,2022,01-19,04:37
051 Pont de Lattes - Gare Saint-Roch,3,9,12,2022,01-19,04:37
053 Deux Ponts - Gare Saint-Roch,2,6,8,2022,01-19,04:37
054 Providence - Ovalie,4,4,8,2022,01-19,04:37
055 P�rols Etang de l'Or,23,45,68,2022,01-19,04:37
056 Albert 1er - Cath�drale,1,11,12,2022,01-19,04:37
057 Saint-Guilhem - Courreau,5,3,8,2022,01-19,04:37
059 Sud De France,0,8,8,2022,01-19,04:37
001 Rue Jules Ferry - Gare Saint-Roch,1,11,12,2022,01-19,04:47
002 Com�die,4,20,24,2022,01-19,04:47
003 Esplanade,0,32,32,2022,01-19,04:47
004 H�tel de Ville,16,0,16,2022,01-19,04:47
005 Corum,10,2,12,2022,01-19,04:47
006 Place Albert 1er - St Charles,21,10,31,2022,01-19,04:47
007 Foch,2,6,8,2022,01-19,04:47
008 Halles Castellane,0,12,12,2022,01-19,04:47
009 Observatoire,7,1,8,2022,01-19,04:47
010 Rondelet,2,14,16,2022,01-19,04:47
011 Plan Cabanes,12,0,12,2022,01-19,04:47
012 Boutonnet,1,11,12,2022,01-19,04:47
013 Emile Combes,1,7,8,2022,01-19,04:47
014 Beaux-Arts,3,5,8,2022,01-19,04:47
015 Les Aubes,5,3,8,2022,01-19,04:47
016 Antigone centre,15,1,16,2022,01-19,04:47
017 M�diath�que Emile Zola,11,5,16,2022,01-19,04:47
018 Nombre d'Or,15,1,16,2022,01-19,04:47
019 Louis Blanc,6,10,16,2022,01-19,04:47
020 Gambetta,4,4,8,2022,01-19,04:47
021 Port Marianne,16,0,16,2022,01-19,04:47
022 Clemenceau,4,8,12,2022,01-19,04:47
023 Les Arceaux,5,11,16,2022,01-19,04:47
024 Cit� Mion,3,5,8,2022,01-19,04:47
025 Nouveau Saint-Roch,4,4,8,2022,01-19,04:47
026 Renouvier,4,4,8,2022,01-19,04:47
027 Odysseum,4,4,8,2022,01-19,04:47
028 Saint-Denis,4,4,8,2022,01-19,04:47
029 Richter,15,1,16,2022,01-19,04:47
030 Charles Flahault,7,1,8,2022,01-19,04:47
031 Voltaire,3,5,8,2022,01-19,04:47
032 Pr�s d'Ar�nes,8,0,8,2022,01-19,04:47
033 Garcia Lorca,8,0,8,2022,01-19,04:47
034 Vert Bois,0,16,16,2022,01-19,04:47
035 Malbosc,2,6,8,2022,01-19,04:47
036 Occitanie,5,27,32,2022,01-19,04:47
037 FacdesSciences,3,21,24,2022,01-19,04:47
038 Fac de Lettres,1,15,16,2022,01-19,04:47
039 Aiguelongue,7,1,8,2022,01-19,04:47
040 Jeu de Mail des Abb�s,8,0,8,2022,01-19,04:47
041 Eurom�decine,0,8,8,2022,01-19,04:47
042 Marie Caizergues,4,4,8,2022,01-19,04:47
043 Sabines,3,5,8,2022,01-19,04:47
044 Celleneuve,1,7,8,2022,01-19,04:47
045 Jardin de la Lironde,1,7,8,2022,01-19,04:47
046 P�re Soulas,8,0,8,2022,01-19,04:47
047 Place Viala,2,6,8,2022,01-19,04:47
048 H�tel du D�partement,0,8,8,2022,01-19,04:47
049 Tonnelles,1,7,8,2022,01-19,04:47
050 Parvis Jules Ferry - Gare Saint-Roch,0,8,8,2022,01-19,04:47
051 Pont de Lattes - Gare Saint-Roch,3,9,12,2022,01-19,04:47
053 Deux Ponts - Gare Saint-Roch,2,6,8,2022,01-19,04:47
054 Providence - Ovalie,4,4,8,2022,01-19,04:47
055 P�rols Etang de l'Or,23,45,68,2022,01-19,04:47
056 Albert 1er - Cath�drale,1,11,12,2022,01-19,04:47
057 Saint-Guilhem - Courreau,5,3,8,2022,01-19,04:47
059 Sud De France,0,8,8,2022,01-19,04:47
001 Rue Jules Ferry - Gare Saint-Roch,2,10,12,2022,01-19,04:57
002 Com�die,4,20,24,2022,01-19,04:57
003 Esplanade,1,31,32,2022,01-19,04:57
004 H�tel de Ville,16,0,16,2022,01-19,04:57
005 Corum,11,1,12,2022,01-19,04:57
006 Place Albert 1er - St Charles,21,10,31,2022,01-19,04:57
007 Foch,2,6,8,2022,01-19,04:57
008 Halles Castellane,0,12,12,2022,01-19,04:57
009 Observatoire,7,1,8,2022,01-19,04:57
010 Rondelet,2,14,16,2022,01-19,04:57
011 Plan Cabanes,12,0,12,2022,01-19,04:57
012 Boutonnet,1,11,12,2022,01-19,04:57
013 Emile Combes,1,7,8,2022,01-19,04:57
014 Beaux-Arts,3,5,8,2022,01-19,04:57
015 Les Aubes,5,3,8,2022,01-19,04:57
016 Antigone centre,15,1,16,2022,01-19,04:57
017 M�diath�que Emile Zola,11,5,16,2022,01-19,04:57
018 Nombre d'Or,15,1,16,2022,01-19,04:57
019 Louis Blanc,6,10,16,2022,01-19,04:57
020 Gambetta,4,4,8,2022,01-19,04:57
021 Port Marianne,16,0,16,2022,01-19,04:57
022 Clemenceau,4,8,12,2022,01-19,04:57
023 Les Arceaux,5,11,16,2022,01-19,04:57
024 Cit� Mion,3,5,8,2022,01-19,04:57
025 Nouveau Saint-Roch,4,4,8,2022,01-19,04:57
026 Renouvier,4,4,8,2022,01-19,04:57
027 Odysseum,4,4,8,2022,01-19,04:57
028 Saint-Denis,4,4,8,2022,01-19,04:57
029 Richter,15,1,16,2022,01-19,04:57
030 Charles Flahault,7,1,8,2022,01-19,04:57
031 Voltaire,3,5,8,2022,01-19,04:57
032 Pr�s d'Ar�nes,8,0,8,2022,01-19,04:57
033 Garcia Lorca,8,0,8,2022,01-19,04:57
034 Vert Bois,0,16,16,2022,01-19,04:57
035 Malbosc,2,6,8,2022,01-19,04:57
036 Occitanie,6,26,32,2022,01-19,04:57
037 FacdesSciences,3,21,24,2022,01-19,04:57
038 Fac de Lettres,1,15,16,2022,01-19,04:57
039 Aiguelongue,6,2,8,2022,01-19,04:57
040 Jeu de Mail des Abb�s,8,0,8,2022,01-19,04:57
041 Eurom�decine,0,8,8,2022,01-19,04:57
042 Marie Caizergues,4,4,8,2022,01-19,04:57
043 Sabines,3,5,8,2022,01-19,04:57
044 Celleneuve,1,7,8,2022,01-19,04:57
045 Jardin de la Lironde,1,7,8,2022,01-19,04:57
046 P�re Soulas,8,0,8,2022,01-19,04:57
047 Place Viala,2,6,8,2022,01-19,04:57
048 H�tel du D�partement,0,8,8,2022,01-19,04:57
049 Tonnelles,1,7,8,2022,01-19,04:57
050 Parvis Jules Ferry - Gare Saint-Roch,0,8,8,2022,01-19,04:57
051 Pont de Lattes - Gare Saint-Roch,3,9,12,2022,01-19,04:57
053 Deux Ponts - Gare Saint-Roch,2,6,8,2022,01-19,04:57
054 Providence - Ovalie,4,4,8,2022,01-19,04:57
055 P�rols Etang de l'Or,23,45,68,2022,01-19,04:57
056 Albert 1er - Cath�drale,1,11,12,2022,01-19,04:57
057 Saint-Guilhem - Courreau,5,3,8,2022,01-19,04:57
059 Sud De France,0,8,8,2022,01-19,04:57
001 Rue Jules Ferry - Gare Saint-Roch,3,9,12,2022,01-19,05:07
002 Com�die,4,20,24,2022,01-19,05:07
003 Esplanade,1,31,32,2022,01-19,05:07
004 H�tel de Ville,16,0,16,2022,01-19,05:07
005 Corum,11,1,12,2022,01-19,05:07
006 Place Albert 1er - St Charles,21,10,31,2022,01-19,05:07
007 Foch,2,6,8,2022,01-19,05:07
008 Halles Castellane,0,12,12,2022,01-19,05:07
009 Observatoire,7,1,8,2022,01-19,05:07
010 Rondelet,2,14,16,2022,01-19,05:07
011 Plan Cabanes,12,0,12,2022,01-19,05:07
012 Boutonnet,1,11,12,2022,01-19,05:07
013 Emile Combes,1,7,8,2022,01-19,05:07
014 Beaux-Arts,3,5,8,2022,01-19,05:07
015 Les Aubes,5,3,8,2022,01-19,05:07
016 Antigone centre,15,1,16,2022,01-19,05:07
017 M�diath�que Emile Zola,12,4,16,2022,01-19,05:07
018 Nombre d'Or,15,1,16,2022,01-19,05:07
019 Louis Blanc,6,10,16,2022,01-19,05:07
020 Gambetta,4,4,8,2022,01-19,05:07
021 Port Marianne,16,0,16,2022,01-19,05:07
022 Clemenceau,4,8,12,2022,01-19,05:07
023 Les Arceaux,5,11,16,2022,01-19,05:07
024 Cit� Mion,3,5,8,2022,01-19,05:07
025 Nouveau Saint-Roch,4,4,8,2022,01-19,05:07
026 Renouvier,4,4,8,2022,01-19,05:07
027 Odysseum,4,4,8,2022,01-19,05:07
028 Saint-Denis,4,4,8,2022,01-19,05:07
029 Richter,15,1,16,2022,01-19,05:07
030 Charles Flahault,7,1,8,2022,01-19,05:07
031 Voltaire,3,5,8,2022,01-19,05:07
032 Pr�s d'Ar�nes,8,0,8,2022,01-19,05:07
033 Garcia Lorca,8,0,8,2022,01-19,05:07
034 Vert Bois,0,16,16,2022,01-19,05:07
035 Malbosc,2,6,8,2022,01-19,05:07
036 Occitanie,6,26,32,2022,01-19,05:07
037 FacdesSciences,3,21,24,2022,01-19,05:07
038 Fac de Lettres,1,15,16,2022,01-19,05:07
039 Aiguelongue,6,2,8,2022,01-19,05:07
040 Jeu de Mail des Abb�s,8,0,8,2022,01-19,05:07
041 Eurom�decine,0,8,8,2022,01-19,05:07
042 Marie Caizergues,4,4,8,2022,01-19,05:07
043 Sabines,3,5,8,2022,01-19,05:07
044 Celleneuve,1,7,8,2022,01-19,05:07
045 Jardin de la Lironde,1,7,8,2022,01-19,05:07
046 P�re Soulas,8,0,8,2022,01-19,05:07
047 Place Viala,2,6,8,2022,01-19,05:07
048 H�tel du D�partement,0,8,8,2022,01-19,05:07
049 Tonnelles,1,7,8,2022,01-19,05:07
050 Parvis Jules Ferry - Gare Saint-Roch,0,8,8,2022,01-19,05:07
051 Pont de Lattes - Gare Saint-Roch,3,9,12,2022,01-19,05:07
053 Deux Ponts - Gare Saint-Roch,2,6,8,2022,01-19,05:07
054 Providence - Ovalie,4,4,8,2022,01-19,05:07
055 P�rols Etang de l'Or,23,45,68,2022,01-19,05:07
056 Albert 1er - Cath�drale,1,11,12,2022,01-19,05:07
057 Saint-Guilhem - Courreau,5,3,8,2022,01-19,05:07
059 Sud De France,0,8,8,2022,01-19,05:07
001 Rue Jules Ferry - Gare Saint-Roch,3,9,12,2022,01-19,05:17
002 Com�die,4,20,24,2022,01-19,05:17
003 Esplanade,1,31,32,2022,01-19,05:17
004 H�tel de Ville,16,0,16,2022,01-19,05:17
005 Corum,11,1,12,2022,01-19,05:17
006 Place Albert 1er - St Charles,21,10,31,2022,01-19,05:17
007 Foch,2,6,8,2022,01-19,05:17
008 Halles Castellane,0,12,12,2022,01-19,05:17
009 Observatoire,7,1,8,2022,01-19,05:17
010 Rondelet,2,14,16,2022,01-19,05:17
011 Plan Cabanes,12,0,12,2022,01-19,05:17
012 Boutonnet,1,11,12,2022,01-19,05:17
013 Emile Combes,1,7,8,2022,01-19,05:17
014 Beaux-Arts,3,5,8,2022,01-19,05:17
015 Les Aubes,5,3,8,2022,01-19,05:17
016 Antigone centre,15,1,16,2022,01-19,05:17
017 M�diath�que Emile Zola,12,4,16,2022,01-19,05:17
018 Nombre d'Or,15,1,16,2022,01-19,05:17
019 Louis Blanc,6,10,16,2022,01-19,05:17
020 Gambetta,4,4,8,2022,01-19,05:17
021 Port Marianne,16,0,16,2022,01-19,05:17
022 Clemenceau,4,8,12,2022,01-19,05:17
023 Les Arceaux,5,11,16,2022,01-19,05:17
024 Cit� Mion,3,5,8,2022,01-19,05:17
025 Nouveau Saint-Roch,4,4,8,2022,01-19,05:17
026 Renouvier,4,4,8,2022,01-19,05:17
027 Odysseum,4,4,8,2022,01-19,05:17
028 Saint-Denis,4,4,8,2022,01-19,05:17
029 Richter,15,1,16,2022,01-19,05:17
030 Charles Flahault,7,1,8,2022,01-19,05:17
031 Voltaire,3,5,8,2022,01-19,05:17
032 Pr�s d'Ar�nes,8,0,8,2022,01-19,05:17
033 Garcia Lorca,8,0,8,2022,01-19,05:17
034 Vert Bois,0,16,16,2022,01-19,05:17
035 Malbosc,2,6,8,2022,01-19,05:17
036 Occitanie,6,26,32,2022,01-19,05:17
037 FacdesSciences,3,21,24,2022,01-19,05:17
038 Fac de Lettres,1,15,16,2022,01-19,05:17
039 Aiguelongue,6,2,8,2022,01-19,05:17
040 Jeu de Mail des Abb�s,8,0,8,2022,01-19,05:17
041 Eurom�decine,0,8,8,2022,01-19,05:17
042 Marie Caizergues,4,4,8,2022,01-19,05:17
043 Sabines,3,5,8,2022,01-19,05:17
044 Celleneuve,1,7,8,2022,01-19,05:17
045 Jardin de la Lironde,1,7,8,2022,01-19,05:17
046 P�re Soulas,8,0,8,2022,01-19,05:17
047 Place Viala,2,6,8,2022,01-19,05:17
048 H�tel du D�partement,0,8,8,2022,01-19,05:17
049 Tonnelles,1,7,8,2022,01-19,05:17
050 Parvis Jules Ferry - Gare Saint-Roch,0,8,8,2022,01-19,05:17
051 Pont de Lattes - Gare Saint-Roch,3,9,12,2022,01-19,05:17
053 Deux Ponts - Gare Saint-Roch,2,6,8,2022,01-19,05:17
054 Providence - Ovalie,4,4,8,2022,01-19,05:17
055 P�rols Etang de l'Or,23,45,68,2022,01-19,05:17
056 Albert 1er - Cath�drale,1,11,12,2022,01-19,05:17
057 Saint-Guilhem - Courreau,5,3,8,2022,01-19,05:17
059 Sud De France,0,8,8,2022,01-19,05:17
001 Rue Jules Ferry - Gare Saint-Roch,3,9,12,2022,01-19,05:27
002 Com�die,4,20,24,2022,01-19,05:27
003 Esplanade,1,31,32,2022,01-19,05:27
004 H�tel de Ville,16,0,16,2022,01-19,05:27
005 Corum,11,1,12,2022,01-19,05:27
006 Place Albert 1er - St Charles,21,10,31,2022,01-19,05:27
007 Foch,2,6,8,2022,01-19,05:27
008 Halles Castellane,0,12,12,2022,01-19,05:27
009 Observatoire,7,1,8,2022,01-19,05:27
010 Rondelet,2,14,16,2022,01-19,05:27
011 Plan Cabanes,12,0,12,2022,01-19,05:27
012 Boutonnet,1,11,12,2022,01-19,05:27
013 Emile Combes,1,7,8,2022,01-19,05:27
014 Beaux-Arts,3,5,8,2022,01-19,05:27
015 Les Aubes,5,3,8,2022,01-19,05:27
016 Antigone centre,15,1,16,2022,01-19,05:27
017 M�diath�que Emile Zola,12,4,16,2022,01-19,05:27
018 Nombre d'Or,15,1,16,2022,01-19,05:27
019 Louis Blanc,6,10,16,2022,01-19,05:27
020 Gambetta,4,4,8,2022,01-19,05:27
021 Port Marianne,16,0,16,2022,01-19,05:27
022 Clemenceau,4,8,12,2022,01-19,05:27
023 Les Arceaux,5,11,16,2022,01-19,05:27
024 Cit� Mion,3,5,8,2022,01-19,05:27
025 Nouveau Saint-Roch,4,4,8,2022,01-19,05:27
026 Renouvier,4,4,8,2022,01-19,05:27
027 Odysseum,4,4,8,2022,01-19,05:27
028 Saint-Denis,4,4,8,2022,01-19,05:27
029 Richter,15,1,16,2022,01-19,05:27
030 Charles Flahault,7,1,8,2022,01-19,05:27
031 Voltaire,3,5,8,2022,01-19,05:27
032 Pr�s d'Ar�nes,8,0,8,2022,01-19,05:27
033 Garcia Lorca,8,0,8,2022,01-19,05:27
034 Vert Bois,0,16,16,2022,01-19,05:27
035 Malbosc,2,6,8,2022,01-19,05:27
036 Occitanie,6,26,32,2022,01-19,05:27
037 FacdesSciences,3,21,24,2022,01-19,05:27
038 Fac de Lettres,1,15,16,2022,01-19,05:27
039 Aiguelongue,5,3,8,2022,01-19,05:27
040 Jeu de Mail des Abb�s,8,0,8,2022,01-19,05:27
041 Eurom�decine,0,8,8,2022,01-19,05:27
042 Marie Caizergues,4,4,8,2022,01-19,05:27
043 Sabines,3,5,8,2022,01-19,05:27
044 Celleneuve,1,7,8,2022,01-19,05:27
045 Jardin de la Lironde,1,7,8,2022,01-19,05:27
046 P�re Soulas,8,0,8,2022,01-19,05:27
047 Place Viala,2,6,8,2022,01-19,05:27
048 H�tel du D�partement,0,8,8,2022,01-19,05:27
049 Tonnelles,1,7,8,2022,01-19,05:27
050 Parvis Jules Ferry - Gare Saint-Roch,0,8,8,2022,01-19,05:27
051 Pont de Lattes - Gare Saint-Roch,3,9,12,2022,01-19,05:27
053 Deux Ponts - Gare Saint-Roch,2,6,8,2022,01-19,05:27
054 Providence - Ovalie,4,4,8,2022,01-19,05:27
055 P�rols Etang de l'Or,23,45,68,2022,01-19,05:27
056 Albert 1er - Cath�drale,1,11,12,2022,01-19,05:27
057 Saint-Guilhem - Courreau,5,3,8,2022,01-19,05:27
059 Sud De France,0,8,8,2022,01-19,05:27
001 Rue Jules Ferry - Gare Saint-Roch,3,9,12,2022,01-19,05:38
002 Com�die,4,20,24,2022,01-19,05:38
003 Esplanade,1,31,32,2022,01-19,05:38
004 H�tel de Ville,16,0,16,2022,01-19,05:38
005 Corum,11,1,12,2022,01-19,05:38
006 Place Albert 1er - St Charles,21,10,31,2022,01-19,05:38
007 Foch,2,6,8,2022,01-19,05:38
008 Halles Castellane,0,12,12,2022,01-19,05:38
009 Observatoire,7,1,8,2022,01-19,05:38
010 Rondelet,2,14,16,2022,01-19,05:38
011 Plan Cabanes,12,0,12,2022,01-19,05:38
012 Boutonnet,1,11,12,2022,01-19,05:38
013 Emile Combes,1,7,8,2022,01-19,05:38
014 Beaux-Arts,3,5,8,2022,01-19,05:38
015 Les Aubes,5,3,8,2022,01-19,05:38
016 Antigone centre,15,1,16,2022,01-19,05:38
017 M�diath�que Emile Zola,12,4,16,2022,01-19,05:38
018 Nombre d'Or,15,1,16,2022,01-19,05:38
019 Louis Blanc,7,9,16,2022,01-19,05:38
020 Gambetta,4,4,8,2022,01-19,05:38
021 Port Marianne,16,0,16,2022,01-19,05:38
022 Clemenceau,4,8,12,2022,01-19,05:38
023 Les Arceaux,5,11,16,2022,01-19,05:38
024 Cit� Mion,3,5,8,2022,01-19,05:38
025 Nouveau Saint-Roch,4,4,8,2022,01-19,05:38
026 Renouvier,4,4,8,2022,01-19,05:38
027 Odysseum,4,4,8,2022,01-19,05:38
028 Saint-Denis,4,4,8,2022,01-19,05:38
029 Richter,15,1,16,2022,01-19,05:38
030 Charles Flahault,7,1,8,2022,01-19,05:38
031 Voltaire,3,5,8,2022,01-19,05:38
032 Pr�s d'Ar�nes,8,0,8,2022,01-19,05:38
033 Garcia Lorca,8,0,8,2022,01-19,05:38
034 Vert Bois,0,16,16,2022,01-19,05:38
035 Malbosc,2,6,8,2022,01-19,05:38
036 Occitanie,6,26,32,2022,01-19,05:38
037 FacdesSciences,3,21,24,2022,01-19,05:38
038 Fac de Lettres,1,15,16,2022,01-19,05:38
039 Aiguelongue,5,3,8,2022,01-19,05:38
040 Jeu de Mail des Abb�s,8,0,8,2022,01-19,05:38
041 Eurom�decine,0,8,8,2022,01-19,05:38
042 Marie Caizergues,4,4,8,2022,01-19,05:38
043 Sabines,3,5,8,2022,01-19,05:38
044 Celleneuve,1,7,8,2022,01-19,05:38
045 Jardin de la Lironde,1,7,8,2022,01-19,05:38
046 P�re Soulas,8,0,8,2022,01-19,05:38
047 Place Viala,2,6,8,2022,01-19,05:38
048 H�tel du D�partement,0,8,8,2022,01-19,05:38
049 Tonnelles,1,7,8,2022,01-19,05:38
050 Parvis Jules Ferry - Gare Saint-Roch,0,8,8,2022,01-19,05:38
051 Pont de Lattes - Gare Saint-Roch,3,9,12,2022,01-19,05:38
053 Deux Ponts - Gare Saint-Roch,2,6,8,2022,01-19,05:38
054 Providence - Ovalie,4,4,8,2022,01-19,05:38
055 P�rols Etang de l'Or,23,45,68,2022,01-19,05:38
056 Albert 1er - Cath�drale,1,11,12,2022,01-19,05:38
057 Saint-Guilhem - Courreau,5,3,8,2022,01-19,05:38
059 Sud De France,0,8,8,2022,01-19,05:38
001 Rue Jules Ferry - Gare Saint-Roch,3,9,12,2022,01-19,05:48
002 Com�die,4,20,24,2022,01-19,05:48
003 Esplanade,1,31,32,2022,01-19,05:48
004 H�tel de Ville,16,0,16,2022,01-19,05:48
005 Corum,11,1,12,2022,01-19,05:48
006 Place Albert 1er - St Charles,21,10,31,2022,01-19,05:48
007 Foch,2,6,8,2022,01-19,05:48
008 Halles Castellane,0,12,12,2022,01-19,05:48
009 Observatoire,7,1,8,2022,01-19,05:48
010 Rondelet,2,14,16,2022,01-19,05:48
011 Plan Cabanes,12,0,12,2022,01-19,05:48
012 Boutonnet,1,11,12,2022,01-19,05:48
013 Emile Combes,1,7,8,2022,01-19,05:48
014 Beaux-Arts,3,5,8,2022,01-19,05:48
015 Les Aubes,5,3,8,2022,01-19,05:48
016 Antigone centre,15,1,16,2022,01-19,05:48
017 M�diath�que Emile Zola,12,4,16,2022,01-19,05:48
018 Nombre d'Or,15,1,16,2022,01-19,05:48
019 Louis Blanc,7,9,16,2022,01-19,05:48
020 Gambetta,4,4,8,2022,01-19,05:48
021 Port Marianne,16,0,16,2022,01-19,05:48
022 Clemenceau,4,8,12,2022,01-19,05:48
023 Les Arceaux,5,11,16,2022,01-19,05:48
024 Cit� Mion,3,5,8,2022,01-19,05:48
025 Nouveau Saint-Roch,4,4,8,2022,01-19,05:48
026 Renouvier,4,4,8,2022,01-19,05:48
027 Odysseum,4,4,8,2022,01-19,05:48
028 Saint-Denis,4,4,8,2022,01-19,05:48
029 Richter,15,1,16,2022,01-19,05:48
030 Charles Flahault,7,1,8,2022,01-19,05:48
031 Voltaire,3,5,8,2022,01-19,05:48
032 Pr�s d'Ar�nes,8,0,8,2022,01-19,05:48
033 Garcia Lorca,8,0,8,2022,01-19,05:48
034 Vert Bois,0,16,16,2022,01-19,05:48
035 Malbosc,2,6,8,2022,01-19,05:48
036 Occitanie,6,26,32,2022,01-19,05:48
037 FacdesSciences,3,21,24,2022,01-19,05:48
038 Fac de Lettres,1,15,16,2022,01-19,05:48
039 Aiguelongue,4,4,8,2022,01-19,05:48
040 Jeu de Mail des Abb�s,8,0,8,2022,01-19,05:48
041 Eurom�decine,0,8,8,2022,01-19,05:48
042 Marie Caizergues,4,4,8,2022,01-19,05:48
043 Sabines,3,5,8,2022,01-19,05:48
044 Celleneuve,1,7,8,2022,01-19,05:48
045 Jardin de la Lironde,1,7,8,2022,01-19,05:48
046 P�re Soulas,8,0,8,2022,01-19,05:48
047 Place Viala,2,6,8,2022,01-19,05:48
048 H�tel du D�partement,0,8,8,2022,01-19,05:48
049 Tonnelles,1,7,8,2022,01-19,05:48
050 Parvis Jules Ferry - Gare Saint-Roch,0,8,8,2022,01-19,05:48
051 Pont de Lattes - Gare Saint-Roch,3,9,12,2022,01-19,05:48
053 Deux Ponts - Gare Saint-Roch,2,6,8,2022,01-19,05:48
054 Providence - Ovalie,4,4,8,2022,01-19,05:48
055 P�rols Etang de l'Or,23,45,68,2022,01-19,05:48
056 Albert 1er - Cath�drale,1,11,12,2022,01-19,05:48
057 Saint-Guilhem - Courreau,5,3,8,2022,01-19,05:48
059 Sud De France,0,8,8,2022,01-19,05:48
001 Rue Jules Ferry - Gare Saint-Roch,3,9,12,2022,01-19,05:58
002 Com�die,4,20,24,2022,01-19,05:58
003 Esplanade,1,31,32,2022,01-19,05:58
004 H�tel de Ville,16,0,16,2022,01-19,05:58
005 Corum,11,1,12,2022,01-19,05:58
006 Place Albert 1er - St Charles,21,10,31,2022,01-19,05:58
007 Foch,2,6,8,2022,01-19,05:58
008 Halles Castellane,0,12,12,2022,01-19,05:58
009 Observatoire,7,1,8,2022,01-19,05:58
010 Rondelet,2,14,16,2022,01-19,05:58
011 Plan Cabanes,12,0,12,2022,01-19,05:58
012 Boutonnet,1,11,12,2022,01-19,05:58
013 Emile Combes,1,7,8,2022,01-19,05:58
014 Beaux-Arts,3,5,8,2022,01-19,05:58
015 Les Aubes,5,3,8,2022,01-19,05:58
016 Antigone centre,15,1,16,2022,01-19,05:58
017 M�diath�que Emile Zola,12,4,16,2022,01-19,05:58
018 Nombre d'Or,15,1,16,2022,01-19,05:58
019 Louis Blanc,7,9,16,2022,01-19,05:58
020 Gambetta,4,4,8,2022,01-19,05:58
021 Port Marianne,16,0,16,2022,01-19,05:58
022 Clemenceau,4,8,12,2022,01-19,05:58
023 Les Arceaux,5,11,16,2022,01-19,05:58
024 Cit� Mion,3,5,8,2022,01-19,05:58
025 Nouveau Saint-Roch,4,4,8,2022,01-19,05:58
026 Renouvier,4,4,8,2022,01-19,05:58
027 Odysseum,4,4,8,2022,01-19,05:58
028 Saint-Denis,4,4,8,2022,01-19,05:58
029 Richter,15,1,16,2022,01-19,05:58
030 Charles Flahault,7,1,8,2022,01-19,05:58
031 Voltaire,3,5,8,2022,01-19,05:58
032 Pr�s d'Ar�nes,8,0,8,2022,01-19,05:58
033 Garcia Lorca,8,0,8,2022,01-19,05:58
034 Vert Bois,0,16,16,2022,01-19,05:58
035 Malbosc,2,6,8,2022,01-19,05:58
036 Occitanie,6,26,32,2022,01-19,05:58
037 FacdesSciences,3,21,24,2022,01-19,05:58
038 Fac de Lettres,1,15,16,2022,01-19,05:58
039 Aiguelongue,4,4,8,2022,01-19,05:58
040 Jeu de Mail des Abb�s,8,0,8,2022,01-19,05:58
041 Eurom�decine,0,8,8,2022,01-19,05:58
042 Marie Caizergues,4,4,8,2022,01-19,05:58
043 Sabines,3,5,8,2022,01-19,05:58
044 Celleneuve,1,7,8,2022,01-19,05:58
045 Jardin de la Lironde,1,7,8,2022,01-19,05:58
046 P�re Soulas,8,0,8,2022,01-19,05:58
047 Place Viala,2,6,8,2022,01-19,05:58
048 H�tel du D�partement,0,8,8,2022,01-19,05:58
049 Tonnelles,1,7,8,2022,01-19,05:58
050 Parvis Jules Ferry - Gare Saint-Roch,0,8,8,2022,01-19,05:58
051 Pont de Lattes - Gare Saint-Roch,3,9,12,2022,01-19,05:58
053 Deux Ponts - Gare Saint-Roch,2,6,8,2022,01-19,05:58
054 Providence - Ovalie,4,4,8,2022,01-19,05:58
055 P�rols Etang de l'Or,23,45,68,2022,01-19,05:58
056 Albert 1er - Cath�drale,1,11,12,2022,01-19,05:58
057 Saint-Guilhem - Courreau,5,3,8,2022,01-19,05:58
059 Sud De France,0,8,8,2022,01-19,05:58
001 Rue Jules Ferry - Gare Saint-Roch,3,9,12,2022,01-19,06:08
002 Com�die,4,20,24,2022,01-19,06:08
003 Esplanade,1,31,32,2022,01-19,06:08
004 H�tel de Ville,16,0,16,2022,01-19,06:08
005 Corum,11,1,12,2022,01-19,06:08
006 Place Albert 1er - St Charles,21,10,31,2022,01-19,06:08
007 Foch,2,6,8,2022,01-19,06:08
008 Halles Castellane,0,12,12,2022,01-19,06:08
009 Observatoire,7,1,8,2022,01-19,06:08
010 Rondelet,2,14,16,2022,01-19,06:08
011 Plan Cabanes,12,0,12,2022,01-19,06:08
012 Boutonnet,1,11,12,2022,01-19,06:08
013 Emile Combes,1,7,8,2022,01-19,06:08
014 Beaux-Arts,3,5,8,2022,01-19,06:08
015 Les Aubes,5,3,8,2022,01-19,06:08
016 Antigone centre,15,1,16,2022,01-19,06:08
017 M�diath�que Emile Zola,12,4,16,2022,01-19,06:08
018 Nombre d'Or,15,1,16,2022,01-19,06:08
019 Louis Blanc,7,9,16,2022,01-19,06:08
020 Gambetta,4,4,8,2022,01-19,06:08
021 Port Marianne,16,0,16,2022,01-19,06:08
022 Clemenceau,4,8,12,2022,01-19,06:08
023 Les Arceaux,5,11,16,2022,01-19,06:08
024 Cit� Mion,3,5,8,2022,01-19,06:08
025 Nouveau Saint-Roch,4,4,8,2022,01-19,06:08
026 Renouvier,4,4,8,2022,01-19,06:08
027 Odysseum,4,4,8,2022,01-19,06:08
028 Saint-Denis,4,4,8,2022,01-19,06:08
029 Richter,15,1,16,2022,01-19,06:08
030 Charles Flahault,7,1,8,2022,01-19,06:08
031 Voltaire,3,5,8,2022,01-19,06:08
032 Pr�s d'Ar�nes,8,0,8,2022,01-19,06:08
033 Garcia Lorca,8,0,8,2022,01-19,06:08
034 Vert Bois,0,16,16,2022,01-19,06:08
035 Malbosc,2,6,8,2022,01-19,06:08
036 Occitanie,6,26,32,2022,01-19,06:08
037 FacdesSciences,4,20,24,2022,01-19,06:08
038 Fac de Lettres,1,15,16,2022,01-19,06:08
039 Aiguelongue,4,4,8,2022,01-19,06:08
040 Jeu de Mail des Abb�s,8,0,8,2022,01-19,06:08
041 Eurom�decine,0,8,8,2022,01-19,06:08
042 Marie Caizergues,4,4,8,2022,01-19,06:08
043 Sabines,3,5,8,2022,01-19,06:08
044 Celleneuve,1,7,8,2022,01-19,06:08
045 Jardin de la Lironde,1,7,8,2022,01-19,06:08
046 P�re Soulas,8,0,8,2022,01-19,06:08
047 Place Viala,2,6,8,2022,01-19,06:08
048 H�tel du D�partement,0,8,8,2022,01-19,06:08
049 Tonnelles,1,7,8,2022,01-19,06:08
050 Parvis Jules Ferry - Gare Saint-Roch,0,8,8,2022,01-19,06:08
051 Pont de Lattes - Gare Saint-Roch,3,9,12,2022,01-19,06:08
053 Deux Ponts - Gare Saint-Roch,2,6,8,2022,01-19,06:08
054 Providence - Ovalie,4,4,8,2022,01-19,06:08
055 P�rols Etang de l'Or,23,45,68,2022,01-19,06:08
056 Albert 1er - Cath�drale,1,11,12,2022,01-19,06:08
057 Saint-Guilhem - Courreau,5,3,8,2022,01-19,06:08
059 Sud De France,0,8,8,2022,01-19,06:08
001 Rue Jules Ferry - Gare Saint-Roch,3,9,12,2022,01-19,06:18
002 Com�die,4,20,24,2022,01-19,06:18
003 Esplanade,1,31,32,2022,01-19,06:18
004 H�tel de Ville,16,0,16,2022,01-19,06:18
005 Corum,10,2,12,2022,01-19,06:18
006 Place Albert 1er - St Charles,21,10,31,2022,01-19,06:18
007 Foch,2,6,8,2022,01-19,06:18
008 Halles Castellane,0,12,12,2022,01-19,06:18
009 Observatoire,7,1,8,2022,01-19,06:18
010 Rondelet,2,14,16,2022,01-19,06:18
011 Plan Cabanes,12,0,12,2022,01-19,06:18
012 Boutonnet,1,11,12,2022,01-19,06:18
013 Emile Combes,1,7,8,2022,01-19,06:18
014 Beaux-Arts,3,5,8,2022,01-19,06:18
015 Les Aubes,5,3,8,2022,01-19,06:18
016 Antigone centre,15,1,16,2022,01-19,06:18
017 M�diath�que Emile Zola,12,4,16,2022,01-19,06:18
018 Nombre d'Or,15,1,16,2022,01-19,06:18
019 Louis Blanc,7,9,16,2022,01-19,06:18
020 Gambetta,4,4,8,2022,01-19,06:18
021 Port Marianne,16,0,16,2022,01-19,06:18
022 Clemenceau,4,8,12,2022,01-19,06:18
023 Les Arceaux,5,11,16,2022,01-19,06:18
024 Cit� Mion,3,5,8,2022,01-19,06:18
025 Nouveau Saint-Roch,4,4,8,2022,01-19,06:18
026 Renouvier,4,4,8,2022,01-19,06:18
027 Odysseum,4,4,8,2022,01-19,06:18
028 Saint-Denis,4,4,8,2022,01-19,06:18
029 Richter,15,1,16,2022,01-19,06:18
030 Charles Flahault,7,1,8,2022,01-19,06:18
031 Voltaire,3,5,8,2022,01-19,06:18
032 Pr�s d'Ar�nes,8,0,8,2022,01-19,06:18
033 Garcia Lorca,8,0,8,2022,01-19,06:18
034 Vert Bois,0,16,16,2022,01-19,06:18
035 Malbosc,2,6,8,2022,01-19,06:18
036 Occitanie,6,26,32,2022,01-19,06:18
037 FacdesSciences,4,20,24,2022,01-19,06:18
038 Fac de Lettres,1,15,16,2022,01-19,06:18
039 Aiguelongue,4,4,8,2022,01-19,06:18
040 Jeu de Mail des Abb�s,8,0,8,2022,01-19,06:18
041 Eurom�decine,0,8,8,2022,01-19,06:18
042 Marie Caizergues,4,4,8,2022,01-19,06:18
043 Sabines,3,5,8,2022,01-19,06:18
044 Celleneuve,1,7,8,2022,01-19,06:18
045 Jardin de la Lironde,1,7,8,2022,01-19,06:18
046 P�re Soulas,8,0,8,2022,01-19,06:18
047 Place Viala,2,6,8,2022,01-19,06:18
048 H�tel du D�partement,0,8,8,2022,01-19,06:18
049 Tonnelles,1,7,8,2022,01-19,06:18
050 Parvis Jules Ferry - Gare Saint-Roch,0,8,8,2022,01-19,06:18
051 Pont de Lattes - Gare Saint-Roch,3,9,12,2022,01-19,06:18
053 Deux Ponts - Gare Saint-Roch,2,6,8,2022,01-19,06:18
054 Providence - Ovalie,4,4,8,2022,01-19,06:18
055 P�rols Etang de l'Or,23,45,68,2022,01-19,06:18
056 Albert 1er - Cath�drale,1,11,12,2022,01-19,06:18
057 Saint-Guilhem - Courreau,5,3,8,2022,01-19,06:18
059 Sud De France,0,8,8,2022,01-19,06:18
001 Rue Jules Ferry - Gare Saint-Roch,3,9,12,2022,01-19,06:28
002 Com�die,4,20,24,2022,01-19,06:28
003 Esplanade,1,31,32,2022,01-19,06:28
004 H�tel de Ville,16,0,16,2022,01-19,06:28
005 Corum,10,2,12,2022,01-19,06:28
006 Place Albert 1er - St Charles,21,10,31,2022,01-19,06:28
007 Foch,2,6,8,2022,01-19,06:28
008 Halles Castellane,0,12,12,2022,01-19,06:28
009 Observatoire,7,1,8,2022,01-19,06:28
010 Rondelet,2,14,16,2022,01-19,06:28
011 Plan Cabanes,12,0,12,2022,01-19,06:28
012 Boutonnet,1,11,12,2022,01-19,06:28
013 Emile Combes,1,7,8,2022,01-19,06:28
014 Beaux-Arts,3,5,8,2022,01-19,06:28
015 Les Aubes,5,3,8,2022,01-19,06:28
016 Antigone centre,14,2,16,2022,01-19,06:28
017 M�diath�que Emile Zola,12,4,16,2022,01-19,06:28
018 Nombre d'Or,15,1,16,2022,01-19,06:28
019 Louis Blanc,7,9,16,2022,01-19,06:28
020 Gambetta,4,4,8,2022,01-19,06:28
021 Port Marianne,16,0,16,2022,01-19,06:28
022 Clemenceau,4,8,12,2022,01-19,06:28
023 Les Arceaux,5,11,16,2022,01-19,06:28
024 Cit� Mion,3,5,8,2022,01-19,06:28
025 Nouveau Saint-Roch,4,4,8,2022,01-19,06:28
026 Renouvier,4,4,8,2022,01-19,06:28
027 Odysseum,4,4,8,2022,01-19,06:28
028 Saint-Denis,4,4,8,2022,01-19,06:28
029 Richter,15,1,16,2022,01-19,06:28
030 Charles Flahault,7,1,8,2022,01-19,06:28
031 Voltaire,3,5,8,2022,01-19,06:28
032 Pr�s d'Ar�nes,8,0,8,2022,01-19,06:28
033 Garcia Lorca,8,0,8,2022,01-19,06:28
034 Vert Bois,0,16,16,2022,01-19,06:28
035 Malbosc,2,6,8,2022,01-19,06:28
036 Occitanie,7,25,32,2022,01-19,06:28
037 FacdesSciences,4,20,24,2022,01-19,06:28
038 Fac de Lettres,1,15,16,2022,01-19,06:28
039 Aiguelongue,4,4,8,2022,01-19,06:28
040 Jeu de Mail des Abb�s,8,0,8,2022,01-19,06:28
041 Eurom�decine,0,8,8,2022,01-19,06:28
042 Marie Caizergues,4,4,8,2022,01-19,06:28
043 Sabines,3,5,8,2022,01-19,06:28
044 Celleneuve,1,7,8,2022,01-19,06:28
045 Jardin de la Lironde,1,7,8,2022,01-19,06:28
046 P�re Soulas,8,0,8,2022,01-19,06:28
047 Place Viala,2,6,8,2022,01-19,06:28
048 H�tel du D�partement,0,8,8,2022,01-19,06:28
049 Tonnelles,1,7,8,2022,01-19,06:28
050 Parvis Jules Ferry - Gare Saint-Roch,0,8,8,2022,01-19,06:28
051 Pont de Lattes - Gare Saint-Roch,3,9,12,2022,01-19,06:28
053 Deux Ponts - Gare Saint-Roch,2,6,8,2022,01-19,06:28
054 Providence - Ovalie,4,4,8,2022,01-19,06:28
055 P�rols Etang de l'Or,23,45,68,2022,01-19,06:28
056 Albert 1er - Cath�drale,1,11,12,2022,01-19,06:28
057 Saint-Guilhem - Courreau,5,3,8,2022,01-19,06:28
059 Sud De France,0,8,8,2022,01-19,06:28
001 Rue Jules Ferry - Gare Saint-Roch,3,9,12,2022,01-19,06:38
002 Com�die,4,20,24,2022,01-19,06:38
003 Esplanade,1,31,32,2022,01-19,06:38
004 H�tel de Ville,16,0,16,2022,01-19,06:38
005 Corum,10,2,12,2022,01-19,06:38
006 Place Albert 1er - St Charles,21,10,31,2022,01-19,06:38
007 Foch,2,6,8,2022,01-19,06:38
008 Halles Castellane,0,12,12,2022,01-19,06:38
009 Observatoire,7,1,8,2022,01-19,06:38
010 Rondelet,3,13,16,2022,01-19,06:38
011 Plan Cabanes,12,0,12,2022,01-19,06:38
012 Boutonnet,1,11,12,2022,01-19,06:38
013 Emile Combes,1,7,8,2022,01-19,06:38
014 Beaux-Arts,3,5,8,2022,01-19,06:38
015 Les Aubes,5,3,8,2022,01-19,06:38
016 Antigone centre,14,2,16,2022,01-19,06:38
017 M�diath�que Emile Zola,12,4,16,2022,01-19,06:38
018 Nombre d'Or,15,1,16,2022,01-19,06:38
019 Louis Blanc,7,9,16,2022,01-19,06:38
020 Gambetta,4,4,8,2022,01-19,06:38
021 Port Marianne,14,2,16,2022,01-19,06:38
022 Clemenceau,4,8,12,2022,01-19,06:38
023 Les Arceaux,5,11,16,2022,01-19,06:38
024 Cit� Mion,3,5,8,2022,01-19,06:38
025 Nouveau Saint-Roch,4,4,8,2022,01-19,06:38
026 Renouvier,4,4,8,2022,01-19,06:38
027 Odysseum,4,4,8,2022,01-19,06:38
028 Saint-Denis,4,4,8,2022,01-19,06:38
029 Richter,15,1,16,2022,01-19,06:38
030 Charles Flahault,7,1,8,2022,01-19,06:38
031 Voltaire,3,5,8,2022,01-19,06:38
032 Pr�s d'Ar�nes,8,0,8,2022,01-19,06:38
033 Garcia Lorca,8,0,8,2022,01-19,06:38
034 Vert Bois,0,16,16,2022,01-19,06:38
035 Malbosc,2,6,8,2022,01-19,06:38
036 Occitanie,7,25,32,2022,01-19,06:38
037 FacdesSciences,4,20,24,2022,01-19,06:38
038 Fac de Lettres,1,15,16,2022,01-19,06:38
039 Aiguelongue,4,4,8,2022,01-19,06:38
040 Jeu de Mail des Abb�s,8,0,8,2022,01-19,06:38
041 Eurom�decine,0,8,8,2022,01-19,06:38
042 Marie Caizergues,4,4,8,2022,01-19,06:38
043 Sabines,3,5,8,2022,01-19,06:38
044 Celleneuve,1,7,8,2022,01-19,06:38
045 Jardin de la Lironde,1,7,8,2022,01-19,06:38
046 P�re Soulas,8,0,8,2022,01-19,06:38
047 Place Viala,2,6,8,2022,01-19,06:38
048 H�tel du D�partement,0,8,8,2022,01-19,06:38
049 Tonnelles,1,7,8,2022,01-19,06:38
050 Parvis Jules Ferry - Gare Saint-Roch,0,8,8,2022,01-19,06:38
051 Pont de Lattes - Gare Saint-Roch,3,9,12,2022,01-19,06:38
053 Deux Ponts - Gare Saint-Roch,2,6,8,2022,01-19,06:38
054 Providence - Ovalie,4,4,8,2022,01-19,06:38
055 P�rols Etang de l'Or,23,45,68,2022,01-19,06:38
056 Albert 1er - Cath�drale,1,11,12,2022,01-19,06:38
057 Saint-Guilhem - Courreau,5,3,8,2022,01-19,06:38
059 Sud De France,0,8,8,2022,01-19,06:38
001 Rue Jules Ferry - Gare Saint-Roch,3,9,12,2022,01-19,06:49
002 Com�die,4,20,24,2022,01-19,06:49
003 Esplanade,1,31,32,2022,01-19,06:49
004 H�tel de Ville,16,0,16,2022,01-19,06:49
005 Corum,10,2,12,2022,01-19,06:49
006 Place Albert 1er - St Charles,21,10,31,2022,01-19,06:49
007 Foch,2,6,8,2022,01-19,06:49
008 Halles Castellane,0,12,12,2022,01-19,06:49
009 Observatoire,7,1,8,2022,01-19,06:49
010 Rondelet,3,13,16,2022,01-19,06:49
011 Plan Cabanes,12,0,12,2022,01-19,06:49
012 Boutonnet,1,11,12,2022,01-19,06:49
013 Emile Combes,1,7,8,2022,01-19,06:49
014 Beaux-Arts,3,5,8,2022,01-19,06:49
015 Les Aubes,5,3,8,2022,01-19,06:49
016 Antigone centre,14,2,16,2022,01-19,06:49
017 M�diath�que Emile Zola,12,4,16,2022,01-19,06:49
018 Nombre d'Or,15,1,16,2022,01-19,06:49
019 Louis Blanc,7,9,16,2022,01-19,06:49
020 Gambetta,4,4,8,2022,01-19,06:49
021 Port Marianne,4,12,16,2022,01-19,06:49
022 Clemenceau,4,8,12,2022,01-19,06:49
023 Les Arceaux,5,11,16,2022,01-19,06:49
024 Cit� Mion,3,5,8,2022,01-19,06:49
025 Nouveau Saint-Roch,4,4,8,2022,01-19,06:49
026 Renouvier,4,4,8,2022,01-19,06:49
027 Odysseum,4,4,8,2022,01-19,06:49
028 Saint-Denis,4,4,8,2022,01-19,06:49
029 Richter,15,1,16,2022,01-19,06:49
030 Charles Flahault,7,1,8,2022,01-19,06:49
031 Voltaire,3,5,8,2022,01-19,06:49
032 Pr�s d'Ar�nes,7,1,8,2022,01-19,06:49
033 Garcia Lorca,8,0,8,2022,01-19,06:49
034 Vert Bois,0,16,16,2022,01-19,06:49
035 Malbosc,2,6,8,2022,01-19,06:49
036 Occitanie,7,25,32,2022,01-19,06:49
037 FacdesSciences,4,20,24,2022,01-19,06:49
038 Fac de Lettres,1,15,16,2022,01-19,06:49
039 Aiguelongue,4,4,8,2022,01-19,06:49
040 Jeu de Mail des Abb�s,8,0,8,2022,01-19,06:49
041 Eurom�decine,0,8,8,2022,01-19,06:49
042 Marie Caizergues,4,4,8,2022,01-19,06:49
043 Sabines,3,5,8,2022,01-19,06:49
044 Celleneuve,1,7,8,2022,01-19,06:49
045 Jardin de la Lironde,1,7,8,2022,01-19,06:49
046 P�re Soulas,8,0,8,2022,01-19,06:49
047 Place Viala,2,6,8,2022,01-19,06:49
048 H�tel du D�partement,0,8,8,2022,01-19,06:49
049 Tonnelles,1,7,8,2022,01-19,06:49
050 Parvis Jules Ferry - Gare Saint-Roch,0,8,8,2022,01-19,06:49
051 Pont de Lattes - Gare Saint-Roch,3,9,12,2022,01-19,06:49
053 Deux Ponts - Gare Saint-Roch,2,6,8,2022,01-19,06:49
054 Providence - Ovalie,4,4,8,2022,01-19,06:49
055 P�rols Etang de l'Or,23,45,68,2022,01-19,06:49
056 Albert 1er - Cath�drale,1,11,12,2022,01-19,06:49
057 Saint-Guilhem - Courreau,5,3,8,2022,01-19,06:49
059 Sud De France,0,8,8,2022,01-19,06:49
001 Rue Jules Ferry - Gare Saint-Roch,3,9,12,2022,01-19,06:59
002 Com�die,13,11,24,2022,01-19,06:59
003 Esplanade,1,31,32,2022,01-19,06:59
004 H�tel de Ville,16,0,16,2022,01-19,06:59
005 Corum,10,2,12,2022,01-19,06:59
006 Place Albert 1er - St Charles,21,10,31,2022,01-19,06:59
007 Foch,2,6,8,2022,01-19,06:59
008 Halles Castellane,0,12,12,2022,01-19,06:59
009 Observatoire,7,1,8,2022,01-19,06:59
010 Rondelet,3,13,16,2022,01-19,06:59
011 Plan Cabanes,12,0,12,2022,01-19,06:59
012 Boutonnet,1,11,12,2022,01-19,06:59
013 Emile Combes,1,7,8,2022,01-19,06:59
014 Beaux-Arts,3,5,8,2022,01-19,06:59
015 Les Aubes,5,3,8,2022,01-19,06:59
016 Antigone centre,14,2,16,2022,01-19,06:59
017 M�diath�que Emile Zola,12,4,16,2022,01-19,06:59
018 Nombre d'Or,15,1,16,2022,01-19,06:59
019 Louis Blanc,7,9,16,2022,01-19,06:59
020 Gambetta,4,4,8,2022,01-19,06:59
021 Port Marianne,4,12,16,2022,01-19,06:59
022 Clemenceau,4,8,12,2022,01-19,06:59
023 Les Arceaux,5,11,16,2022,01-19,06:59
024 Cit� Mion,3,5,8,2022,01-19,06:59
025 Nouveau Saint-Roch,4,4,8,2022,01-19,06:59
026 Renouvier,4,4,8,2022,01-19,06:59
027 Odysseum,4,4,8,2022,01-19,06:59
028 Saint-Denis,4,4,8,2022,01-19,06:59
029 Richter,15,1,16,2022,01-19,06:59
030 Charles Flahault,7,1,8,2022,01-19,06:59
031 Voltaire,3,5,8,2022,01-19,06:59
032 Pr�s d'Ar�nes,7,1,8,2022,01-19,06:59
033 Garcia Lorca,8,0,8,2022,01-19,06:59
034 Vert Bois,0,16,16,2022,01-19,06:59
035 Malbosc,2,6,8,2022,01-19,06:59
036 Occitanie,7,25,32,2022,01-19,06:59
037 FacdesSciences,4,20,24,2022,01-19,06:59
038 Fac de Lettres,1,15,16,2022,01-19,06:59
039 Aiguelongue,4,4,8,2022,01-19,06:59
040 Jeu de Mail des Abb�s,8,0,8,2022,01-19,06:59
041 Eurom�decine,0,8,8,2022,01-19,06:59
042 Marie Caizergues,4,4,8,2022,01-19,06:59
043 Sabines,3,5,8,2022,01-19,06:59
044 Celleneuve,1,7,8,2022,01-19,06:59
045 Jardin de la Lironde,1,7,8,2022,01-19,06:59
046 P�re Soulas,8,0,8,2022,01-19,06:59
047 Place Viala,2,6,8,2022,01-19,06:59
048 H�tel du D�partement,0,8,8,2022,01-19,06:59
049 Tonnelles,1,7,8,2022,01-19,06:59
050 Parvis Jules Ferry - Gare Saint-Roch,0,8,8,2022,01-19,06:59
051 Pont de Lattes - Gare Saint-Roch,3,9,12,2022,01-19,06:59
053 Deux Ponts - Gare Saint-Roch,2,6,8,2022,01-19,06:59
054 Providence - Ovalie,4,4,8,2022,01-19,06:59
055 P�rols Etang de l'Or,23,45,68,2022,01-19,06:59
056 Albert 1er - Cath�drale,1,11,12,2022,01-19,06:59
057 Saint-Guilhem - Courreau,5,3,8,2022,01-19,06:59
059 Sud De France,0,8,8,2022,01-19,06:59
001 Rue Jules Ferry - Gare Saint-Roch,3,9,12,2022,01-19,07:09
002 Com�die,13,11,24,2022,01-19,07:09
003 Esplanade,1,31,32,2022,01-19,07:09
004 H�tel de Ville,16,0,16,2022,01-19,07:09
005 Corum,10,2,12,2022,01-19,07:09
006 Place Albert 1er - St Charles,21,10,31,2022,01-19,07:09
007 Foch,2,6,8,2022,01-19,07:09
008 Halles Castellane,0,12,12,2022,01-19,07:09
009 Observatoire,7,1,8,2022,01-19,07:09
010 Rondelet,3,13,16,2022,01-19,07:09
011 Plan Cabanes,6,6,12,2022,01-19,07:09
012 Boutonnet,1,11,12,2022,01-19,07:09
013 Emile Combes,1,7,8,2022,01-19,07:09
014 Beaux-Arts,3,5,8,2022,01-19,07:09
015 Les Aubes,5,3,8,2022,01-19,07:09
016 Antigone centre,15,1,16,2022,01-19,07:09
017 M�diath�que Emile Zola,12,4,16,2022,01-19,07:09
018 Nombre d'Or,15,1,16,2022,01-19,07:09
019 Louis Blanc,7,9,16,2022,01-19,07:09
020 Gambetta,4,4,8,2022,01-19,07:09
021 Port Marianne,4,12,16,2022,01-19,07:09
022 Clemenceau,4,8,12,2022,01-19,07:09
023 Les Arceaux,5,11,16,2022,01-19,07:09
024 Cit� Mion,3,5,8,2022,01-19,07:09
025 Nouveau Saint-Roch,4,4,8,2022,01-19,07:09
026 Renouvier,4,4,8,2022,01-19,07:09
027 Odysseum,4,4,8,2022,01-19,07:09
028 Saint-Denis,4,4,8,2022,01-19,07:09
029 Richter,15,1,16,2022,01-19,07:09
030 Charles Flahault,7,1,8,2022,01-19,07:09
031 Voltaire,3,5,8,2022,01-19,07:09
032 Pr�s d'Ar�nes,7,1,8,2022,01-19,07:09
033 Garcia Lorca,8,0,8,2022,01-19,07:09
034 Vert Bois,0,16,16,2022,01-19,07:09
035 Malbosc,2,6,8,2022,01-19,07:09
036 Occitanie,7,25,32,2022,01-19,07:09
037 FacdesSciences,4,20,24,2022,01-19,07:09
038 Fac de Lettres,1,15,16,2022,01-19,07:09
039 Aiguelongue,4,4,8,2022,01-19,07:09
040 Jeu de Mail des Abb�s,8,0,8,2022,01-19,07:09
041 Eurom�decine,0,8,8,2022,01-19,07:09
042 Marie Caizergues,4,4,8,2022,01-19,07:09
043 Sabines,3,5,8,2022,01-19,07:09
044 Celleneuve,1,7,8,2022,01-19,07:09
045 Jardin de la Lironde,1,7,8,2022,01-19,07:09
046 P�re Soulas,7,1,8,2022,01-19,07:09
047 Place Viala,2,6,8,2022,01-19,07:09
048 H�tel du D�partement,0,8,8,2022,01-19,07:09
049 Tonnelles,1,7,8,2022,01-19,07:09
050 Parvis Jules Ferry - Gare Saint-Roch,0,8,8,2022,01-19,07:09
051 Pont de Lattes - Gare Saint-Roch,3,9,12,2022,01-19,07:09
053 Deux Ponts - Gare Saint-Roch,2,6,8,2022,01-19,07:09
054 Providence - Ovalie,4,4,8,2022,01-19,07:09
055 P�rols Etang de l'Or,23,45,68,2022,01-19,07:09
056 Albert 1er - Cath�drale,1,11,12,2022,01-19,07:09
057 Saint-Guilhem - Courreau,5,3,8,2022,01-19,07:09
059 Sud De France,0,8,8,2022,01-19,07:09
001 Rue Jules Ferry - Gare Saint-Roch,3,9,12,2022,01-19,07:19
002 Com�die,13,11,24,2022,01-19,07:19
003 Esplanade,1,31,32,2022,01-19,07:19
004 H�tel de Ville,16,0,16,2022,01-19,07:19
005 Corum,10,2,12,2022,01-19,07:19
006 Place Albert 1er - St Charles,21,10,31,2022,01-19,07:19
007 Foch,2,6,8,2022,01-19,07:19
008 Halles Castellane,0,12,12,2022,01-19,07:19
009 Observatoire,7,1,8,2022,01-19,07:19
010 Rondelet,3,13,16,2022,01-19,07:19
011 Plan Cabanes,4,8,12,2022,01-19,07:19
012 Boutonnet,1,11,12,2022,01-19,07:19
013 Emile Combes,1,7,8,2022,01-19,07:19
014 Beaux-Arts,3,5,8,2022,01-19,07:19
015 Les Aubes,5,3,8,2022,01-19,07:19
016 Antigone centre,15,1,16,2022,01-19,07:19
017 M�diath�que Emile Zola,12,4,16,2022,01-19,07:19
018 Nombre d'Or,15,1,16,2022,01-19,07:19
019 Louis Blanc,7,9,16,2022,01-19,07:19
020 Gambetta,4,4,8,2022,01-19,07:19
021 Port Marianne,4,12,16,2022,01-19,07:19
022 Clemenceau,4,8,12,2022,01-19,07:19
023 Les Arceaux,5,11,16,2022,01-19,07:19
024 Cit� Mion,3,5,8,2022,01-19,07:19
025 Nouveau Saint-Roch,4,4,8,2022,01-19,07:19
026 Renouvier,4,4,8,2022,01-19,07:19
027 Odysseum,4,4,8,2022,01-19,07:19
028 Saint-Denis,4,4,8,2022,01-19,07:19
029 Richter,15,1,16,2022,01-19,07:19
030 Charles Flahault,7,1,8,2022,01-19,07:19
031 Voltaire,3,5,8,2022,01-19,07:19
032 Pr�s d'Ar�nes,7,1,8,2022,01-19,07:19
033 Garcia Lorca,8,0,8,2022,01-19,07:19
034 Vert Bois,0,16,16,2022,01-19,07:19
035 Malbosc,2,6,8,2022,01-19,07:19
036 Occitanie,6,26,32,2022,01-19,07:19
037 FacdesSciences,4,20,24,2022,01-19,07:19
038 Fac de Lettres,1,15,16,2022,01-19,07:19
039 Aiguelongue,4,4,8,2022,01-19,07:19
040 Jeu de Mail des Abb�s,8,0,8,2022,01-19,07:19
041 Eurom�decine,0,8,8,2022,01-19,07:19
042 Marie Caizergues,4,4,8,2022,01-19,07:19
043 Sabines,3,5,8,2022,01-19,07:19
044 Celleneuve,1,7,8,2022,01-19,07:19
045 Jardin de la Lironde,1,7,8,2022,01-19,07:19
046 P�re Soulas,7,1,8,2022,01-19,07:19
047 Place Viala,2,6,8,2022,01-19,07:19
048 H�tel du D�partement,0,8,8,2022,01-19,07:19
049 Tonnelles,1,7,8,2022,01-19,07:19
050 Parvis Jules Ferry - Gare Saint-Roch,0,8,8,2022,01-19,07:19
051 Pont de Lattes - Gare Saint-Roch,3,9,12,2022,01-19,07:19
053 Deux Ponts - Gare Saint-Roch,2,6,8,2022,01-19,07:19
054 Providence - Ovalie,4,4,8,2022,01-19,07:19
055 P�rols Etang de l'Or,23,45,68,2022,01-19,07:19
056 Albert 1er - Cath�drale,1,11,12,2022,01-19,07:19
057 Saint-Guilhem - Courreau,5,3,8,2022,01-19,07:19
059 Sud De France,0,8,8,2022,01-19,07:19
001 Rue Jules Ferry - Gare Saint-Roch,3,9,12,2022,01-19,07:29
002 Com�die,13,11,24,2022,01-19,07:29
003 Esplanade,1,31,32,2022,01-19,07:29
004 H�tel de Ville,9,7,16,2022,01-19,07:29
005 Corum,10,2,12,2022,01-19,07:29
006 Place Albert 1er - St Charles,21,10,31,2022,01-19,07:29
007 Foch,2,6,8,2022,01-19,07:29
008 Halles Castellane,0,12,12,2022,01-19,07:29
009 Observatoire,7,1,8,2022,01-19,07:29
010 Rondelet,4,12,16,2022,01-19,07:29
011 Plan Cabanes,4,8,12,2022,01-19,07:29
012 Boutonnet,1,11,12,2022,01-19,07:29
013 Emile Combes,1,7,8,2022,01-19,07:29
014 Beaux-Arts,3,5,8,2022,01-19,07:29
015 Les Aubes,5,3,8,2022,01-19,07:29
016 Antigone centre,15,1,16,2022,01-19,07:29
017 M�diath�que Emile Zola,12,4,16,2022,01-19,07:29
018 Nombre d'Or,15,1,16,2022,01-19,07:29
019 Louis Blanc,7,9,16,2022,01-19,07:29
020 Gambetta,4,4,8,2022,01-19,07:29
021 Port Marianne,4,12,16,2022,01-19,07:29
022 Clemenceau,4,8,12,2022,01-19,07:29
023 Les Arceaux,5,11,16,2022,01-19,07:29
024 Cit� Mion,3,5,8,2022,01-19,07:29
025 Nouveau Saint-Roch,4,4,8,2022,01-19,07:29
026 Renouvier,4,4,8,2022,01-19,07:29
027 Odysseum,4,4,8,2022,01-19,07:29
028 Saint-Denis,4,4,8,2022,01-19,07:29
029 Richter,15,1,16,2022,01-19,07:29
030 Charles Flahault,7,1,8,2022,01-19,07:29
031 Voltaire,3,5,8,2022,01-19,07:29
032 Pr�s d'Ar�nes,7,1,8,2022,01-19,07:29
033 Garcia Lorca,8,0,8,2022,01-19,07:29
034 Vert Bois,0,16,16,2022,01-19,07:29
035 Malbosc,1,7,8,2022,01-19,07:29
036 Occitanie,6,26,32,2022,01-19,07:29
037 FacdesSciences,4,20,24,2022,01-19,07:29
038 Fac de Lettres,1,15,16,2022,01-19,07:29
039 Aiguelongue,4,4,8,2022,01-19,07:29
040 Jeu de Mail des Abb�s,8,0,8,2022,01-19,07:29
041 Eurom�decine,0,8,8,2022,01-19,07:29
042 Marie Caizergues,4,4,8,2022,01-19,07:29
043 Sabines,3,5,8,2022,01-19,07:29
044 Celleneuve,1,7,8,2022,01-19,07:29
045 Jardin de la Lironde,1,7,8,2022,01-19,07:29
046 P�re Soulas,7,1,8,2022,01-19,07:29
047 Place Viala,2,6,8,2022,01-19,07:29
048 H�tel du D�partement,0,8,8,2022,01-19,07:29
049 Tonnelles,1,7,8,2022,01-19,07:29
050 Parvis Jules Ferry - Gare Saint-Roch,1,7,8,2022,01-19,07:29
051 Pont de Lattes - Gare Saint-Roch,3,9,12,2022,01-19,07:29
053 Deux Ponts - Gare Saint-Roch,2,6,8,2022,01-19,07:29
054 Providence - Ovalie,4,4,8,2022,01-19,07:29
055 P�rols Etang de l'Or,23,45,68,2022,01-19,07:29
056 Albert 1er - Cath�drale,1,11,12,2022,01-19,07:29
057 Saint-Guilhem - Courreau,5,3,8,2022,01-19,07:29
059 Sud De France,0,8,8,2022,01-19,07:29
001 Rue Jules Ferry - Gare Saint-Roch,3,9,12,2022,01-19,07:40
002 Com�die,13,11,24,2022,01-19,07:40
003 Esplanade,1,31,32,2022,01-19,07:40
004 H�tel de Ville,7,9,16,2022,01-19,07:40
005 Corum,10,2,12,2022,01-19,07:40
006 Place Albert 1er - St Charles,21,10,31,2022,01-19,07:40
007 Foch,2,6,8,2022,01-19,07:40
008 Halles Castellane,0,12,12,2022,01-19,07:40
009 Observatoire,7,1,8,2022,01-19,07:40
010 Rondelet,4,12,16,2022,01-19,07:40
011 Plan Cabanes,4,8,12,2022,01-19,07:40
012 Boutonnet,1,11,12,2022,01-19,07:40
013 Emile Combes,1,7,8,2022,01-19,07:40
014 Beaux-Arts,3,5,8,2022,01-19,07:40
015 Les Aubes,5,3,8,2022,01-19,07:40
016 Antigone centre,15,1,16,2022,01-19,07:40
017 M�diath�que Emile Zola,12,4,16,2022,01-19,07:40
018 Nombre d'Or,15,1,16,2022,01-19,07:40
019 Louis Blanc,7,9,16,2022,01-19,07:40
020 Gambetta,4,4,8,2022,01-19,07:40
021 Port Marianne,4,12,16,2022,01-19,07:40
022 Clemenceau,4,8,12,2022,01-19,07:40
023 Les Arceaux,4,12,16,2022,01-19,07:40
024 Cit� Mion,3,5,8,2022,01-19,07:40
025 Nouveau Saint-Roch,4,4,8,2022,01-19,07:40
026 Renouvier,4,4,8,2022,01-19,07:40
027 Odysseum,4,4,8,2022,01-19,07:40
028 Saint-Denis,4,4,8,2022,01-19,07:40
029 Richter,15,1,16,2022,01-19,07:40
030 Charles Flahault,7,1,8,2022,01-19,07:40
031 Voltaire,3,5,8,2022,01-19,07:40
032 Pr�s d'Ar�nes,7,1,8,2022,01-19,07:40
033 Garcia Lorca,8,0,8,2022,01-19,07:40
034 Vert Bois,0,16,16,2022,01-19,07:40
035 Malbosc,1,7,8,2022,01-19,07:40
036 Occitanie,6,26,32,2022,01-19,07:40
037 FacdesSciences,4,20,24,2022,01-19,07:40
038 Fac de Lettres,1,15,16,2022,01-19,07:40
039 Aiguelongue,4,4,8,2022,01-19,07:40
040 Jeu de Mail des Abb�s,8,0,8,2022,01-19,07:40
041 Eurom�decine,0,8,8,2022,01-19,07:40
042 Marie Caizergues,4,4,8,2022,01-19,07:40
043 Sabines,3,5,8,2022,01-19,07:40
044 Celleneuve,1,7,8,2022,01-19,07:40
045 Jardin de la Lironde,1,7,8,2022,01-19,07:40
046 P�re Soulas,7,1,8,2022,01-19,07:40
047 Place Viala,2,6,8,2022,01-19,07:40
048 H�tel du D�partement,0,8,8,2022,01-19,07:40
049 Tonnelles,1,7,8,2022,01-19,07:40
050 Parvis Jules Ferry - Gare Saint-Roch,1,7,8,2022,01-19,07:40
051 Pont de Lattes - Gare Saint-Roch,3,9,12,2022,01-19,07:40
053 Deux Ponts - Gare Saint-Roch,2,6,8,2022,01-19,07:40
054 Providence - Ovalie,4,4,8,2022,01-19,07:40
055 P�rols Etang de l'Or,23,45,68,2022,01-19,07:40
056 Albert 1er - Cath�drale,1,11,12,2022,01-19,07:40
057 Saint-Guilhem - Courreau,5,3,8,2022,01-19,07:40
059 Sud De France,0,8,8,2022,01-19,07:40
001 Rue Jules Ferry - Gare Saint-Roch,3,9,12,2022,01-19,07:50
002 Com�die,13,11,24,2022,01-19,07:50
003 Esplanade,1,31,32,2022,01-19,07:50
004 H�tel de Ville,7,9,16,2022,01-19,07:50
005 Corum,10,2,12,2022,01-19,07:50
006 Place Albert 1er - St Charles,21,10,31,2022,01-19,07:50
007 Foch,2,6,8,2022,01-19,07:50
008 Halles Castellane,0,12,12,2022,01-19,07:50
009 Observatoire,7,1,8,2022,01-19,07:50
010 Rondelet,4,12,16,2022,01-19,07:50
011 Plan Cabanes,4,8,12,2022,01-19,07:50
012 Boutonnet,2,10,12,2022,01-19,07:50
013 Emile Combes,1,7,8,2022,01-19,07:50
014 Beaux-Arts,3,5,8,2022,01-19,07:50
015 Les Aubes,5,3,8,2022,01-19,07:50
016 Antigone centre,15,1,16,2022,01-19,07:50
017 M�diath�que Emile Zola,12,4,16,2022,01-19,07:50
018 Nombre d'Or,15,1,16,2022,01-19,07:50
019 Louis Blanc,7,9,16,2022,01-19,07:50
020 Gambetta,3,5,8,2022,01-19,07:50
021 Port Marianne,4,12,16,2022,01-19,07:50
022 Clemenceau,4,8,12,2022,01-19,07:50
023 Les Arceaux,4,12,16,2022,01-19,07:50
024 Cit� Mion,3,5,8,2022,01-19,07:50
025 Nouveau Saint-Roch,4,4,8,2022,01-19,07:50
026 Renouvier,4,4,8,2022,01-19,07:50
027 Odysseum,4,4,8,2022,01-19,07:50
028 Saint-Denis,4,4,8,2022,01-19,07:50
029 Richter,15,1,16,2022,01-19,07:50
030 Charles Flahault,7,1,8,2022,01-19,07:50
031 Voltaire,3,5,8,2022,01-19,07:50
032 Pr�s d'Ar�nes,7,1,8,2022,01-19,07:50
033 Garcia Lorca,8,0,8,2022,01-19,07:50
034 Vert Bois,0,16,16,2022,01-19,07:50
035 Malbosc,1,7,8,2022,01-19,07:50
036 Occitanie,5,27,32,2022,01-19,07:50
037 FacdesSciences,4,20,24,2022,01-19,07:50
038 Fac de Lettres,1,15,16,2022,01-19,07:50
039 Aiguelongue,4,4,8,2022,01-19,07:50
040 Jeu de Mail des Abb�s,8,0,8,2022,01-19,07:50
041 Eurom�decine,0,8,8,2022,01-19,07:50
042 Marie Caizergues,4,4,8,2022,01-19,07:50
043 Sabines,3,5,8,2022,01-19,07:50
044 Celleneuve,1,7,8,2022,01-19,07:50
045 Jardin de la Lironde,1,7,8,2022,01-19,07:50
046 P�re Soulas,7,1,8,2022,01-19,07:50
047 Place Viala,2,6,8,2022,01-19,07:50
048 H�tel du D�partement,0,8,8,2022,01-19,07:50
049 Tonnelles,0,8,8,2022,01-19,07:50
050 Parvis Jules Ferry - Gare Saint-Roch,1,7,8,2022,01-19,07:50
051 Pont de Lattes - Gare Saint-Roch,3,9,12,2022,01-19,07:50
053 Deux Ponts - Gare Saint-Roch,2,6,8,2022,01-19,07:50
054 Providence - Ovalie,4,4,8,2022,01-19,07:50
055 P�rols Etang de l'Or,23,45,68,2022,01-19,07:50
056 Albert 1er - Cath�drale,1,11,12,2022,01-19,07:50
057 Saint-Guilhem - Courreau,5,3,8,2022,01-19,07:50
059 Sud De France,0,8,8,2022,01-19,07:50
001 Rue Jules Ferry - Gare Saint-Roch,3,9,12,2022,01-19,08:00
002 Com�die,13,11,24,2022,01-19,08:00
003 Esplanade,18,14,32,2022,01-19,08:00
004 H�tel de Ville,7,9,16,2022,01-19,08:00
005 Corum,11,1,12,2022,01-19,08:00
006 Place Albert 1er - St Charles,21,10,31,2022,01-19,08:00
007 Foch,2,6,8,2022,01-19,08:00
008 Halles Castellane,0,12,12,2022,01-19,08:00
009 Observatoire,7,1,8,2022,01-19,08:00
010 Rondelet,4,12,16,2022,01-19,08:00
011 Plan Cabanes,3,9,12,2022,01-19,08:00
012 Boutonnet,2,10,12,2022,01-19,08:00
013 Emile Combes,1,7,8,2022,01-19,08:00
014 Beaux-Arts,2,6,8,2022,01-19,08:00
015 Les Aubes,6,2,8,2022,01-19,08:00
016 Antigone centre,15,1,16,2022,01-19,08:00
017 M�diath�que Emile Zola,11,5,16,2022,01-19,08:00
018 Nombre d'Or,15,1,16,2022,01-19,08:00
019 Louis Blanc,7,9,16,2022,01-19,08:00
020 Gambetta,3,5,8,2022,01-19,08:00
021 Port Marianne,4,12,16,2022,01-19,08:00
022 Clemenceau,4,8,12,2022,01-19,08:00
023 Les Arceaux,4,12,16,2022,01-19,08:00
024 Cit� Mion,3,5,8,2022,01-19,08:00
025 Nouveau Saint-Roch,4,4,8,2022,01-19,08:00
026 Renouvier,4,4,8,2022,01-19,08:00
027 Odysseum,4,4,8,2022,01-19,08:00
028 Saint-Denis,4,4,8,2022,01-19,08:00
029 Richter,15,1,16,2022,01-19,08:00
030 Charles Flahault,7,1,8,2022,01-19,08:00
031 Voltaire,3,5,8,2022,01-19,08:00
032 Pr�s d'Ar�nes,7,1,8,2022,01-19,08:00
033 Garcia Lorca,8,0,8,2022,01-19,08:00
034 Vert Bois,0,16,16,2022,01-19,08:00
035 Malbosc,1,7,8,2022,01-19,08:00
036 Occitanie,5,27,32,2022,01-19,08:00
037 FacdesSciences,6,18,24,2022,01-19,08:00
038 Fac de Lettres,1,15,16,2022,01-19,08:00
039 Aiguelongue,3,5,8,2022,01-19,08:00
040 Jeu de Mail des Abb�s,8,0,8,2022,01-19,08:00
041 Eurom�decine,0,8,8,2022,01-19,08:00
042 Marie Caizergues,4,4,8,2022,01-19,08:00
043 Sabines,4,4,8,2022,01-19,08:00
044 Celleneuve,1,7,8,2022,01-19,08:00
045 Jardin de la Lironde,1,7,8,2022,01-19,08:00
046 P�re Soulas,6,2,8,2022,01-19,08:00
047 Place Viala,2,6,8,2022,01-19,08:00
048 H�tel du D�partement,0,8,8,2022,01-19,08:00
049 Tonnelles,0,8,8,2022,01-19,08:00
050 Parvis Jules Ferry - Gare Saint-Roch,1,7,8,2022,01-19,08:00
051 Pont de Lattes - Gare Saint-Roch,3,9,12,2022,01-19,08:00
053 Deux Ponts - Gare Saint-Roch,2,6,8,2022,01-19,08:00
054 Providence - Ovalie,3,5,8,2022,01-19,08:00
055 P�rols Etang de l'Or,23,45,68,2022,01-19,08:00
056 Albert 1er - Cath�drale,1,11,12,2022,01-19,08:00
057 Saint-Guilhem - Courreau,5,3,8,2022,01-19,08:00
059 Sud De France,0,8,8,2022,01-19,08:00
001 Rue Jules Ferry - Gare Saint-Roch,1,11,12,2022,01-19,08:10
002 Com�die,14,10,24,2022,01-19,08:10
003 Esplanade,18,14,32,2022,01-19,08:10
004 H�tel de Ville,7,9,16,2022,01-19,08:10
005 Corum,11,1,12,2022,01-19,08:10
006 Place Albert 1er - St Charles,21,10,31,2022,01-19,08:10
007 Foch,2,6,8,2022,01-19,08:10
008 Halles Castellane,0,12,12,2022,01-19,08:10
009 Observatoire,7,1,8,2022,01-19,08:10
010 Rondelet,4,12,16,2022,01-19,08:10
011 Plan Cabanes,2,10,12,2022,01-19,08:10
012 Boutonnet,2,10,12,2022,01-19,08:10
013 Emile Combes,1,7,8,2022,01-19,08:10
014 Beaux-Arts,2,6,8,2022,01-19,08:10
015 Les Aubes,6,2,8,2022,01-19,08:10
016 Antigone centre,15,1,16,2022,01-19,08:10
017 M�diath�que Emile Zola,11,5,16,2022,01-19,08:10
018 Nombre d'Or,15,1,16,2022,01-19,08:10
019 Louis Blanc,8,8,16,2022,01-19,08:10
020 Gambetta,3,5,8,2022,01-19,08:10
021 Port Marianne,4,12,16,2022,01-19,08:10
022 Clemenceau,3,9,12,2022,01-19,08:10
023 Les Arceaux,4,12,16,2022,01-19,08:10
024 Cit� Mion,3,5,8,2022,01-19,08:10
025 Nouveau Saint-Roch,4,4,8,2022,01-19,08:10
026 Renouvier,4,4,8,2022,01-19,08:10
027 Odysseum,4,4,8,2022,01-19,08:10
028 Saint-Denis,4,4,8,2022,01-19,08:10
029 Richter,15,1,16,2022,01-19,08:10
030 Charles Flahault,7,1,8,2022,01-19,08:10
031 Voltaire,3,5,8,2022,01-19,08:10
032 Pr�s d'Ar�nes,7,1,8,2022,01-19,08:10
033 Garcia Lorca,7,1,8,2022,01-19,08:10
034 Vert Bois,0,16,16,2022,01-19,08:10
035 Malbosc,1,7,8,2022,01-19,08:10
036 Occitanie,4,28,32,2022,01-19,08:10
037 FacdesSciences,7,17,24,2022,01-19,08:10
038 Fac de Lettres,1,15,16,2022,01-19,08:10
039 Aiguelongue,3,5,8,2022,01-19,08:10
040 Jeu de Mail des Abb�s,8,0,8,2022,01-19,08:10
041 Eurom�decine,0,8,8,2022,01-19,08:10
042 Marie Caizergues,4,4,8,2022,01-19,08:10
043 Sabines,4,4,8,2022,01-19,08:10
044 Celleneuve,1,7,8,2022,01-19,08:10
045 Jardin de la Lironde,1,7,8,2022,01-19,08:10
046 P�re Soulas,6,2,8,2022,01-19,08:10
047 Place Viala,3,5,8,2022,01-19,08:10
048 H�tel du D�partement,0,8,8,2022,01-19,08:10
049 Tonnelles,0,8,8,2022,01-19,08:10
050 Parvis Jules Ferry - Gare Saint-Roch,1,7,8,2022,01-19,08:10
051 Pont de Lattes - Gare Saint-Roch,3,9,12,2022,01-19,08:10
053 Deux Ponts - Gare Saint-Roch,2,6,8,2022,01-19,08:10
054 Providence - Ovalie,3,5,8,2022,01-19,08:10
055 P�rols Etang de l'Or,23,45,68,2022,01-19,08:10
056 Albert 1er - Cath�drale,1,11,12,2022,01-19,08:10
057 Saint-Guilhem - Courreau,5,3,8,2022,01-19,08:10
059 Sud De France,0,8,8,2022,01-19,08:10
001 Rue Jules Ferry - Gare Saint-Roch,2,10,12,2022,01-19,08:20
002 Com�die,14,10,24,2022,01-19,08:20
003 Esplanade,18,14,32,2022,01-19,08:20
004 H�tel de Ville,7,9,16,2022,01-19,08:20
005 Corum,11,1,12,2022,01-19,08:20
006 Place Albert 1er - St Charles,21,10,31,2022,01-19,08:20
007 Foch,2,6,8,2022,01-19,08:20
008 Halles Castellane,1,11,12,2022,01-19,08:20
009 Observatoire,7,1,8,2022,01-19,08:20
010 Rondelet,4,12,16,2022,01-19,08:20
011 Plan Cabanes,2,10,12,2022,01-19,08:20
012 Boutonnet,2,10,12,2022,01-19,08:20
013 Emile Combes,1,7,8,2022,01-19,08:20
014 Beaux-Arts,2,6,8,2022,01-19,08:20
015 Les Aubes,6,2,8,2022,01-19,08:20
016 Antigone centre,15,1,16,2022,01-19,08:20
017 M�diath�que Emile Zola,11,5,16,2022,01-19,08:20
018 Nombre d'Or,15,1,16,2022,01-19,08:20
019 Louis Blanc,9,7,16,2022,01-19,08:20
020 Gambetta,3,5,8,2022,01-19,08:20
021 Port Marianne,4,12,16,2022,01-19,08:20
022 Clemenceau,3,9,12,2022,01-19,08:20
023 Les Arceaux,4,12,16,2022,01-19,08:20
024 Cit� Mion,3,5,8,2022,01-19,08:20
025 Nouveau Saint-Roch,4,4,8,2022,01-19,08:20
026 Renouvier,4,4,8,2022,01-19,08:20
027 Odysseum,4,4,8,2022,01-19,08:20
028 Saint-Denis,4,4,8,2022,01-19,08:20
029 Richter,15,1,16,2022,01-19,08:20
030 Charles Flahault,7,1,8,2022,01-19,08:20
031 Voltaire,3,5,8,2022,01-19,08:20
032 Pr�s d'Ar�nes,7,1,8,2022,01-19,08:20
033 Garcia Lorca,7,1,8,2022,01-19,08:20
034 Vert Bois,0,16,16,2022,01-19,08:20
035 Malbosc,1,7,8,2022,01-19,08:20
036 Occitanie,4,28,32,2022,01-19,08:20
037 FacdesSciences,8,16,24,2022,01-19,08:20
038 Fac de Lettres,1,15,16,2022,01-19,08:20
039 Aiguelongue,3,5,8,2022,01-19,08:20
040 Jeu de Mail des Abb�s,8,0,8,2022,01-19,08:20
041 Eurom�decine,0,8,8,2022,01-19,08:20
042 Marie Caizergues,4,4,8,2022,01-19,08:20
043 Sabines,4,4,8,2022,01-19,08:20
044 Celleneuve,1,7,8,2022,01-19,08:20
045 Jardin de la Lironde,1,7,8,2022,01-19,08:20
046 P�re Soulas,6,2,8,2022,01-19,08:20
047 Place Viala,2,6,8,2022,01-19,08:20
048 H�tel du D�partement,0,8,8,2022,01-19,08:20
049 Tonnelles,0,8,8,2022,01-19,08:20
050 Parvis Jules Ferry - Gare Saint-Roch,1,7,8,2022,01-19,08:20
051 Pont de Lattes - Gare Saint-Roch,3,9,12,2022,01-19,08:20
053 Deux Ponts - Gare Saint-Roch,2,6,8,2022,01-19,08:20
054 Providence - Ovalie,3,5,8,2022,01-19,08:20
055 P�rols Etang de l'Or,23,45,68,2022,01-19,08:20
056 Albert 1er - Cath�drale,1,11,12,2022,01-19,08:20
057 Saint-Guilhem - Courreau,5,3,8,2022,01-19,08:20
059 Sud De France,0,8,8,2022,01-19,08:20
001 Rue Jules Ferry - Gare Saint-Roch,2,10,12,2022,01-19,08:30
002 Com�die,14,10,24,2022,01-19,08:30
003 Esplanade,18,14,32,2022,01-19,08:30
004 H�tel de Ville,7,9,16,2022,01-19,08:30
005 Corum,11,1,12,2022,01-19,08:30
006 Place Albert 1er - St Charles,21,10,31,2022,01-19,08:30
007 Foch,2,6,8,2022,01-19,08:30
008 Halles Castellane,1,11,12,2022,01-19,08:30
009 Observatoire,7,1,8,2022,01-19,08:30
010 Rondelet,4,12,16,2022,01-19,08:30
011 Plan Cabanes,2,10,12,2022,01-19,08:30
012 Boutonnet,2,10,12,2022,01-19,08:30
013 Emile Combes,1,7,8,2022,01-19,08:30
014 Beaux-Arts,2,6,8,2022,01-19,08:30
015 Les Aubes,6,2,8,2022,01-19,08:30
016 Antigone centre,15,1,16,2022,01-19,08:30
017 M�diath�que Emile Zola,11,5,16,2022,01-19,08:30
018 Nombre d'Or,15,1,16,2022,01-19,08:30
019 Louis Blanc,8,8,16,2022,01-19,08:30
020 Gambetta,3,5,8,2022,01-19,08:30
021 Port Marianne,4,12,16,2022,01-19,08:30
022 Clemenceau,3,9,12,2022,01-19,08:30
023 Les Arceaux,4,12,16,2022,01-19,08:30
024 Cit� Mion,3,5,8,2022,01-19,08:30
025 Nouveau Saint-Roch,3,5,8,2022,01-19,08:30
026 Renouvier,3,5,8,2022,01-19,08:30
027 Odysseum,4,4,8,2022,01-19,08:30
028 Saint-Denis,4,4,8,2022,01-19,08:30
029 Richter,7,9,16,2022,01-19,08:30
030 Charles Flahault,6,2,8,2022,01-19,08:30
031 Voltaire,3,5,8,2022,01-19,08:30
032 Pr�s d'Ar�nes,7,1,8,2022,01-19,08:30
033 Garcia Lorca,7,1,8,2022,01-19,08:30
034 Vert Bois,0,16,16,2022,01-19,08:30
035 Malbosc,1,7,8,2022,01-19,08:30
036 Occitanie,4,28,32,2022,01-19,08:30
037 FacdesSciences,8,16,24,2022,01-19,08:30
038 Fac de Lettres,1,15,16,2022,01-19,08:30
039 Aiguelongue,3,5,8,2022,01-19,08:30
040 Jeu de Mail des Abb�s,8,0,8,2022,01-19,08:30
041 Eurom�decine,0,8,8,2022,01-19,08:30
042 Marie Caizergues,4,4,8,2022,01-19,08:30
043 Sabines,4,4,8,2022,01-19,08:30
044 Celleneuve,1,7,8,2022,01-19,08:30
045 Jardin de la Lironde,0,8,8,2022,01-19,08:30
046 P�re Soulas,6,2,8,2022,01-19,08:30
047 Place Viala,2,6,8,2022,01-19,08:30
048 H�tel du D�partement,0,8,8,2022,01-19,08:30
049 Tonnelles,0,8,8,2022,01-19,08:30
050 Parvis Jules Ferry - Gare Saint-Roch,1,7,8,2022,01-19,08:30
051 Pont de Lattes - Gare Saint-Roch,3,9,12,2022,01-19,08:30
053 Deux Ponts - Gare Saint-Roch,2,6,8,2022,01-19,08:30
054 Providence - Ovalie,3,5,8,2022,01-19,08:30
055 P�rols Etang de l'Or,23,45,68,2022,01-19,08:30
056 Albert 1er - Cath�drale,1,11,12,2022,01-19,08:30
057 Saint-Guilhem - Courreau,4,4,8,2022,01-19,08:30
059 Sud De France,0,8,8,2022,01-19,08:30
001 Rue Jules Ferry - Gare Saint-Roch,2,10,12,2022,01-19,08:41
002 Com�die,14,10,24,2022,01-19,08:41
003 Esplanade,18,14,32,2022,01-19,08:41
004 H�tel de Ville,7,9,16,2022,01-19,08:41
005 Corum,11,1,12,2022,01-19,08:41
006 Place Albert 1er - St Charles,21,10,31,2022,01-19,08:41
007 Foch,2,6,8,2022,01-19,08:41
008 Halles Castellane,1,11,12,2022,01-19,08:41
009 Observatoire,6,2,8,2022,01-19,08:41
010 Rondelet,4,12,16,2022,01-19,08:41
011 Plan Cabanes,2,10,12,2022,01-19,08:41
012 Boutonnet,2,10,12,2022,01-19,08:41
013 Emile Combes,1,7,8,2022,01-19,08:41
014 Beaux-Arts,2,6,8,2022,01-19,08:41
015 Les Aubes,6,2,8,2022,01-19,08:41
016 Antigone centre,15,1,16,2022,01-19,08:41
017 M�diath�que Emile Zola,11,5,16,2022,01-19,08:41
018 Nombre d'Or,15,1,16,2022,01-19,08:41
019 Louis Blanc,8,8,16,2022,01-19,08:41
020 Gambetta,3,5,8,2022,01-19,08:41
021 Port Marianne,4,12,16,2022,01-19,08:41
022 Clemenceau,3,9,12,2022,01-19,08:41
023 Les Arceaux,4,12,16,2022,01-19,08:41
024 Cit� Mion,3,5,8,2022,01-19,08:41
025 Nouveau Saint-Roch,3,5,8,2022,01-19,08:41
026 Renouvier,3,5,8,2022,01-19,08:41
027 Odysseum,4,4,8,2022,01-19,08:41
028 Saint-Denis,4,4,8,2022,01-19,08:41
029 Richter,3,13,16,2022,01-19,08:41
030 Charles Flahault,6,2,8,2022,01-19,08:41
031 Voltaire,3,5,8,2022,01-19,08:41
032 Pr�s d'Ar�nes,7,1,8,2022,01-19,08:41
033 Garcia Lorca,7,1,8,2022,01-19,08:41
034 Vert Bois,0,16,16,2022,01-19,08:41
035 Malbosc,1,7,8,2022,01-19,08:41
036 Occitanie,4,28,32,2022,01-19,08:41
037 FacdesSciences,8,16,24,2022,01-19,08:41
038 Fac de Lettres,1,15,16,2022,01-19,08:41
039 Aiguelongue,3,5,8,2022,01-19,08:41
040 Jeu de Mail des Abb�s,8,0,8,2022,01-19,08:41
041 Eurom�decine,0,8,8,2022,01-19,08:41
042 Marie Caizergues,4,4,8,2022,01-19,08:41
043 Sabines,4,4,8,2022,01-19,08:41
044 Celleneuve,1,7,8,2022,01-19,08:41
045 Jardin de la Lironde,0,8,8,2022,01-19,08:41
046 P�re Soulas,4,4,8,2022,01-19,08:41
047 Place Viala,2,6,8,2022,01-19,08:41
048 H�tel du D�partement,0,8,8,2022,01-19,08:41
049 Tonnelles,0,8,8,2022,01-19,08:41
050 Parvis Jules Ferry - Gare Saint-Roch,0,8,8,2022,01-19,08:41
051 Pont de Lattes - Gare Saint-Roch,3,9,12,2022,01-19,08:41
053 Deux Ponts - Gare Saint-Roch,2,6,8,2022,01-19,08:41
054 Providence - Ovalie,3,5,8,2022,01-19,08:41
055 P�rols Etang de l'Or,23,45,68,2022,01-19,08:41
056 Albert 1er - Cath�drale,1,11,12,2022,01-19,08:41
057 Saint-Guilhem - Courreau,4,4,8,2022,01-19,08:41
059 Sud De France,0,8,8,2022,01-19,08:41
001 Rue Jules Ferry - Gare Saint-Roch,2,10,12,2022,01-19,08:51
002 Com�die,13,11,24,2022,01-19,08:51
003 Esplanade,18,14,32,2022,01-19,08:51
004 H�tel de Ville,7,9,16,2022,01-19,08:51
005 Corum,11,1,12,2022,01-19,08:51
006 Place Albert 1er - St Charles,21,10,31,2022,01-19,08:51
007 Foch,2,6,8,2022,01-19,08:51
008 Halles Castellane,1,11,12,2022,01-19,08:51
009 Observatoire,6,2,8,2022,01-19,08:51
010 Rondelet,4,12,16,2022,01-19,08:51
011 Plan Cabanes,3,9,12,2022,01-19,08:51
012 Boutonnet,3,9,12,2022,01-19,08:51
013 Emile Combes,1,7,8,2022,01-19,08:51
014 Beaux-Arts,2,6,8,2022,01-19,08:51
015 Les Aubes,6,2,8,2022,01-19,08:51
016 Antigone centre,16,0,16,2022,01-19,08:51
017 M�diath�que Emile Zola,11,5,16,2022,01-19,08:51
018 Nombre d'Or,15,1,16,2022,01-19,08:51
019 Louis Blanc,9,7,16,2022,01-19,08:51
020 Gambetta,3,5,8,2022,01-19,08:51
021 Port Marianne,4,12,16,2022,01-19,08:51
022 Clemenceau,3,9,12,2022,01-19,08:51
023 Les Arceaux,4,12,16,2022,01-19,08:51
024 Cit� Mion,3,5,8,2022,01-19,08:51
025 Nouveau Saint-Roch,3,5,8,2022,01-19,08:51
026 Renouvier,3,5,8,2022,01-19,08:51
027 Odysseum,4,4,8,2022,01-19,08:51
028 Saint-Denis,4,4,8,2022,01-19,08:51
029 Richter,6,10,16,2022,01-19,08:51
030 Charles Flahault,6,2,8,2022,01-19,08:51
031 Voltaire,3,5,8,2022,01-19,08:51
032 Pr�s d'Ar�nes,7,1,8,2022,01-19,08:51
033 Garcia Lorca,7,1,8,2022,01-19,08:51
034 Vert Bois,0,16,16,2022,01-19,08:51
035 Malbosc,1,7,8,2022,01-19,08:51
036 Occitanie,4,28,32,2022,01-19,08:51
037 FacdesSciences,9,15,24,2022,01-19,08:51
038 Fac de Lettres,1,15,16,2022,01-19,08:51
039 Aiguelongue,3,5,8,2022,01-19,08:51
040 Jeu de Mail des Abb�s,8,0,8,2022,01-19,08:51
041 Eurom�decine,0,8,8,2022,01-19,08:51
042 Marie Caizergues,4,4,8,2022,01-19,08:51
043 Sabines,4,4,8,2022,01-19,08:51
044 Celleneuve,1,7,8,2022,01-19,08:51
045 Jardin de la Lironde,2,6,8,2022,01-19,08:51
046 P�re Soulas,4,4,8,2022,01-19,08:51
047 Place Viala,2,6,8,2022,01-19,08:51
048 H�tel du D�partement,0,8,8,2022,01-19,08:51
049 Tonnelles,0,8,8,2022,01-19,08:51
050 Parvis Jules Ferry - Gare Saint-Roch,0,8,8,2022,01-19,08:51
051 Pont de Lattes - Gare Saint-Roch,3,9,12,2022,01-19,08:51
053 Deux Ponts - Gare Saint-Roch,2,6,8,2022,01-19,08:51
054 Providence - Ovalie,3,5,8,2022,01-19,08:51
055 P�rols Etang de l'Or,23,45,68,2022,01-19,08:51
056 Albert 1er - Cath�drale,1,11,12,2022,01-19,08:51
057 Saint-Guilhem - Courreau,5,3,8,2022,01-19,08:51
059 Sud De France,0,8,8,2022,01-19,08:51
001 Rue Jules Ferry - Gare Saint-Roch,2,10,12,2022,01-19,09:01
002 Com�die,13,11,24,2022,01-19,09:01
003 Esplanade,18,14,32,2022,01-19,09:01
004 H�tel de Ville,7,9,16,2022,01-19,09:01
005 Corum,11,1,12,2022,01-19,09:01
006 Place Albert 1er - St Charles,21,10,31,2022,01-19,09:01
007 Foch,1,7,8,2022,01-19,09:01
008 Halles Castellane,5,7,12,2022,01-19,09:01
009 Observatoire,6,2,8,2022,01-19,09:01
010 Rondelet,4,12,16,2022,01-19,09:01
011 Plan Cabanes,3,9,12,2022,01-19,09:01
012 Boutonnet,3,9,12,2022,01-19,09:01
013 Emile Combes,1,7,8,2022,01-19,09:01
014 Beaux-Arts,2,6,8,2022,01-19,09:01
015 Les Aubes,6,2,8,2022,01-19,09:01
016 Antigone centre,16,0,16,2022,01-19,09:01
017 M�diath�que Emile Zola,11,5,16,2022,01-19,09:01
018 Nombre d'Or,15,1,16,2022,01-19,09:01
019 Louis Blanc,9,7,16,2022,01-19,09:01
020 Gambetta,3,5,8,2022,01-19,09:01
021 Port Marianne,5,11,16,2022,01-19,09:01
022 Clemenceau,3,9,12,2022,01-19,09:01
023 Les Arceaux,4,12,16,2022,01-19,09:01
024 Cit� Mion,3,5,8,2022,01-19,09:01
025 Nouveau Saint-Roch,3,5,8,2022,01-19,09:01
026 Renouvier,3,5,8,2022,01-19,09:01
027 Odysseum,4,4,8,2022,01-19,09:01
028 Saint-Denis,4,4,8,2022,01-19,09:01
029 Richter,6,10,16,2022,01-19,09:01
030 Charles Flahault,6,2,8,2022,01-19,09:01
031 Voltaire,3,5,8,2022,01-19,09:01
032 Pr�s d'Ar�nes,7,1,8,2022,01-19,09:01
033 Garcia Lorca,7,1,8,2022,01-19,09:01
034 Vert Bois,0,16,16,2022,01-19,09:01
035 Malbosc,1,7,8,2022,01-19,09:01
036 Occitanie,4,28,32,2022,01-19,09:01
037 FacdesSciences,9,15,24,2022,01-19,09:01
038 Fac de Lettres,1,15,16,2022,01-19,09:01
039 Aiguelongue,3,5,8,2022,01-19,09:01
040 Jeu de Mail des Abb�s,8,0,8,2022,01-19,09:01
041 Eurom�decine,0,8,8,2022,01-19,09:01
042 Marie Caizergues,4,4,8,2022,01-19,09:01
043 Sabines,4,4,8,2022,01-19,09:01
044 Celleneuve,1,7,8,2022,01-19,09:01
045 Jardin de la Lironde,2,6,8,2022,01-19,09:01
046 P�re Soulas,4,4,8,2022,01-19,09:01
047 Place Viala,2,6,8,2022,01-19,09:01
048 H�tel du D�partement,0,8,8,2022,01-19,09:01
049 Tonnelles,0,8,8,2022,01-19,09:01
050 Parvis Jules Ferry - Gare Saint-Roch,0,8,8,2022,01-19,09:01
051 Pont de Lattes - Gare Saint-Roch,3,9,12,2022,01-19,09:01
053 Deux Ponts - Gare Saint-Roch,2,6,8,2022,01-19,09:01
054 Providence - Ovalie,3,5,8,2022,01-19,09:01
055 P�rols Etang de l'Or,23,45,68,2022,01-19,09:01
056 Albert 1er - Cath�drale,1,11,12,2022,01-19,09:01
057 Saint-Guilhem - Courreau,5,3,8,2022,01-19,09:01
059 Sud De France,0,8,8,2022,01-19,09:01
001 Rue Jules Ferry - Gare Saint-Roch,2,10,12,2022,01-19,09:11
002 Com�die,11,13,24,2022,01-19,09:11
003 Esplanade,18,14,32,2022,01-19,09:11
004 H�tel de Ville,7,9,16,2022,01-19,09:11
005 Corum,11,1,12,2022,01-19,09:11
006 Place Albert 1er - St Charles,21,10,31,2022,01-19,09:11
007 Foch,7,1,8,2022,01-19,09:11
008 Halles Castellane,9,3,12,2022,01-19,09:11
009 Observatoire,6,2,8,2022,01-19,09:11
010 Rondelet,4,12,16,2022,01-19,09:11
011 Plan Cabanes,3,9,12,2022,01-19,09:11
012 Boutonnet,3,9,12,2022,01-19,09:11
013 Emile Combes,1,7,8,2022,01-19,09:11
014 Beaux-Arts,2,6,8,2022,01-19,09:11
015 Les Aubes,6,2,8,2022,01-19,09:11
016 Antigone centre,16,0,16,2022,01-19,09:11
017 M�diath�que Emile Zola,11,5,16,2022,01-19,09:11
018 Nombre d'Or,15,1,16,2022,01-19,09:11
019 Louis Blanc,8,8,16,2022,01-19,09:11
020 Gambetta,3,5,8,2022,01-19,09:11
021 Port Marianne,5,11,16,2022,01-19,09:11
022 Clemenceau,3,9,12,2022,01-19,09:11
023 Les Arceaux,4,12,16,2022,01-19,09:11
024 Cit� Mion,3,5,8,2022,01-19,09:11
025 Nouveau Saint-Roch,3,5,8,2022,01-19,09:11
026 Renouvier,3,5,8,2022,01-19,09:11
027 Odysseum,4,4,8,2022,01-19,09:11
028 Saint-Denis,4,4,8,2022,01-19,09:11
029 Richter,6,10,16,2022,01-19,09:11
030 Charles Flahault,6,2,8,2022,01-19,09:11
031 Voltaire,3,5,8,2022,01-19,09:11
032 Pr�s d'Ar�nes,7,1,8,2022,01-19,09:11
033 Garcia Lorca,7,1,8,2022,01-19,09:11
034 Vert Bois,0,16,16,2022,01-19,09:11
035 Malbosc,1,7,8,2022,01-19,09:11
036 Occitanie,4,28,32,2022,01-19,09:11
037 FacdesSciences,9,15,24,2022,01-19,09:11
038 Fac de Lettres,1,15,16,2022,01-19,09:11
039 Aiguelongue,3,5,8,2022,01-19,09:11
040 Jeu de Mail des Abb�s,8,0,8,2022,01-19,09:11
041 Eurom�decine,0,8,8,2022,01-19,09:11
042 Marie Caizergues,4,4,8,2022,01-19,09:11
043 Sabines,4,4,8,2022,01-19,09:11
044 Celleneuve,1,7,8,2022,01-19,09:11
045 Jardin de la Lironde,2,6,8,2022,01-19,09:11
046 P�re Soulas,4,4,8,2022,01-19,09:11
047 Place Viala,2,6,8,2022,01-19,09:11
048 H�tel du D�partement,0,8,8,2022,01-19,09:11
049 Tonnelles,0,8,8,2022,01-19,09:11
050 Parvis Jules Ferry - Gare Saint-Roch,0,8,8,2022,01-19,09:11
051 Pont de Lattes - Gare Saint-Roch,3,9,12,2022,01-19,09:11
053 Deux Ponts - Gare Saint-Roch,2,6,8,2022,01-19,09:11
054 Providence - Ovalie,3,5,8,2022,01-19,09:11
055 P�rols Etang de l'Or,23,45,68,2022,01-19,09:11
056 Albert 1er - Cath�drale,1,11,12,2022,01-19,09:11
057 Saint-Guilhem - Courreau,5,3,8,2022,01-19,09:11
059 Sud De France,0,8,8,2022,01-19,09:11
001 Rue Jules Ferry - Gare Saint-Roch,2,10,12,2022,01-19,09:21
002 Com�die,11,13,24,2022,01-19,09:21
003 Esplanade,18,14,32,2022,01-19,09:21
004 H�tel de Ville,8,8,16,2022,01-19,09:21
005 Corum,11,1,12,2022,01-19,09:21
006 Place Albert 1er - St Charles,21,10,31,2022,01-19,09:21
007 Foch,7,1,8,2022,01-19,09:21
008 Halles Castellane,10,2,12,2022,01-19,09:21
009 Observatoire,6,2,8,2022,01-19,09:21
010 Rondelet,4,12,16,2022,01-19,09:21
011 Plan Cabanes,3,9,12,2022,01-19,09:21
012 Boutonnet,3,9,12,2022,01-19,09:21
013 Emile Combes,1,7,8,2022,01-19,09:21
014 Beaux-Arts,2,6,8,2022,01-19,09:21
015 Les Aubes,6,2,8,2022,01-19,09:21
016 Antigone centre,15,1,16,2022,01-19,09:21
017 M�diath�que Emile Zola,12,4,16,2022,01-19,09:21
018 Nombre d'Or,15,1,16,2022,01-19,09:21
019 Louis Blanc,8,8,16,2022,01-19,09:21
020 Gambetta,3,5,8,2022,01-19,09:21
021 Port Marianne,5,11,16,2022,01-19,09:21
022 Clemenceau,2,10,12,2022,01-19,09:21
023 Les Arceaux,3,13,16,2022,01-19,09:21
024 Cit� Mion,3,5,8,2022,01-19,09:21
025 Nouveau Saint-Roch,4,4,8,2022,01-19,09:21
026 Renouvier,4,4,8,2022,01-19,09:21
027 Odysseum,4,4,8,2022,01-19,09:21
028 Saint-Denis,4,4,8,2022,01-19,09:21
029 Richter,7,9,16,2022,01-19,09:21
030 Charles Flahault,6,2,8,2022,01-19,09:21
031 Voltaire,3,5,8,2022,01-19,09:21
032 Pr�s d'Ar�nes,7,1,8,2022,01-19,09:21
033 Garcia Lorca,7,1,8,2022,01-19,09:21
034 Vert Bois,0,16,16,2022,01-19,09:21
035 Malbosc,1,7,8,2022,01-19,09:21
036 Occitanie,4,28,32,2022,01-19,09:21
037 FacdesSciences,9,15,24,2022,01-19,09:21
038 Fac de Lettres,1,15,16,2022,01-19,09:21
039 Aiguelongue,2,6,8,2022,01-19,09:21
040 Jeu de Mail des Abb�s,8,0,8,2022,01-19,09:21
041 Eurom�decine,0,8,8,2022,01-19,09:21
042 Marie Caizergues,3,5,8,2022,01-19,09:21
043 Sabines,4,4,8,2022,01-19,09:21
044 Celleneuve,1,7,8,2022,01-19,09:21
045 Jardin de la Lironde,2,6,8,2022,01-19,09:21
046 P�re Soulas,4,4,8,2022,01-19,09:21
047 Place Viala,2,6,8,2022,01-19,09:21
048 H�tel du D�partement,0,8,8,2022,01-19,09:21
049 Tonnelles,0,8,8,2022,01-19,09:21
050 Parvis Jules Ferry - Gare Saint-Roch,0,8,8,2022,01-19,09:21
051 Pont de Lattes - Gare Saint-Roch,3,9,12,2022,01-19,09:21
053 Deux Ponts - Gare Saint-Roch,2,6,8,2022,01-19,09:21
054 Providence - Ovalie,3,5,8,2022,01-19,09:21
055 P�rols Etang de l'Or,23,45,68,2022,01-19,09:21
056 Albert 1er - Cath�drale,1,11,12,2022,01-19,09:21
057 Saint-Guilhem - Courreau,5,3,8,2022,01-19,09:21
059 Sud De France,0,8,8,2022,01-19,09:21
001 Rue Jules Ferry - Gare Saint-Roch,1,11,12,2022,01-19,09:31
002 Com�die,11,13,24,2022,01-19,09:31
003 Esplanade,17,15,32,2022,01-19,09:31
004 H�tel de Ville,8,8,16,2022,01-19,09:31
005 Corum,12,0,12,2022,01-19,09:31
006 Place Albert 1er - St Charles,22,9,31,2022,01-19,09:31
007 Foch,7,1,8,2022,01-19,09:31
008 Halles Castellane,10,2,12,2022,01-19,09:31
009 Observatoire,6,2,8,2022,01-19,09:31
010 Rondelet,4,12,16,2022,01-19,09:31
011 Plan Cabanes,3,9,12,2022,01-19,09:31
012 Boutonnet,3,9,12,2022,01-19,09:31
013 Emile Combes,1,7,8,2022,01-19,09:31
014 Beaux-Arts,2,6,8,2022,01-19,09:31
015 Les Aubes,6,2,8,2022,01-19,09:31
016 Antigone centre,14,2,16,2022,01-19,09:31
017 M�diath�que Emile Zola,11,5,16,2022,01-19,09:31
018 Nombre d'Or,15,1,16,2022,01-19,09:31
019 Louis Blanc,8,8,16,2022,01-19,09:31
020 Gambetta,3,5,8,2022,01-19,09:31
021 Port Marianne,5,11,16,2022,01-19,09:31
022 Clemenceau,2,10,12,2022,01-19,09:31
023 Les Arceaux,3,13,16,2022,01-19,09:31
024 Cit� Mion,2,6,8,2022,01-19,09:31
025 Nouveau Saint-Roch,4,4,8,2022,01-19,09:31
026 Renouvier,4,4,8,2022,01-19,09:31
027 Odysseum,4,4,8,2022,01-19,09:31
028 Saint-Denis,4,4,8,2022,01-19,09:31
029 Richter,11,5,16,2022,01-19,09:31
030 Charles Flahault,6,2,8,2022,01-19,09:31
031 Voltaire,4,4,8,2022,01-19,09:31
032 Pr�s d'Ar�nes,7,1,8,2022,01-19,09:31
033 Garcia Lorca,7,1,8,2022,01-19,09:31
034 Vert Bois,0,16,16,2022,01-19,09:31
035 Malbosc,1,7,8,2022,01-19,09:31
036 Occitanie,4,28,32,2022,01-19,09:31
037 FacdesSciences,10,14,24,2022,01-19,09:31
038 Fac de Lettres,1,15,16,2022,01-19,09:31
039 Aiguelongue,2,6,8,2022,01-19,09:31
040 Jeu de Mail des Abb�s,8,0,8,2022,01-19,09:31
041 Eurom�decine,0,8,8,2022,01-19,09:31
042 Marie Caizergues,3,5,8,2022,01-19,09:31
043 Sabines,4,4,8,2022,01-19,09:31
044 Celleneuve,1,7,8,2022,01-19,09:31
045 Jardin de la Lironde,2,6,8,2022,01-19,09:31
046 P�re Soulas,4,4,8,2022,01-19,09:31
047 Place Viala,3,5,8,2022,01-19,09:31
048 H�tel du D�partement,0,8,8,2022,01-19,09:31
049 Tonnelles,0,8,8,2022,01-19,09:31
050 Parvis Jules Ferry - Gare Saint-Roch,0,8,8,2022,01-19,09:31
051 Pont de Lattes - Gare Saint-Roch,3,9,12,2022,01-19,09:31
053 Deux Ponts - Gare Saint-Roch,2,6,8,2022,01-19,09:31
054 Providence - Ovalie,3,5,8,2022,01-19,09:31
055 P�rols Etang de l'Or,23,45,68,2022,01-19,09:31
056 Albert 1er - Cath�drale,1,11,12,2022,01-19,09:31
057 Saint-Guilhem - Courreau,4,4,8,2022,01-19,09:31
059 Sud De France,0,8,8,2022,01-19,09:31
001 Rue Jules Ferry - Gare Saint-Roch,1,11,12,2022,01-19,09:41
002 Com�die,11,13,24,2022,01-19,09:41
003 Esplanade,17,15,32,2022,01-19,09:41
004 H�tel de Ville,8,8,16,2022,01-19,09:41
005 Corum,12,0,12,2022,01-19,09:41
006 Place Albert 1er - St Charles,21,10,31,2022,01-19,09:41
007 Foch,7,1,8,2022,01-19,09:41
008 Halles Castellane,10,2,12,2022,01-19,09:41
009 Observatoire,6,2,8,2022,01-19,09:41
010 Rondelet,4,12,16,2022,01-19,09:41
011 Plan Cabanes,3,9,12,2022,01-19,09:41
012 Boutonnet,3,9,12,2022,01-19,09:41
013 Emile Combes,1,7,8,2022,01-19,09:41
014 Beaux-Arts,2,6,8,2022,01-19,09:41
015 Les Aubes,6,2,8,2022,01-19,09:41
016 Antigone centre,14,2,16,2022,01-19,09:41
017 M�diath�que Emile Zola,11,5,16,2022,01-19,09:41
018 Nombre d'Or,16,0,16,2022,01-19,09:41
019 Louis Blanc,8,8,16,2022,01-19,09:41
020 Gambetta,3,5,8,2022,01-19,09:41
021 Port Marianne,5,11,16,2022,01-19,09:41
022 Clemenceau,2,10,12,2022,01-19,09:41
023 Les Arceaux,3,13,16,2022,01-19,09:41
024 Cit� Mion,2,6,8,2022,01-19,09:41
025 Nouveau Saint-Roch,4,4,8,2022,01-19,09:41
026 Renouvier,4,4,8,2022,01-19,09:41
027 Odysseum,4,4,8,2022,01-19,09:41
028 Saint-Denis,4,4,8,2022,01-19,09:41
029 Richter,11,5,16,2022,01-19,09:41
030 Charles Flahault,6,2,8,2022,01-19,09:41
031 Voltaire,4,4,8,2022,01-19,09:41
032 Pr�s d'Ar�nes,7,1,8,2022,01-19,09:41
033 Garcia Lorca,7,1,8,2022,01-19,09:41
034 Vert Bois,0,16,16,2022,01-19,09:41
035 Malbosc,1,7,8,2022,01-19,09:41
036 Occitanie,4,28,32,2022,01-19,09:41
037 FacdesSciences,10,14,24,2022,01-19,09:41
038 Fac de Lettres,1,15,16,2022,01-19,09:41
039 Aiguelongue,2,6,8,2022,01-19,09:41
040 Jeu de Mail des Abb�s,8,0,8,2022,01-19,09:41
041 Eurom�decine,0,8,8,2022,01-19,09:41
042 Marie Caizergues,3,5,8,2022,01-19,09:41
043 Sabines,4,4,8,2022,01-19,09:41
044 Celleneuve,0,8,8,2022,01-19,09:41
045 Jardin de la Lironde,2,6,8,2022,01-19,09:41
046 P�re Soulas,4,4,8,2022,01-19,09:41
047 Place Viala,3,5,8,2022,01-19,09:41
048 H�tel du D�partement,0,8,8,2022,01-19,09:41
049 Tonnelles,0,8,8,2022,01-19,09:41
050 Parvis Jules Ferry - Gare Saint-Roch,0,8,8,2022,01-19,09:41
051 Pont de Lattes - Gare Saint-Roch,3,9,12,2022,01-19,09:41
053 Deux Ponts - Gare Saint-Roch,2,6,8,2022,01-19,09:41
054 Providence - Ovalie,3,5,8,2022,01-19,09:41
055 P�rols Etang de l'Or,23,45,68,2022,01-19,09:41
056 Albert 1er - Cath�drale,1,11,12,2022,01-19,09:41
057 Saint-Guilhem - Courreau,4,4,8,2022,01-19,09:41
059 Sud De France,0,8,8,2022,01-19,09:41
001 Rue Jules Ferry - Gare Saint-Roch,2,10,12,2022,01-19,09:52
002 Com�die,11,13,24,2022,01-19,09:52
003 Esplanade,17,15,32,2022,01-19,09:52
004 H�tel de Ville,8,8,16,2022,01-19,09:52
005 Corum,12,0,12,2022,01-19,09:52
006 Place Albert 1er - St Charles,22,9,31,2022,01-19,09:52
007 Foch,7,1,8,2022,01-19,09:52
008 Halles Castellane,10,2,12,2022,01-19,09:52
009 Observatoire,6,2,8,2022,01-19,09:52
010 Rondelet,4,12,16,2022,01-19,09:52
011 Plan Cabanes,2,10,12,2022,01-19,09:52
012 Boutonnet,2,10,12,2022,01-19,09:52
013 Emile Combes,1,7,8,2022,01-19,09:52
014 Beaux-Arts,2,6,8,2022,01-19,09:52
015 Les Aubes,6,2,8,2022,01-19,09:52
016 Antigone centre,14,2,16,2022,01-19,09:52
017 M�diath�que Emile Zola,11,5,16,2022,01-19,09:52
018 Nombre d'Or,12,4,16,2022,01-19,09:52
019 Louis Blanc,7,9,16,2022,01-19,09:52
020 Gambetta,3,5,8,2022,01-19,09:52
021 Port Marianne,5,11,16,2022,01-19,09:52
022 Clemenceau,2,10,12,2022,01-19,09:52
023 Les Arceaux,3,13,16,2022,01-19,09:52
024 Cit� Mion,2,6,8,2022,01-19,09:52
025 Nouveau Saint-Roch,4,4,8,2022,01-19,09:52
026 Renouvier,4,4,8,2022,01-19,09:52
027 Odysseum,4,4,8,2022,01-19,09:52
028 Saint-Denis,4,4,8,2022,01-19,09:52
029 Richter,11,5,16,2022,01-19,09:52
030 Charles Flahault,5,3,8,2022,01-19,09:52
031 Voltaire,4,4,8,2022,01-19,09:52
032 Pr�s d'Ar�nes,7,1,8,2022,01-19,09:52
033 Garcia Lorca,7,1,8,2022,01-19,09:52
034 Vert Bois,0,16,16,2022,01-19,09:52
035 Malbosc,1,7,8,2022,01-19,09:52
036 Occitanie,3,29,32,2022,01-19,09:52
037 FacdesSciences,11,13,24,2022,01-19,09:52
038 Fac de Lettres,1,15,16,2022,01-19,09:52
039 Aiguelongue,2,6,8,2022,01-19,09:52
040 Jeu de Mail des Abb�s,8,0,8,2022,01-19,09:52
041 Eurom�decine,0,8,8,2022,01-19,09:52
042 Marie Caizergues,3,5,8,2022,01-19,09:52
043 Sabines,4,4,8,2022,01-19,09:52
044 Celleneuve,0,8,8,2022,01-19,09:52
045 Jardin de la Lironde,2,6,8,2022,01-19,09:52
046 P�re Soulas,2,6,8,2022,01-19,09:52
047 Place Viala,3,5,8,2022,01-19,09:52
048 H�tel du D�partement,0,8,8,2022,01-19,09:52
049 Tonnelles,0,8,8,2022,01-19,09:52
050 Parvis Jules Ferry - Gare Saint-Roch,0,8,8,2022,01-19,09:52
051 Pont de Lattes - Gare Saint-Roch,3,9,12,2022,01-19,09:52
053 Deux Ponts - Gare Saint-Roch,2,6,8,2022,01-19,09:52
054 Providence - Ovalie,3,5,8,2022,01-19,09:52
055 P�rols Etang de l'Or,23,45,68,2022,01-19,09:52
056 Albert 1er - Cath�drale,1,11,12,2022,01-19,09:52
057 Saint-Guilhem - Courreau,4,4,8,2022,01-19,09:52
059 Sud De France,0,8,8,2022,01-19,09:52
001 Rue Jules Ferry - Gare Saint-Roch,2,10,12,2022,01-19,10:02
002 Com�die,11,13,24,2022,01-19,10:02
003 Esplanade,17,15,32,2022,01-19,10:02
004 H�tel de Ville,8,8,16,2022,01-19,10:02
005 Corum,12,0,12,2022,01-19,10:02
006 Place Albert 1er - St Charles,22,9,31,2022,01-19,10:02
007 Foch,8,0,8,2022,01-19,10:02
008 Halles Castellane,9,3,12,2022,01-19,10:02
009 Observatoire,6,2,8,2022,01-19,10:02
010 Rondelet,4,12,16,2022,01-19,10:02
011 Plan Cabanes,2,10,12,2022,01-19,10:02
012 Boutonnet,2,10,12,2022,01-19,10:02
013 Emile Combes,1,7,8,2022,01-19,10:02
014 Beaux-Arts,2,6,8,2022,01-19,10:02
015 Les Aubes,6,2,8,2022,01-19,10:02
016 Antigone centre,14,2,16,2022,01-19,10:02
017 M�diath�que Emile Zola,11,5,16,2022,01-19,10:02
018 Nombre d'Or,4,12,16,2022,01-19,10:02
019 Louis Blanc,7,9,16,2022,01-19,10:02
020 Gambetta,3,5,8,2022,01-19,10:02
021 Port Marianne,5,11,16,2022,01-19,10:02
022 Clemenceau,2,10,12,2022,01-19,10:02
023 Les Arceaux,2,14,16,2022,01-19,10:02
024 Cit� Mion,2,6,8,2022,01-19,10:02
025 Nouveau Saint-Roch,4,4,8,2022,01-19,10:02
026 Renouvier,4,4,8,2022,01-19,10:02
027 Odysseum,4,4,8,2022,01-19,10:02
028 Saint-Denis,4,4,8,2022,01-19,10:02
029 Richter,11,5,16,2022,01-19,10:02
030 Charles Flahault,5,3,8,2022,01-19,10:02
031 Voltaire,3,5,8,2022,01-19,10:02
032 Pr�s d'Ar�nes,7,1,8,2022,01-19,10:02
033 Garcia Lorca,7,1,8,2022,01-19,10:02
034 Vert Bois,0,16,16,2022,01-19,10:02
035 Malbosc,1,7,8,2022,01-19,10:02
036 Occitanie,3,29,32,2022,01-19,10:02
037 FacdesSciences,13,11,24,2022,01-19,10:02
038 Fac de Lettres,1,15,16,2022,01-19,10:02
039 Aiguelongue,2,6,8,2022,01-19,10:02
040 Jeu de Mail des Abb�s,8,0,8,2022,01-19,10:02
041 Eurom�decine,0,8,8,2022,01-19,10:02
042 Marie Caizergues,3,5,8,2022,01-19,10:02
043 Sabines,4,4,8,2022,01-19,10:02
044 Celleneuve,0,8,8,2022,01-19,10:02
045 Jardin de la Lironde,2,6,8,2022,01-19,10:02
046 P�re Soulas,2,6,8,2022,01-19,10:02
047 Place Viala,3,5,8,2022,01-19,10:02
048 H�tel du D�partement,0,8,8,2022,01-19,10:02
049 Tonnelles,0,8,8,2022,01-19,10:02
050 Parvis Jules Ferry - Gare Saint-Roch,0,8,8,2022,01-19,10:02
051 Pont de Lattes - Gare Saint-Roch,3,9,12,2022,01-19,10:02
053 Deux Ponts - Gare Saint-Roch,2,6,8,2022,01-19,10:02
054 Providence - Ovalie,3,5,8,2022,01-19,10:02
055 P�rols Etang de l'Or,23,45,68,2022,01-19,10:02
056 Albert 1er - Cath�drale,1,11,12,2022,01-19,10:02
057 Saint-Guilhem - Courreau,4,4,8,2022,01-19,10:02
059 Sud De France,0,8,8,2022,01-19,10:02
001 Rue Jules Ferry - Gare Saint-Roch,2,10,12,2022,01-19,10:12
002 Com�die,11,13,24,2022,01-19,10:12
003 Esplanade,17,15,32,2022,01-19,10:12
004 H�tel de Ville,8,8,16,2022,01-19,10:12
005 Corum,12,0,12,2022,01-19,10:12
006 Place Albert 1er - St Charles,22,9,31,2022,01-19,10:12
007 Foch,8,0,8,2022,01-19,10:12
008 Halles Castellane,9,3,12,2022,01-19,10:12
009 Observatoire,6,2,8,2022,01-19,10:12
010 Rondelet,4,12,16,2022,01-19,10:12
011 Plan Cabanes,2,10,12,2022,01-19,10:12
012 Boutonnet,2,10,12,2022,01-19,10:12
013 Emile Combes,1,7,8,2022,01-19,10:12
014 Beaux-Arts,2,6,8,2022,01-19,10:12
015 Les Aubes,6,2,8,2022,01-19,10:12
016 Antigone centre,14,2,16,2022,01-19,10:12
017 M�diath�que Emile Zola,13,3,16,2022,01-19,10:12
018 Nombre d'Or,4,12,16,2022,01-19,10:12
019 Louis Blanc,7,9,16,2022,01-19,10:12
020 Gambetta,3,5,8,2022,01-19,10:12
021 Port Marianne,5,11,16,2022,01-19,10:12
022 Clemenceau,2,10,12,2022,01-19,10:12
023 Les Arceaux,2,14,16,2022,01-19,10:12
024 Cit� Mion,2,6,8,2022,01-19,10:12
025 Nouveau Saint-Roch,4,4,8,2022,01-19,10:12
026 Renouvier,4,4,8,2022,01-19,10:12
027 Odysseum,4,4,8,2022,01-19,10:12
028 Saint-Denis,4,4,8,2022,01-19,10:12
029 Richter,11,5,16,2022,01-19,10:12
030 Charles Flahault,5,3,8,2022,01-19,10:12
031 Voltaire,3,5,8,2022,01-19,10:12
032 Pr�s d'Ar�nes,7,1,8,2022,01-19,10:12
033 Garcia Lorca,7,1,8,2022,01-19,10:12
034 Vert Bois,0,16,16,2022,01-19,10:12
035 Malbosc,2,6,8,2022,01-19,10:12
036 Occitanie,4,28,32,2022,01-19,10:12
037 FacdesSciences,13,11,24,2022,01-19,10:12
038 Fac de Lettres,1,15,16,2022,01-19,10:12
039 Aiguelongue,2,6,8,2022,01-19,10:12
040 Jeu de Mail des Abb�s,8,0,8,2022,01-19,10:12
041 Eurom�decine,0,8,8,2022,01-19,10:12
042 Marie Caizergues,3,5,8,2022,01-19,10:12
043 Sabines,4,4,8,2022,01-19,10:12
044 Celleneuve,0,8,8,2022,01-19,10:12
045 Jardin de la Lironde,2,6,8,2022,01-19,10:12
046 P�re Soulas,2,6,8,2022,01-19,10:12
047 Place Viala,3,5,8,2022,01-19,10:12
048 H�tel du D�partement,0,8,8,2022,01-19,10:12
049 Tonnelles,0,8,8,2022,01-19,10:12
050 Parvis Jules Ferry - Gare Saint-Roch,0,8,8,2022,01-19,10:12
051 Pont de Lattes - Gare Saint-Roch,2,10,12,2022,01-19,10:12
053 Deux Ponts - Gare Saint-Roch,2,6,8,2022,01-19,10:12
054 Providence - Ovalie,3,5,8,2022,01-19,10:12
055 P�rols Etang de l'Or,23,45,68,2022,01-19,10:12
056 Albert 1er - Cath�drale,1,11,12,2022,01-19,10:12
057 Saint-Guilhem - Courreau,4,4,8,2022,01-19,10:12
059 Sud De France,0,8,8,2022,01-19,10:12
001 Rue Jules Ferry - Gare Saint-Roch,2,10,12,2022,01-19,10:22
002 Com�die,11,13,24,2022,01-19,10:22
003 Esplanade,17,15,32,2022,01-19,10:22
004 H�tel de Ville,8,8,16,2022,01-19,10:22
005 Corum,12,0,12,2022,01-19,10:22
006 Place Albert 1er - St Charles,22,9,31,2022,01-19,10:22
007 Foch,8,0,8,2022,01-19,10:22
008 Halles Castellane,9,3,12,2022,01-19,10:22
009 Observatoire,6,2,8,2022,01-19,10:22
010 Rondelet,4,12,16,2022,01-19,10:22
011 Plan Cabanes,3,9,12,2022,01-19,10:22
012 Boutonnet,2,10,12,2022,01-19,10:22
013 Emile Combes,1,7,8,2022,01-19,10:22
014 Beaux-Arts,2,6,8,2022,01-19,10:22
015 Les Aubes,6,2,8,2022,01-19,10:22
016 Antigone centre,14,2,16,2022,01-19,10:22
017 M�diath�que Emile Zola,13,3,16,2022,01-19,10:22
018 Nombre d'Or,4,12,16,2022,01-19,10:22
019 Louis Blanc,7,9,16,2022,01-19,10:22
020 Gambetta,3,5,8,2022,01-19,10:22
021 Port Marianne,5,11,16,2022,01-19,10:22
022 Clemenceau,2,10,12,2022,01-19,10:22
023 Les Arceaux,2,14,16,2022,01-19,10:22
024 Cit� Mion,2,6,8,2022,01-19,10:22
025 Nouveau Saint-Roch,4,4,8,2022,01-19,10:22
026 Renouvier,4,4,8,2022,01-19,10:22
027 Odysseum,4,4,8,2022,01-19,10:22
028 Saint-Denis,4,4,8,2022,01-19,10:22
029 Richter,11,5,16,2022,01-19,10:22
030 Charles Flahault,5,3,8,2022,01-19,10:22
031 Voltaire,3,5,8,2022,01-19,10:22
032 Pr�s d'Ar�nes,7,1,8,2022,01-19,10:22
033 Garcia Lorca,7,1,8,2022,01-19,10:22
034 Vert Bois,0,16,16,2022,01-19,10:22
035 Malbosc,2,6,8,2022,01-19,10:22
036 Occitanie,4,28,32,2022,01-19,10:22
037 FacdesSciences,13,11,24,2022,01-19,10:22
038 Fac de Lettres,1,15,16,2022,01-19,10:22
039 Aiguelongue,2,6,8,2022,01-19,10:22
040 Jeu de Mail des Abb�s,8,0,8,2022,01-19,10:22
041 Eurom�decine,0,8,8,2022,01-19,10:22
042 Marie Caizergues,2,6,8,2022,01-19,10:22
043 Sabines,4,4,8,2022,01-19,10:22
044 Celleneuve,0,8,8,2022,01-19,10:22
045 Jardin de la Lironde,2,6,8,2022,01-19,10:22
046 P�re Soulas,2,6,8,2022,01-19,10:22
047 Place Viala,3,5,8,2022,01-19,10:22
048 H�tel du D�partement,0,8,8,2022,01-19,10:22
049 Tonnelles,0,8,8,2022,01-19,10:22
050 Parvis Jules Ferry - Gare Saint-Roch,0,8,8,2022,01-19,10:22
051 Pont de Lattes - Gare Saint-Roch,2,10,12,2022,01-19,10:22
053 Deux Ponts - Gare Saint-Roch,2,6,8,2022,01-19,10:22
054 Providence - Ovalie,3,5,8,2022,01-19,10:22
055 P�rols Etang de l'Or,23,45,68,2022,01-19,10:22
056 Albert 1er - Cath�drale,1,11,12,2022,01-19,10:22
057 Saint-Guilhem - Courreau,4,4,8,2022,01-19,10:22
059 Sud De France,0,8,8,2022,01-19,10:22
001 Rue Jules Ferry - Gare Saint-Roch,3,9,12,2022,01-19,10:32
002 Com�die,11,13,24,2022,01-19,10:32
003 Esplanade,17,15,32,2022,01-19,10:32
004 H�tel de Ville,8,8,16,2022,01-19,10:32
005 Corum,12,0,12,2022,01-19,10:32
006 Place Albert 1er - St Charles,22,9,31,2022,01-19,10:32
007 Foch,8,0,8,2022,01-19,10:32
008 Halles Castellane,9,3,12,2022,01-19,10:32
009 Observatoire,6,2,8,2022,01-19,10:32
010 Rondelet,4,12,16,2022,01-19,10:32
011 Plan Cabanes,3,9,12,2022,01-19,10:32
012 Boutonnet,2,10,12,2022,01-19,10:32
013 Emile Combes,1,7,8,2022,01-19,10:32
014 Beaux-Arts,2,6,8,2022,01-19,10:32
015 Les Aubes,6,2,8,2022,01-19,10:32
016 Antigone centre,14,2,16,2022,01-19,10:32
017 M�diath�que Emile Zola,13,3,16,2022,01-19,10:32
018 Nombre d'Or,4,12,16,2022,01-19,10:32
019 Louis Blanc,7,9,16,2022,01-19,10:32
020 Gambetta,3,5,8,2022,01-19,10:32
021 Port Marianne,5,11,16,2022,01-19,10:32
022 Clemenceau,2,10,12,2022,01-19,10:32
023 Les Arceaux,4,12,16,2022,01-19,10:32
024 Cit� Mion,2,6,8,2022,01-19,10:32
025 Nouveau Saint-Roch,4,4,8,2022,01-19,10:32
026 Renouvier,4,4,8,2022,01-19,10:32
027 Odysseum,4,4,8,2022,01-19,10:32
028 Saint-Denis,4,4,8,2022,01-19,10:32
029 Richter,11,5,16,2022,01-19,10:32
030 Charles Flahault,5,3,8,2022,01-19,10:32
031 Voltaire,2,6,8,2022,01-19,10:32
032 Pr�s d'Ar�nes,7,1,8,2022,01-19,10:32
033 Garcia Lorca,7,1,8,2022,01-19,10:32
034 Vert Bois,0,16,16,2022,01-19,10:32
035 Malbosc,2,6,8,2022,01-19,10:32
036 Occitanie,4,28,32,2022,01-19,10:32
037 FacdesSciences,12,12,24,2022,01-19,10:32
038 Fac de Lettres,2,14,16,2022,01-19,10:32
039 Aiguelongue,2,6,8,2022,01-19,10:32
040 Jeu de Mail des Abb�s,8,0,8,2022,01-19,10:32
041 Eurom�decine,0,8,8,2022,01-19,10:32
042 Marie Caizergues,2,6,8,2022,01-19,10:32
043 Sabines,4,4,8,2022,01-19,10:32
044 Celleneuve,0,8,8,2022,01-19,10:32
045 Jardin de la Lironde,2,6,8,2022,01-19,10:32
046 P�re Soulas,2,6,8,2022,01-19,10:32
047 Place Viala,3,5,8,2022,01-19,10:32
048 H�tel du D�partement,0,8,8,2022,01-19,10:32
049 Tonnelles,0,8,8,2022,01-19,10:32
050 Parvis Jules Ferry - Gare Saint-Roch,0,8,8,2022,01-19,10:32
051 Pont de Lattes - Gare Saint-Roch,2,10,12,2022,01-19,10:32
053 Deux Ponts - Gare Saint-Roch,2,6,8,2022,01-19,10:32
054 Providence - Ovalie,3,5,8,2022,01-19,10:32
055 P�rols Etang de l'Or,23,45,68,2022,01-19,10:32
056 Albert 1er - Cath�drale,1,11,12,2022,01-19,10:32
057 Saint-Guilhem - Courreau,4,4,8,2022,01-19,10:32
059 Sud De France,0,8,8,2022,01-19,10:32
001 Rue Jules Ferry - Gare Saint-Roch,4,8,12,2022,01-19,10:43
002 Com�die,11,13,24,2022,01-19,10:43
003 Esplanade,17,15,32,2022,01-19,10:43
004 H�tel de Ville,8,8,16,2022,01-19,10:43
005 Corum,12,0,12,2022,01-19,10:43
006 Place Albert 1er - St Charles,23,8,31,2022,01-19,10:43
007 Foch,8,0,8,2022,01-19,10:43
008 Halles Castellane,9,3,12,2022,01-19,10:43
009 Observatoire,6,2,8,2022,01-19,10:43
010 Rondelet,4,12,16,2022,01-19,10:43
011 Plan Cabanes,3,9,12,2022,01-19,10:43
012 Boutonnet,2,10,12,2022,01-19,10:43
013 Emile Combes,1,7,8,2022,01-19,10:43
014 Beaux-Arts,2,6,8,2022,01-19,10:43
015 Les Aubes,6,2,8,2022,01-19,10:43
016 Antigone centre,14,2,16,2022,01-19,10:43
017 M�diath�que Emile Zola,13,3,16,2022,01-19,10:43
018 Nombre d'Or,4,12,16,2022,01-19,10:43
019 Louis Blanc,7,9,16,2022,01-19,10:43
020 Gambetta,3,5,8,2022,01-19,10:43
021 Port Marianne,5,11,16,2022,01-19,10:43
022 Clemenceau,2,10,12,2022,01-19,10:43
023 Les Arceaux,4,12,16,2022,01-19,10:43
024 Cit� Mion,2,6,8,2022,01-19,10:43
025 Nouveau Saint-Roch,4,4,8,2022,01-19,10:43
026 Renouvier,4,4,8,2022,01-19,10:43
027 Odysseum,4,4,8,2022,01-19,10:43
028 Saint-Denis,4,4,8,2022,01-19,10:43
029 Richter,11,5,16,2022,01-19,10:43
030 Charles Flahault,5,3,8,2022,01-19,10:43
031 Voltaire,2,6,8,2022,01-19,10:43
032 Pr�s d'Ar�nes,7,1,8,2022,01-19,10:43
033 Garcia Lorca,7,1,8,2022,01-19,10:43
034 Vert Bois,0,16,16,2022,01-19,10:43
035 Malbosc,2,6,8,2022,01-19,10:43
036 Occitanie,4,28,32,2022,01-19,10:43
037 FacdesSciences,11,13,24,2022,01-19,10:43
038 Fac de Lettres,2,14,16,2022,01-19,10:43
039 Aiguelongue,2,6,8,2022,01-19,10:43
040 Jeu de Mail des Abb�s,8,0,8,2022,01-19,10:43
041 Eurom�decine,0,8,8,2022,01-19,10:43
042 Marie Caizergues,4,4,8,2022,01-19,10:43
043 Sabines,4,4,8,2022,01-19,10:43
044 Celleneuve,0,8,8,2022,01-19,10:43
045 Jardin de la Lironde,2,6,8,2022,01-19,10:43
046 P�re Soulas,2,6,8,2022,01-19,10:43
047 Place Viala,2,6,8,2022,01-19,10:43
048 H�tel du D�partement,0,8,8,2022,01-19,10:43
049 Tonnelles,5,3,8,2022,01-19,10:43
050 Parvis Jules Ferry - Gare Saint-Roch,0,8,8,2022,01-19,10:43
051 Pont de Lattes - Gare Saint-Roch,2,10,12,2022,01-19,10:43
053 Deux Ponts - Gare Saint-Roch,2,6,8,2022,01-19,10:43
054 Providence - Ovalie,3,5,8,2022,01-19,10:43
055 P�rols Etang de l'Or,23,45,68,2022,01-19,10:43
056 Albert 1er - Cath�drale,1,11,12,2022,01-19,10:43
057 Saint-Guilhem - Courreau,4,4,8,2022,01-19,10:43
059 Sud De France,0,8,8,2022,01-19,10:43
001 Rue Jules Ferry - Gare Saint-Roch,4,8,12,2022,01-19,10:53
002 Com�die,10,14,24,2022,01-19,10:53
003 Esplanade,17,15,32,2022,01-19,10:53
004 H�tel de Ville,8,8,16,2022,01-19,10:53
005 Corum,12,0,12,2022,01-19,10:53
006 Place Albert 1er - St Charles,23,8,31,2022,01-19,10:53
007 Foch,8,0,8,2022,01-19,10:53
008 Halles Castellane,9,3,12,2022,01-19,10:53
009 Observatoire,6,2,8,2022,01-19,10:53
010 Rondelet,4,12,16,2022,01-19,10:53
011 Plan Cabanes,3,9,12,2022,01-19,10:53
012 Boutonnet,2,10,12,2022,01-19,10:53
013 Emile Combes,1,7,8,2022,01-19,10:53
014 Beaux-Arts,2,6,8,2022,01-19,10:53
015 Les Aubes,6,2,8,2022,01-19,10:53
016 Antigone centre,14,2,16,2022,01-19,10:53
017 M�diath�que Emile Zola,13,3,16,2022,01-19,10:53
018 Nombre d'Or,4,12,16,2022,01-19,10:53
019 Louis Blanc,7,9,16,2022,01-19,10:53
020 Gambetta,3,5,8,2022,01-19,10:53
021 Port Marianne,5,11,16,2022,01-19,10:53
022 Clemenceau,1,11,12,2022,01-19,10:53
023 Les Arceaux,4,12,16,2022,01-19,10:53
024 Cit� Mion,2,6,8,2022,01-19,10:53
025 Nouveau Saint-Roch,4,4,8,2022,01-19,10:53
026 Renouvier,4,4,8,2022,01-19,10:53
027 Odysseum,4,4,8,2022,01-19,10:53
028 Saint-Denis,4,4,8,2022,01-19,10:53
029 Richter,11,5,16,2022,01-19,10:53
030 Charles Flahault,5,3,8,2022,01-19,10:53
031 Voltaire,2,6,8,2022,01-19,10:53
032 Pr�s d'Ar�nes,7,1,8,2022,01-19,10:53
033 Garcia Lorca,7,1,8,2022,01-19,10:53
034 Vert Bois,0,16,16,2022,01-19,10:53
035 Malbosc,2,6,8,2022,01-19,10:53
036 Occitanie,4,28,32,2022,01-19,10:53
037 FacdesSciences,11,13,24,2022,01-19,10:53
038 Fac de Lettres,3,13,16,2022,01-19,10:53
039 Aiguelongue,2,6,8,2022,01-19,10:53
040 Jeu de Mail des Abb�s,8,0,8,2022,01-19,10:53
041 Eurom�decine,0,8,8,2022,01-19,10:53
042 Marie Caizergues,4,4,8,2022,01-19,10:53
043 Sabines,4,4,8,2022,01-19,10:53
044 Celleneuve,0,8,8,2022,01-19,10:53
045 Jardin de la Lironde,2,6,8,2022,01-19,10:53
046 P�re Soulas,2,6,8,2022,01-19,10:53
047 Place Viala,2,6,8,2022,01-19,10:53
048 H�tel du D�partement,0,8,8,2022,01-19,10:53
049 Tonnelles,5,3,8,2022,01-19,10:53
050 Parvis Jules Ferry - Gare Saint-Roch,0,8,8,2022,01-19,10:53
051 Pont de Lattes - Gare Saint-Roch,2,10,12,2022,01-19,10:53
053 Deux Ponts - Gare Saint-Roch,2,6,8,2022,01-19,10:53
054 Providence - Ovalie,3,5,8,2022,01-19,10:53
055 P�rols Etang de l'Or,23,45,68,2022,01-19,10:53
056 Albert 1er - Cath�drale,1,11,12,2022,01-19,10:53
057 Saint-Guilhem - Courreau,4,4,8,2022,01-19,10:53
059 Sud De France,0,8,8,2022,01-19,10:53
001 Rue Jules Ferry - Gare Saint-Roch,4,8,12,2022,01-19,11:03
002 Com�die,10,14,24,2022,01-19,11:03
003 Esplanade,17,15,32,2022,01-19,11:03
004 H�tel de Ville,8,8,16,2022,01-19,11:03
005 Corum,12,0,12,2022,01-19,11:03
006 Place Albert 1er - St Charles,23,8,31,2022,01-19,11:03
007 Foch,8,0,8,2022,01-19,11:03
008 Halles Castellane,9,3,12,2022,01-19,11:03
009 Observatoire,6,2,8,2022,01-19,11:03
010 Rondelet,4,12,16,2022,01-19,11:03
011 Plan Cabanes,4,8,12,2022,01-19,11:03
012 Boutonnet,2,10,12,2022,01-19,11:03
013 Emile Combes,1,7,8,2022,01-19,11:03
014 Beaux-Arts,2,6,8,2022,01-19,11:03
015 Les Aubes,6,2,8,2022,01-19,11:03
016 Antigone centre,14,2,16,2022,01-19,11:03
017 M�diath�que Emile Zola,13,3,16,2022,01-19,11:03
018 Nombre d'Or,4,12,16,2022,01-19,11:03
019 Louis Blanc,7,9,16,2022,01-19,11:03
020 Gambetta,3,5,8,2022,01-19,11:03
021 Port Marianne,5,11,16,2022,01-19,11:03
022 Clemenceau,1,11,12,2022,01-19,11:03
023 Les Arceaux,3,13,16,2022,01-19,11:03
024 Cit� Mion,2,6,8,2022,01-19,11:03
025 Nouveau Saint-Roch,4,4,8,2022,01-19,11:03
026 Renouvier,4,4,8,2022,01-19,11:03
027 Odysseum,4,4,8,2022,01-19,11:03
028 Saint-Denis,4,4,8,2022,01-19,11:03
029 Richter,11,5,16,2022,01-19,11:03
030 Charles Flahault,5,3,8,2022,01-19,11:03
031 Voltaire,2,6,8,2022,01-19,11:03
032 Pr�s d'Ar�nes,8,0,8,2022,01-19,11:03
033 Garcia Lorca,5,3,8,2022,01-19,11:03
034 Vert Bois,0,16,16,2022,01-19,11:03
035 Malbosc,2,6,8,2022,01-19,11:03
036 Occitanie,4,28,32,2022,01-19,11:03
037 FacdesSciences,11,13,24,2022,01-19,11:03
038 Fac de Lettres,7,9,16,2022,01-19,11:03
039 Aiguelongue,2,6,8,2022,01-19,11:03
040 Jeu de Mail des Abb�s,8,0,8,2022,01-19,11:03
041 Eurom�decine,0,8,8,2022,01-19,11:03
042 Marie Caizergues,4,4,8,2022,01-19,11:03
043 Sabines,4,4,8,2022,01-19,11:03
044 Celleneuve,0,8,8,2022,01-19,11:03
045 Jardin de la Lironde,2,6,8,2022,01-19,11:03
046 P�re Soulas,2,6,8,2022,01-19,11:03
047 Place Viala,1,7,8,2022,01-19,11:03
048 H�tel du D�partement,0,8,8,2022,01-19,11:03
049 Tonnelles,5,3,8,2022,01-19,11:03
050 Parvis Jules Ferry - Gare Saint-Roch,0,8,8,2022,01-19,11:03
051 Pont de Lattes - Gare Saint-Roch,2,10,12,2022,01-19,11:03
053 Deux Ponts - Gare Saint-Roch,2,6,8,2022,01-19,11:03
054 Providence - Ovalie,3,5,8,2022,01-19,11:03
055 P�rols Etang de l'Or,23,45,68,2022,01-19,11:03
056 Albert 1er - Cath�drale,1,11,12,2022,01-19,11:03
057 Saint-Guilhem - Courreau,4,4,8,2022,01-19,11:03
059 Sud De France,0,8,8,2022,01-19,11:03
001 Rue Jules Ferry - Gare Saint-Roch,4,8,12,2022,01-19,11:13
002 Com�die,10,14,24,2022,01-19,11:13
003 Esplanade,17,15,32,2022,01-19,11:13
004 H�tel de Ville,8,8,16,2022,01-19,11:13
005 Corum,12,0,12,2022,01-19,11:13
006 Place Albert 1er - St Charles,22,9,31,2022,01-19,11:13
007 Foch,8,0,8,2022,01-19,11:13
008 Halles Castellane,9,3,12,2022,01-19,11:13
009 Observatoire,6,2,8,2022,01-19,11:13
010 Rondelet,4,12,16,2022,01-19,11:13
011 Plan Cabanes,4,8,12,2022,01-19,11:13
012 Boutonnet,2,10,12,2022,01-19,11:13
013 Emile Combes,1,7,8,2022,01-19,11:13
014 Beaux-Arts,2,6,8,2022,01-19,11:13
015 Les Aubes,6,2,8,2022,01-19,11:13
016 Antigone centre,14,2,16,2022,01-19,11:13
017 M�diath�que Emile Zola,13,3,16,2022,01-19,11:13
018 Nombre d'Or,4,12,16,2022,01-19,11:13
019 Louis Blanc,7,9,16,2022,01-19,11:13
020 Gambetta,3,5,8,2022,01-19,11:13
021 Port Marianne,5,11,16,2022,01-19,11:13
022 Clemenceau,1,11,12,2022,01-19,11:13
023 Les Arceaux,2,14,16,2022,01-19,11:13
024 Cit� Mion,2,6,8,2022,01-19,11:13
025 Nouveau Saint-Roch,4,4,8,2022,01-19,11:13
026 Renouvier,4,4,8,2022,01-19,11:13
027 Odysseum,4,4,8,2022,01-19,11:13
028 Saint-Denis,4,4,8,2022,01-19,11:13
029 Richter,11,5,16,2022,01-19,11:13
030 Charles Flahault,5,3,8,2022,01-19,11:13
031 Voltaire,2,6,8,2022,01-19,11:13
032 Pr�s d'Ar�nes,8,0,8,2022,01-19,11:13
033 Garcia Lorca,5,3,8,2022,01-19,11:13
034 Vert Bois,0,16,16,2022,01-19,11:13
035 Malbosc,2,6,8,2022,01-19,11:13
036 Occitanie,2,30,32,2022,01-19,11:13
037 FacdesSciences,12,12,24,2022,01-19,11:13
038 Fac de Lettres,7,9,16,2022,01-19,11:13
039 Aiguelongue,2,6,8,2022,01-19,11:13
040 Jeu de Mail des Abb�s,8,0,8,2022,01-19,11:13
041 Eurom�decine,0,8,8,2022,01-19,11:13
042 Marie Caizergues,4,4,8,2022,01-19,11:13
043 Sabines,4,4,8,2022,01-19,11:13
044 Celleneuve,0,8,8,2022,01-19,11:13
045 Jardin de la Lironde,2,6,8,2022,01-19,11:13
046 P�re Soulas,2,6,8,2022,01-19,11:13
047 Place Viala,1,7,8,2022,01-19,11:13
048 H�tel du D�partement,0,8,8,2022,01-19,11:13
049 Tonnelles,5,3,8,2022,01-19,11:13
050 Parvis Jules Ferry - Gare Saint-Roch,0,8,8,2022,01-19,11:13
051 Pont de Lattes - Gare Saint-Roch,2,10,12,2022,01-19,11:13
053 Deux Ponts - Gare Saint-Roch,2,6,8,2022,01-19,11:13
054 Providence - Ovalie,3,5,8,2022,01-19,11:13
055 P�rols Etang de l'Or,21,47,68,2022,01-19,11:13
056 Albert 1er - Cath�drale,1,11,12,2022,01-19,11:13
057 Saint-Guilhem - Courreau,4,4,8,2022,01-19,11:13
059 Sud De France,0,8,8,2022,01-19,11:13
001 Rue Jules Ferry - Gare Saint-Roch,5,7,12,2022,01-19,11:23
002 Com�die,10,14,24,2022,01-19,11:23
003 Esplanade,17,15,32,2022,01-19,11:23
004 H�tel de Ville,7,9,16,2022,01-19,11:23
005 Corum,12,0,12,2022,01-19,11:23
006 Place Albert 1er - St Charles,21,10,31,2022,01-19,11:23
007 Foch,8,0,8,2022,01-19,11:23
008 Halles Castellane,9,3,12,2022,01-19,11:23
009 Observatoire,6,2,8,2022,01-19,11:23
010 Rondelet,4,12,16,2022,01-19,11:23
011 Plan Cabanes,4,8,12,2022,01-19,11:23
012 Boutonnet,2,10,12,2022,01-19,11:23
013 Emile Combes,1,7,8,2022,01-19,11:23
014 Beaux-Arts,3,5,8,2022,01-19,11:23
015 Les Aubes,6,2,8,2022,01-19,11:23
016 Antigone centre,15,1,16,2022,01-19,11:23
017 M�diath�que Emile Zola,13,3,16,2022,01-19,11:23
018 Nombre d'Or,4,12,16,2022,01-19,11:23
019 Louis Blanc,7,9,16,2022,01-19,11:23
020 Gambetta,3,5,8,2022,01-19,11:23
021 Port Marianne,5,11,16,2022,01-19,11:23
022 Clemenceau,1,11,12,2022,01-19,11:23
023 Les Arceaux,2,14,16,2022,01-19,11:23
024 Cit� Mion,2,6,8,2022,01-19,11:23
025 Nouveau Saint-Roch,4,4,8,2022,01-19,11:23
026 Renouvier,4,4,8,2022,01-19,11:23
027 Odysseum,4,4,8,2022,01-19,11:23
028 Saint-Denis,3,5,8,2022,01-19,11:23
029 Richter,11,5,16,2022,01-19,11:23
030 Charles Flahault,6,2,8,2022,01-19,11:23
031 Voltaire,2,6,8,2022,01-19,11:23
032 Pr�s d'Ar�nes,8,0,8,2022,01-19,11:23
033 Garcia Lorca,4,4,8,2022,01-19,11:23
034 Vert Bois,0,16,16,2022,01-19,11:23
035 Malbosc,2,6,8,2022,01-19,11:23
036 Occitanie,3,29,32,2022,01-19,11:23
037 FacdesSciences,12,12,24,2022,01-19,11:23
038 Fac de Lettres,7,9,16,2022,01-19,11:23
039 Aiguelongue,2,6,8,2022,01-19,11:23
040 Jeu de Mail des Abb�s,8,0,8,2022,01-19,11:23
041 Eurom�decine,0,8,8,2022,01-19,11:23
042 Marie Caizergues,4,4,8,2022,01-19,11:23
043 Sabines,4,4,8,2022,01-19,11:23
044 Celleneuve,0,8,8,2022,01-19,11:23
045 Jardin de la Lironde,2,6,8,2022,01-19,11:23
046 P�re Soulas,2,6,8,2022,01-19,11:23
047 Place Viala,1,7,8,2022,01-19,11:23
048 H�tel du D�partement,0,8,8,2022,01-19,11:23
049 Tonnelles,5,3,8,2022,01-19,11:23
050 Parvis Jules Ferry - Gare Saint-Roch,2,6,8,2022,01-19,11:23
051 Pont de Lattes - Gare Saint-Roch,2,10,12,2022,01-19,11:23
053 Deux Ponts - Gare Saint-Roch,2,6,8,2022,01-19,11:23
054 Providence - Ovalie,3,5,8,2022,01-19,11:23
055 P�rols Etang de l'Or,21,47,68,2022,01-19,11:23
056 Albert 1er - Cath�drale,1,11,12,2022,01-19,11:23
057 Saint-Guilhem - Courreau,4,4,8,2022,01-19,11:23
059 Sud De France,0,8,8,2022,01-19,11:23
001 Rue Jules Ferry - Gare Saint-Roch,5,7,12,2022,01-19,11:33
002 Com�die,10,14,24,2022,01-19,11:33
003 Esplanade,17,15,32,2022,01-19,11:33
004 H�tel de Ville,7,9,16,2022,01-19,11:33
005 Corum,12,0,12,2022,01-19,11:33
006 Place Albert 1er - St Charles,21,10,31,2022,01-19,11:33
007 Foch,7,1,8,2022,01-19,11:33
008 Halles Castellane,8,4,12,2022,01-19,11:33
009 Observatoire,6,2,8,2022,01-19,11:33
010 Rondelet,4,12,16,2022,01-19,11:33
011 Plan Cabanes,5,7,12,2022,01-19,11:33
012 Boutonnet,2,10,12,2022,01-19,11:33
013 Emile Combes,1,7,8,2022,01-19,11:33
014 Beaux-Arts,3,5,8,2022,01-19,11:33
015 Les Aubes,6,2,8,2022,01-19,11:33
016 Antigone centre,15,1,16,2022,01-19,11:33
017 M�diath�que Emile Zola,13,3,16,2022,01-19,11:33
018 Nombre d'Or,4,12,16,2022,01-19,11:33
019 Louis Blanc,8,8,16,2022,01-19,11:33
020 Gambetta,3,5,8,2022,01-19,11:33
021 Port Marianne,5,11,16,2022,01-19,11:33
022 Clemenceau,1,11,12,2022,01-19,11:33
023 Les Arceaux,2,14,16,2022,01-19,11:33
024 Cit� Mion,2,6,8,2022,01-19,11:33
025 Nouveau Saint-Roch,4,4,8,2022,01-19,11:33
026 Renouvier,4,4,8,2022,01-19,11:33
027 Odysseum,4,4,8,2022,01-19,11:33
028 Saint-Denis,3,5,8,2022,01-19,11:33
029 Richter,12,4,16,2022,01-19,11:33
030 Charles Flahault,6,2,8,2022,01-19,11:33
031 Voltaire,2,6,8,2022,01-19,11:33
032 Pr�s d'Ar�nes,8,0,8,2022,01-19,11:33
033 Garcia Lorca,4,4,8,2022,01-19,11:33
034 Vert Bois,0,16,16,2022,01-19,11:33
035 Malbosc,1,7,8,2022,01-19,11:33
036 Occitanie,3,29,32,2022,01-19,11:33
037 FacdesSciences,11,13,24,2022,01-19,11:33
038 Fac de Lettres,7,9,16,2022,01-19,11:33
039 Aiguelongue,2,6,8,2022,01-19,11:33
040 Jeu de Mail des Abb�s,5,3,8,2022,01-19,11:33
041 Eurom�decine,0,8,8,2022,01-19,11:33
042 Marie Caizergues,5,3,8,2022,01-19,11:33
043 Sabines,4,4,8,2022,01-19,11:33
044 Celleneuve,0,8,8,2022,01-19,11:33
045 Jardin de la Lironde,2,6,8,2022,01-19,11:33
046 P�re Soulas,3,5,8,2022,01-19,11:33
047 Place Viala,1,7,8,2022,01-19,11:33
048 H�tel du D�partement,0,8,8,2022,01-19,11:33
049 Tonnelles,5,3,8,2022,01-19,11:33
050 Parvis Jules Ferry - Gare Saint-Roch,2,6,8,2022,01-19,11:33
051 Pont de Lattes - Gare Saint-Roch,2,10,12,2022,01-19,11:33
053 Deux Ponts - Gare Saint-Roch,2,6,8,2022,01-19,11:33
054 Providence - Ovalie,3,5,8,2022,01-19,11:33
055 P�rols Etang de l'Or,21,47,68,2022,01-19,11:33
056 Albert 1er - Cath�drale,1,11,12,2022,01-19,11:33
057 Saint-Guilhem - Courreau,4,4,8,2022,01-19,11:33
059 Sud De France,0,8,8,2022,01-19,11:33
001 Rue Jules Ferry - Gare Saint-Roch,5,7,12,2022,01-19,11:44
002 Com�die,10,14,24,2022,01-19,11:44
003 Esplanade,17,15,32,2022,01-19,11:44
004 H�tel de Ville,7,9,16,2022,01-19,11:44
005 Corum,8,4,12,2022,01-19,11:44
006 Place Albert 1er - St Charles,21,10,31,2022,01-19,11:44
007 Foch,7,1,8,2022,01-19,11:44
008 Halles Castellane,8,4,12,2022,01-19,11:44
009 Observatoire,6,2,8,2022,01-19,11:44
010 Rondelet,4,12,16,2022,01-19,11:44
011 Plan Cabanes,5,7,12,2022,01-19,11:44
012 Boutonnet,1,11,12,2022,01-19,11:44
013 Emile Combes,1,7,8,2022,01-19,11:44
014 Beaux-Arts,3,5,8,2022,01-19,11:44
015 Les Aubes,6,2,8,2022,01-19,11:44
016 Antigone centre,15,1,16,2022,01-19,11:44
017 M�diath�que Emile Zola,13,3,16,2022,01-19,11:44
018 Nombre d'Or,4,12,16,2022,01-19,11:44
019 Louis Blanc,8,8,16,2022,01-19,11:44
020 Gambetta,3,5,8,2022,01-19,11:44
021 Port Marianne,5,11,16,2022,01-19,11:44
022 Clemenceau,1,11,12,2022,01-19,11:44
023 Les Arceaux,2,14,16,2022,01-19,11:44
024 Cit� Mion,2,6,8,2022,01-19,11:44
025 Nouveau Saint-Roch,4,4,8,2022,01-19,11:44
026 Renouvier,4,4,8,2022,01-19,11:44
027 Odysseum,4,4,8,2022,01-19,11:44
028 Saint-Denis,3,5,8,2022,01-19,11:44
029 Richter,12,4,16,2022,01-19,11:44
030 Charles Flahault,6,2,8,2022,01-19,11:44
031 Voltaire,2,6,8,2022,01-19,11:44
032 Pr�s d'Ar�nes,8,0,8,2022,01-19,11:44
033 Garcia Lorca,4,4,8,2022,01-19,11:44
034 Vert Bois,0,16,16,2022,01-19,11:44
035 Malbosc,1,7,8,2022,01-19,11:44
036 Occitanie,4,28,32,2022,01-19,11:44
037 FacdesSciences,10,14,24,2022,01-19,11:44
038 Fac de Lettres,7,9,16,2022,01-19,11:44
039 Aiguelongue,2,6,8,2022,01-19,11:44
040 Jeu de Mail des Abb�s,5,3,8,2022,01-19,11:44
041 Eurom�decine,0,8,8,2022,01-19,11:44
042 Marie Caizergues,5,3,8,2022,01-19,11:44
043 Sabines,4,4,8,2022,01-19,11:44
044 Celleneuve,0,8,8,2022,01-19,11:44
045 Jardin de la Lironde,2,6,8,2022,01-19,11:44
046 P�re Soulas,3,5,8,2022,01-19,11:44
047 Place Viala,1,7,8,2022,01-19,11:44
048 H�tel du D�partement,0,8,8,2022,01-19,11:44
049 Tonnelles,5,3,8,2022,01-19,11:44
050 Parvis Jules Ferry - Gare Saint-Roch,2,6,8,2022,01-19,11:44
051 Pont de Lattes - Gare Saint-Roch,2,10,12,2022,01-19,11:44
053 Deux Ponts - Gare Saint-Roch,2,6,8,2022,01-19,11:44
054 Providence - Ovalie,3,5,8,2022,01-19,11:44
055 P�rols Etang de l'Or,21,47,68,2022,01-19,11:44
056 Albert 1er - Cath�drale,1,11,12,2022,01-19,11:44
057 Saint-Guilhem - Courreau,4,4,8,2022,01-19,11:44
059 Sud De France,0,8,8,2022,01-19,11:44
001 Rue Jules Ferry - Gare Saint-Roch,5,7,12,2022,01-19,11:54
002 Com�die,9,15,24,2022,01-19,11:54
003 Esplanade,17,15,32,2022,01-19,11:54
004 H�tel de Ville,7,9,16,2022,01-19,11:54
005 Corum,8,4,12,2022,01-19,11:54
006 Place Albert 1er - St Charles,21,10,31,2022,01-19,11:54
007 Foch,7,1,8,2022,01-19,11:54
008 Halles Castellane,8,4,12,2022,01-19,11:54
009 Observatoire,6,2,8,2022,01-19,11:54
010 Rondelet,4,12,16,2022,01-19,11:54
011 Plan Cabanes,5,7,12,2022,01-19,11:54
012 Boutonnet,1,11,12,2022,01-19,11:54
013 Emile Combes,1,7,8,2022,01-19,11:54
014 Beaux-Arts,3,5,8,2022,01-19,11:54
015 Les Aubes,6,2,8,2022,01-19,11:54
016 Antigone centre,15,1,16,2022,01-19,11:54
017 M�diath�que Emile Zola,13,3,16,2022,01-19,11:54
018 Nombre d'Or,4,12,16,2022,01-19,11:54
019 Louis Blanc,9,7,16,2022,01-19,11:54
020 Gambetta,3,5,8,2022,01-19,11:54
021 Port Marianne,5,11,16,2022,01-19,11:54
022 Clemenceau,1,11,12,2022,01-19,11:54
023 Les Arceaux,1,15,16,2022,01-19,11:54
024 Cit� Mion,1,7,8,2022,01-19,11:54
025 Nouveau Saint-Roch,5,3,8,2022,01-19,11:54
026 Renouvier,4,4,8,2022,01-19,11:54
027 Odysseum,4,4,8,2022,01-19,11:54
028 Saint-Denis,3,5,8,2022,01-19,11:54
029 Richter,13,3,16,2022,01-19,11:54
030 Charles Flahault,6,2,8,2022,01-19,11:54
031 Voltaire,2,6,8,2022,01-19,11:54
032 Pr�s d'Ar�nes,8,0,8,2022,01-19,11:54
033 Garcia Lorca,4,4,8,2022,01-19,11:54
034 Vert Bois,0,16,16,2022,01-19,11:54
035 Malbosc,1,7,8,2022,01-19,11:54
036 Occitanie,4,28,32,2022,01-19,11:54
037 FacdesSciences,10,14,24,2022,01-19,11:54
038 Fac de Lettres,5,11,16,2022,01-19,11:54
039 Aiguelongue,2,6,8,2022,01-19,11:54
040 Jeu de Mail des Abb�s,5,3,8,2022,01-19,11:54
041 Eurom�decine,0,8,8,2022,01-19,11:54
042 Marie Caizergues,5,3,8,2022,01-19,11:54
043 Sabines,4,4,8,2022,01-19,11:54
044 Celleneuve,0,8,8,2022,01-19,11:54
045 Jardin de la Lironde,2,6,8,2022,01-19,11:54
046 P�re Soulas,3,5,8,2022,01-19,11:54
047 Place Viala,2,6,8,2022,01-19,11:54
048 H�tel du D�partement,0,8,8,2022,01-19,11:54
049 Tonnelles,5,3,8,2022,01-19,11:54
050 Parvis Jules Ferry - Gare Saint-Roch,2,6,8,2022,01-19,11:54
051 Pont de Lattes - Gare Saint-Roch,2,10,12,2022,01-19,11:54
053 Deux Ponts - Gare Saint-Roch,1,7,8,2022,01-19,11:54
054 Providence - Ovalie,3,5,8,2022,01-19,11:54
055 P�rols Etang de l'Or,21,47,68,2022,01-19,11:54
056 Albert 1er - Cath�drale,1,11,12,2022,01-19,11:54
057 Saint-Guilhem - Courreau,4,4,8,2022,01-19,11:54
059 Sud De France,0,8,8,2022,01-19,11:54
001 Rue Jules Ferry - Gare Saint-Roch,5,7,12,2022,01-19,12:04
002 Com�die,10,14,24,2022,01-19,12:04
003 Esplanade,17,15,32,2022,01-19,12:04
004 H�tel de Ville,7,9,16,2022,01-19,12:04
005 Corum,8,4,12,2022,01-19,12:04
006 Place Albert 1er - St Charles,21,10,31,2022,01-19,12:04
007 Foch,7,1,8,2022,01-19,12:04
008 Halles Castellane,8,4,12,2022,01-19,12:04
009 Observatoire,6,2,8,2022,01-19,12:04
010 Rondelet,4,12,16,2022,01-19,12:04
011 Plan Cabanes,5,7,12,2022,01-19,12:04
012 Boutonnet,2,10,12,2022,01-19,12:04
013 Emile Combes,1,7,8,2022,01-19,12:04
014 Beaux-Arts,3,5,8,2022,01-19,12:04
015 Les Aubes,6,2,8,2022,01-19,12:04
016 Antigone centre,15,1,16,2022,01-19,12:04
017 M�diath�que Emile Zola,13,3,16,2022,01-19,12:04
018 Nombre d'Or,4,12,16,2022,01-19,12:04
019 Louis Blanc,9,7,16,2022,01-19,12:04
020 Gambetta,3,5,8,2022,01-19,12:04
021 Port Marianne,5,11,16,2022,01-19,12:04
022 Clemenceau,1,11,12,2022,01-19,12:04
023 Les Arceaux,1,15,16,2022,01-19,12:04
024 Cit� Mion,1,7,8,2022,01-19,12:04
025 Nouveau Saint-Roch,5,3,8,2022,01-19,12:04
026 Renouvier,4,4,8,2022,01-19,12:04
027 Odysseum,4,4,8,2022,01-19,12:04
028 Saint-Denis,3,5,8,2022,01-19,12:04
029 Richter,13,3,16,2022,01-19,12:04
030 Charles Flahault,6,2,8,2022,01-19,12:04
031 Voltaire,2,6,8,2022,01-19,12:04
032 Pr�s d'Ar�nes,8,0,8,2022,01-19,12:04
033 Garcia Lorca,4,4,8,2022,01-19,12:04
034 Vert Bois,0,16,16,2022,01-19,12:04
035 Malbosc,1,7,8,2022,01-19,12:04
036 Occitanie,4,28,32,2022,01-19,12:04
037 FacdesSciences,11,13,24,2022,01-19,12:04
038 Fac de Lettres,3,13,16,2022,01-19,12:04
039 Aiguelongue,2,6,8,2022,01-19,12:04
040 Jeu de Mail des Abb�s,5,3,8,2022,01-19,12:04
041 Eurom�decine,0,8,8,2022,01-19,12:04
042 Marie Caizergues,5,3,8,2022,01-19,12:04
043 Sabines,4,4,8,2022,01-19,12:04
044 Celleneuve,0,8,8,2022,01-19,12:04
045 Jardin de la Lironde,2,6,8,2022,01-19,12:04
046 P�re Soulas,3,5,8,2022,01-19,12:04
047 Place Viala,2,6,8,2022,01-19,12:04
048 H�tel du D�partement,0,8,8,2022,01-19,12:04
049 Tonnelles,5,3,8,2022,01-19,12:04
050 Parvis Jules Ferry - Gare Saint-Roch,2,6,8,2022,01-19,12:04
051 Pont de Lattes - Gare Saint-Roch,2,10,12,2022,01-19,12:04
053 Deux Ponts - Gare Saint-Roch,1,7,8,2022,01-19,12:04
054 Providence - Ovalie,3,5,8,2022,01-19,12:04
055 P�rols Etang de l'Or,21,47,68,2022,01-19,12:04
056 Albert 1er - Cath�drale,7,5,12,2022,01-19,12:04
057 Saint-Guilhem - Courreau,4,4,8,2022,01-19,12:04
059 Sud De France,0,8,8,2022,01-19,12:04
001 Rue Jules Ferry - Gare Saint-Roch,5,7,12,2022,01-19,12:14
002 Com�die,10,14,24,2022,01-19,12:14
003 Esplanade,17,15,32,2022,01-19,12:14
004 H�tel de Ville,7,9,16,2022,01-19,12:14
005 Corum,8,4,12,2022,01-19,12:14
006 Place Albert 1er - St Charles,21,10,31,2022,01-19,12:14
007 Foch,7,1,8,2022,01-19,12:14
008 Halles Castellane,8,4,12,2022,01-19,12:14
009 Observatoire,6,2,8,2022,01-19,12:14
010 Rondelet,4,12,16,2022,01-19,12:14
011 Plan Cabanes,5,7,12,2022,01-19,12:14
012 Boutonnet,4,8,12,2022,01-19,12:14
013 Emile Combes,1,7,8,2022,01-19,12:14
014 Beaux-Arts,3,5,8,2022,01-19,12:14
015 Les Aubes,6,2,8,2022,01-19,12:14
016 Antigone centre,15,1,16,2022,01-19,12:14
017 M�diath�que Emile Zola,12,4,16,2022,01-19,12:14
018 Nombre d'Or,4,12,16,2022,01-19,12:14
019 Louis Blanc,9,7,16,2022,01-19,12:14
020 Gambetta,3,5,8,2022,01-19,12:14
021 Port Marianne,5,11,16,2022,01-19,12:14
022 Clemenceau,1,11,12,2022,01-19,12:14
023 Les Arceaux,1,15,16,2022,01-19,12:14
024 Cit� Mion,1,7,8,2022,01-19,12:14
025 Nouveau Saint-Roch,5,3,8,2022,01-19,12:14
026 Renouvier,4,4,8,2022,01-19,12:14
027 Odysseum,4,4,8,2022,01-19,12:14
028 Saint-Denis,3,5,8,2022,01-19,12:14
029 Richter,12,4,16,2022,01-19,12:14
030 Charles Flahault,3,5,8,2022,01-19,12:14
031 Voltaire,2,6,8,2022,01-19,12:14
032 Pr�s d'Ar�nes,8,0,8,2022,01-19,12:14
033 Garcia Lorca,4,4,8,2022,01-19,12:14
034 Vert Bois,0,16,16,2022,01-19,12:14
035 Malbosc,1,7,8,2022,01-19,12:14
036 Occitanie,4,28,32,2022,01-19,12:14
037 FacdesSciences,12,12,24,2022,01-19,12:14
038 Fac de Lettres,3,13,16,2022,01-19,12:14
039 Aiguelongue,2,6,8,2022,01-19,12:14
040 Jeu de Mail des Abb�s,5,3,8,2022,01-19,12:14
041 Eurom�decine,0,8,8,2022,01-19,12:14
042 Marie Caizergues,4,4,8,2022,01-19,12:14
043 Sabines,4,4,8,2022,01-19,12:14
044 Celleneuve,0,8,8,2022,01-19,12:14
045 Jardin de la Lironde,2,6,8,2022,01-19,12:14
046 P�re Soulas,3,5,8,2022,01-19,12:14
047 Place Viala,2,6,8,2022,01-19,12:14
048 H�tel du D�partement,0,8,8,2022,01-19,12:14
049 Tonnelles,5,3,8,2022,01-19,12:14
050 Parvis Jules Ferry - Gare Saint-Roch,1,7,8,2022,01-19,12:14
051 Pont de Lattes - Gare Saint-Roch,2,10,12,2022,01-19,12:14
053 Deux Ponts - Gare Saint-Roch,1,7,8,2022,01-19,12:14
054 Providence - Ovalie,3,5,8,2022,01-19,12:14
055 P�rols Etang de l'Or,21,47,68,2022,01-19,12:14
056 Albert 1er - Cath�drale,7,5,12,2022,01-19,12:14
057 Saint-Guilhem - Courreau,4,4,8,2022,01-19,12:14
059 Sud De France,0,8,8,2022,01-19,12:14
001 Rue Jules Ferry - Gare Saint-Roch,6,6,12,2022,01-19,12:24
002 Com�die,12,12,24,2022,01-19,12:24
003 Esplanade,16,16,32,2022,01-19,12:24
004 H�tel de Ville,7,9,16,2022,01-19,12:24
005 Corum,8,4,12,2022,01-19,12:24
006 Place Albert 1er - St Charles,21,10,31,2022,01-19,12:24
007 Foch,8,0,8,2022,01-19,12:24
008 Halles Castellane,8,4,12,2022,01-19,12:24
009 Observatoire,7,1,8,2022,01-19,12:24
010 Rondelet,4,12,16,2022,01-19,12:24
011 Plan Cabanes,5,7,12,2022,01-19,12:24
012 Boutonnet,4,8,12,2022,01-19,12:24
013 Emile Combes,1,7,8,2022,01-19,12:24
014 Beaux-Arts,3,5,8,2022,01-19,12:24
015 Les Aubes,6,2,8,2022,01-19,12:24
016 Antigone centre,14,2,16,2022,01-19,12:24
017 M�diath�que Emile Zola,13,3,16,2022,01-19,12:24
018 Nombre d'Or,4,12,16,2022,01-19,12:24
019 Louis Blanc,10,6,16,2022,01-19,12:24
020 Gambetta,3,5,8,2022,01-19,12:24
021 Port Marianne,5,11,16,2022,01-19,12:24
022 Clemenceau,1,11,12,2022,01-19,12:24
023 Les Arceaux,1,15,16,2022,01-19,12:24
024 Cit� Mion,1,7,8,2022,01-19,12:24
025 Nouveau Saint-Roch,5,3,8,2022,01-19,12:24
026 Renouvier,4,4,8,2022,01-19,12:24
027 Odysseum,4,4,8,2022,01-19,12:24
028 Saint-Denis,3,5,8,2022,01-19,12:24
029 Richter,12,4,16,2022,01-19,12:24
030 Charles Flahault,3,5,8,2022,01-19,12:24
031 Voltaire,2,6,8,2022,01-19,12:24
032 Pr�s d'Ar�nes,8,0,8,2022,01-19,12:24
033 Garcia Lorca,4,4,8,2022,01-19,12:24
034 Vert Bois,0,16,16,2022,01-19,12:24
035 Malbosc,1,7,8,2022,01-19,12:24
036 Occitanie,3,29,32,2022,01-19,12:24
037 FacdesSciences,11,13,24,2022,01-19,12:24
038 Fac de Lettres,3,13,16,2022,01-19,12:24
039 Aiguelongue,2,6,8,2022,01-19,12:24
040 Jeu de Mail des Abb�s,5,3,8,2022,01-19,12:24
041 Eurom�decine,0,8,8,2022,01-19,12:24
042 Marie Caizergues,3,5,8,2022,01-19,12:24
043 Sabines,4,4,8,2022,01-19,12:24
044 Celleneuve,0,8,8,2022,01-19,12:24
045 Jardin de la Lironde,1,7,8,2022,01-19,12:24
046 P�re Soulas,3,5,8,2022,01-19,12:24
047 Place Viala,2,6,8,2022,01-19,12:24
048 H�tel du D�partement,0,8,8,2022,01-19,12:24
049 Tonnelles,5,3,8,2022,01-19,12:24
050 Parvis Jules Ferry - Gare Saint-Roch,1,7,8,2022,01-19,12:24
051 Pont de Lattes - Gare Saint-Roch,2,10,12,2022,01-19,12:24
053 Deux Ponts - Gare Saint-Roch,1,7,8,2022,01-19,12:24
054 Providence - Ovalie,3,5,8,2022,01-19,12:24
055 P�rols Etang de l'Or,21,47,68,2022,01-19,12:24
056 Albert 1er - Cath�drale,7,5,12,2022,01-19,12:24
057 Saint-Guilhem - Courreau,3,5,8,2022,01-19,12:24
059 Sud De France,0,8,8,2022,01-19,12:24
001 Rue Jules Ferry - Gare Saint-Roch,6,6,12,2022,01-19,12:34
002 Com�die,12,12,24,2022,01-19,12:34
003 Esplanade,16,16,32,2022,01-19,12:34
004 H�tel de Ville,7,9,16,2022,01-19,12:34
005 Corum,8,4,12,2022,01-19,12:34
006 Place Albert 1er - St Charles,21,10,31,2022,01-19,12:34
007 Foch,8,0,8,2022,01-19,12:34
008 Halles Castellane,7,5,12,2022,01-19,12:34
009 Observatoire,7,1,8,2022,01-19,12:34
010 Rondelet,4,12,16,2022,01-19,12:34
011 Plan Cabanes,7,5,12,2022,01-19,12:34
012 Boutonnet,4,8,12,2022,01-19,12:34
013 Emile Combes,1,7,8,2022,01-19,12:34
014 Beaux-Arts,3,5,8,2022,01-19,12:34
015 Les Aubes,6,2,8,2022,01-19,12:34
016 Antigone centre,14,2,16,2022,01-19,12:34
017 M�diath�que Emile Zola,13,3,16,2022,01-19,12:34
018 Nombre d'Or,4,12,16,2022,01-19,12:34
019 Louis Blanc,11,5,16,2022,01-19,12:34
020 Gambetta,3,5,8,2022,01-19,12:34
021 Port Marianne,5,11,16,2022,01-19,12:34
022 Clemenceau,1,11,12,2022,01-19,12:34
023 Les Arceaux,1,15,16,2022,01-19,12:34
024 Cit� Mion,1,7,8,2022,01-19,12:34
025 Nouveau Saint-Roch,5,3,8,2022,01-19,12:34
026 Renouvier,3,5,8,2022,01-19,12:34
027 Odysseum,4,4,8,2022,01-19,12:34
028 Saint-Denis,3,5,8,2022,01-19,12:34
029 Richter,12,4,16,2022,01-19,12:34
030 Charles Flahault,3,5,8,2022,01-19,12:34
031 Voltaire,2,6,8,2022,01-19,12:34
032 Pr�s d'Ar�nes,8,0,8,2022,01-19,12:34
033 Garcia Lorca,5,3,8,2022,01-19,12:34
034 Vert Bois,0,16,16,2022,01-19,12:34
035 Malbosc,1,7,8,2022,01-19,12:34
036 Occitanie,3,29,32,2022,01-19,12:34
037 FacdesSciences,11,13,24,2022,01-19,12:34
038 Fac de Lettres,3,13,16,2022,01-19,12:34
039 Aiguelongue,2,6,8,2022,01-19,12:34
040 Jeu de Mail des Abb�s,5,3,8,2022,01-19,12:34
041 Eurom�decine,0,8,8,2022,01-19,12:34
042 Marie Caizergues,3,5,8,2022,01-19,12:34
043 Sabines,4,4,8,2022,01-19,12:34
044 Celleneuve,0,8,8,2022,01-19,12:34
045 Jardin de la Lironde,1,7,8,2022,01-19,12:34
046 P�re Soulas,3,5,8,2022,01-19,12:34
047 Place Viala,2,6,8,2022,01-19,12:34
048 H�tel du D�partement,0,8,8,2022,01-19,12:34
049 Tonnelles,5,3,8,2022,01-19,12:34
050 Parvis Jules Ferry - Gare Saint-Roch,1,7,8,2022,01-19,12:34
051 Pont de Lattes - Gare Saint-Roch,2,10,12,2022,01-19,12:34
053 Deux Ponts - Gare Saint-Roch,1,7,8,2022,01-19,12:34
054 Providence - Ovalie,3,5,8,2022,01-19,12:34
055 P�rols Etang de l'Or,21,47,68,2022,01-19,12:34
056 Albert 1er - Cath�drale,7,5,12,2022,01-19,12:34
057 Saint-Guilhem - Courreau,2,6,8,2022,01-19,12:34
059 Sud De France,0,8,8,2022,01-19,12:34
001 Rue Jules Ferry - Gare Saint-Roch,7,5,12,2022,01-19,12:45
002 Com�die,12,12,24,2022,01-19,12:45
003 Esplanade,17,15,32,2022,01-19,12:45
004 H�tel de Ville,7,9,16,2022,01-19,12:45
005 Corum,8,4,12,2022,01-19,12:45
006 Place Albert 1er - St Charles,21,10,31,2022,01-19,12:45
007 Foch,8,0,8,2022,01-19,12:45
008 Halles Castellane,7,5,12,2022,01-19,12:45
009 Observatoire,7,1,8,2022,01-19,12:45
010 Rondelet,4,12,16,2022,01-19,12:45
011 Plan Cabanes,7,5,12,2022,01-19,12:45
012 Boutonnet,5,7,12,2022,01-19,12:45
013 Emile Combes,1,7,8,2022,01-19,12:45
014 Beaux-Arts,3,5,8,2022,01-19,12:45
015 Les Aubes,6,2,8,2022,01-19,12:45
016 Antigone centre,14,2,16,2022,01-19,12:45
017 M�diath�que Emile Zola,13,3,16,2022,01-19,12:45
018 Nombre d'Or,4,12,16,2022,01-19,12:45
019 Louis Blanc,11,5,16,2022,01-19,12:45
020 Gambetta,3,5,8,2022,01-19,12:45
021 Port Marianne,4,12,16,2022,01-19,12:45
022 Clemenceau,1,11,12,2022,01-19,12:45
023 Les Arceaux,1,15,16,2022,01-19,12:45
024 Cit� Mion,1,7,8,2022,01-19,12:45
025 Nouveau Saint-Roch,4,4,8,2022,01-19,12:45
026 Renouvier,3,5,8,2022,01-19,12:45
027 Odysseum,4,4,8,2022,01-19,12:45
028 Saint-Denis,4,4,8,2022,01-19,12:45
029 Richter,12,4,16,2022,01-19,12:45
030 Charles Flahault,3,5,8,2022,01-19,12:45
031 Voltaire,1,7,8,2022,01-19,12:45
032 Pr�s d'Ar�nes,8,0,8,2022,01-19,12:45
033 Garcia Lorca,5,3,8,2022,01-19,12:45
034 Vert Bois,0,16,16,2022,01-19,12:45
035 Malbosc,1,7,8,2022,01-19,12:45
036 Occitanie,4,28,32,2022,01-19,12:45
037 FacdesSciences,11,13,24,2022,01-19,12:45
038 Fac de Lettres,3,13,16,2022,01-19,12:45
039 Aiguelongue,2,6,8,2022,01-19,12:45
040 Jeu de Mail des Abb�s,5,3,8,2022,01-19,12:45
041 Eurom�decine,0,8,8,2022,01-19,12:45
042 Marie Caizergues,3,5,8,2022,01-19,12:45
043 Sabines,4,4,8,2022,01-19,12:45
044 Celleneuve,0,8,8,2022,01-19,12:45
045 Jardin de la Lironde,1,7,8,2022,01-19,12:45
046 P�re Soulas,3,5,8,2022,01-19,12:45
047 Place Viala,1,7,8,2022,01-19,12:45
048 H�tel du D�partement,0,8,8,2022,01-19,12:45
049 Tonnelles,5,3,8,2022,01-19,12:45
050 Parvis Jules Ferry - Gare Saint-Roch,2,6,8,2022,01-19,12:45
051 Pont de Lattes - Gare Saint-Roch,2,10,12,2022,01-19,12:45
053 Deux Ponts - Gare Saint-Roch,1,7,8,2022,01-19,12:45
054 Providence - Ovalie,3,5,8,2022,01-19,12:45
055 P�rols Etang de l'Or,21,47,68,2022,01-19,12:45
056 Albert 1er - Cath�drale,7,5,12,2022,01-19,12:45
057 Saint-Guilhem - Courreau,2,6,8,2022,01-19,12:45
059 Sud De France,0,8,8,2022,01-19,12:45
001 Rue Jules Ferry - Gare Saint-Roch,7,5,12,2022,01-19,12:55
002 Com�die,12,12,24,2022,01-19,12:55
003 Esplanade,17,15,32,2022,01-19,12:55
004 H�tel de Ville,7,9,16,2022,01-19,12:55
005 Corum,8,4,12,2022,01-19,12:55
006 Place Albert 1er - St Charles,21,10,31,2022,01-19,12:55
007 Foch,8,0,8,2022,01-19,12:55
008 Halles Castellane,7,5,12,2022,01-19,12:55
009 Observatoire,7,1,8,2022,01-19,12:55
010 Rondelet,4,12,16,2022,01-19,12:55
011 Plan Cabanes,7,5,12,2022,01-19,12:55
012 Boutonnet,5,7,12,2022,01-19,12:55
013 Emile Combes,1,7,8,2022,01-19,12:55
014 Beaux-Arts,3,5,8,2022,01-19,12:55
015 Les Aubes,6,2,8,2022,01-19,12:55
016 Antigone centre,14,2,16,2022,01-19,12:55
017 M�diath�que Emile Zola,13,3,16,2022,01-19,12:55
018 Nombre d'Or,3,13,16,2022,01-19,12:55
019 Louis Blanc,11,5,16,2022,01-19,12:55
020 Gambetta,3,5,8,2022,01-19,12:55
021 Port Marianne,4,12,16,2022,01-19,12:55
022 Clemenceau,1,11,12,2022,01-19,12:55
023 Les Arceaux,1,15,16,2022,01-19,12:55
024 Cit� Mion,1,7,8,2022,01-19,12:55
025 Nouveau Saint-Roch,3,5,8,2022,01-19,12:55
026 Renouvier,3,5,8,2022,01-19,12:55
027 Odysseum,4,4,8,2022,01-19,12:55
028 Saint-Denis,5,3,8,2022,01-19,12:55
029 Richter,12,4,16,2022,01-19,12:55
030 Charles Flahault,3,5,8,2022,01-19,12:55
031 Voltaire,1,7,8,2022,01-19,12:55
032 Pr�s d'Ar�nes,8,0,8,2022,01-19,12:55
033 Garcia Lorca,5,3,8,2022,01-19,12:55
034 Vert Bois,0,16,16,2022,01-19,12:55
035 Malbosc,1,7,8,2022,01-19,12:55
036 Occitanie,5,27,32,2022,01-19,12:55
037 FacdesSciences,12,12,24,2022,01-19,12:55
038 Fac de Lettres,2,14,16,2022,01-19,12:55
039 Aiguelongue,2,6,8,2022,01-19,12:55
040 Jeu de Mail des Abb�s,5,3,8,2022,01-19,12:55
041 Eurom�decine,0,8,8,2022,01-19,12:55
042 Marie Caizergues,3,5,8,2022,01-19,12:55
043 Sabines,4,4,8,2022,01-19,12:55
044 Celleneuve,0,8,8,2022,01-19,12:55
045 Jardin de la Lironde,1,7,8,2022,01-19,12:55
046 P�re Soulas,3,5,8,2022,01-19,12:55
047 Place Viala,1,7,8,2022,01-19,12:55
048 H�tel du D�partement,0,8,8,2022,01-19,12:55
049 Tonnelles,5,3,8,2022,01-19,12:55
050 Parvis Jules Ferry - Gare Saint-Roch,2,6,8,2022,01-19,12:55
051 Pont de Lattes - Gare Saint-Roch,2,10,12,2022,01-19,12:55
053 Deux Ponts - Gare Saint-Roch,1,7,8,2022,01-19,12:55
054 Providence - Ovalie,3,5,8,2022,01-19,12:55
055 P�rols Etang de l'Or,23,45,68,2022,01-19,12:55
056 Albert 1er - Cath�drale,7,5,12,2022,01-19,12:55
057 Saint-Guilhem - Courreau,2,6,8,2022,01-19,12:55
059 Sud De France,0,8,8,2022,01-19,12:55
001 Rue Jules Ferry - Gare Saint-Roch,7,5,12,2022,01-19,13:05
002 Com�die,13,11,24,2022,01-19,13:05
003 Esplanade,16,16,32,2022,01-19,13:05
004 H�tel de Ville,7,9,16,2022,01-19,13:05
005 Corum,8,4,12,2022,01-19,13:05
006 Place Albert 1er - St Charles,19,12,31,2022,01-19,13:05
007 Foch,7,1,8,2022,01-19,13:05
008 Halles Castellane,7,5,12,2022,01-19,13:05
009 Observatoire,7,1,8,2022,01-19,13:05
010 Rondelet,4,12,16,2022,01-19,13:05
011 Plan Cabanes,7,5,12,2022,01-19,13:05
012 Boutonnet,4,8,12,2022,01-19,13:05
013 Emile Combes,1,7,8,2022,01-19,13:05
014 Beaux-Arts,3,5,8,2022,01-19,13:05
015 Les Aubes,6,2,8,2022,01-19,13:05
016 Antigone centre,16,0,16,2022,01-19,13:05
017 M�diath�que Emile Zola,13,3,16,2022,01-19,13:05
018 Nombre d'Or,3,13,16,2022,01-19,13:05
019 Louis Blanc,11,5,16,2022,01-19,13:05
020 Gambetta,3,5,8,2022,01-19,13:05
021 Port Marianne,4,12,16,2022,01-19,13:05
022 Clemenceau,1,11,12,2022,01-19,13:05
023 Les Arceaux,1,15,16,2022,01-19,13:05
024 Cit� Mion,1,7,8,2022,01-19,13:05
025 Nouveau Saint-Roch,3,5,8,2022,01-19,13:05
026 Renouvier,3,5,8,2022,01-19,13:05
027 Odysseum,4,4,8,2022,01-19,13:05
028 Saint-Denis,5,3,8,2022,01-19,13:05
029 Richter,12,4,16,2022,01-19,13:05
030 Charles Flahault,3,5,8,2022,01-19,13:05
031 Voltaire,0,8,8,2022,01-19,13:05
032 Pr�s d'Ar�nes,8,0,8,2022,01-19,13:05
033 Garcia Lorca,5,3,8,2022,01-19,13:05
034 Vert Bois,0,16,16,2022,01-19,13:05
035 Malbosc,1,7,8,2022,01-19,13:05
036 Occitanie,5,27,32,2022,01-19,13:05
037 FacdesSciences,12,12,24,2022,01-19,13:05
038 Fac de Lettres,2,14,16,2022,01-19,13:05
039 Aiguelongue,2,6,8,2022,01-19,13:05
040 Jeu de Mail des Abb�s,5,3,8,2022,01-19,13:05
041 Eurom�decine,0,8,8,2022,01-19,13:05
042 Marie Caizergues,3,5,8,2022,01-19,13:05
043 Sabines,4,4,8,2022,01-19,13:05
044 Celleneuve,0,8,8,2022,01-19,13:05
045 Jardin de la Lironde,1,7,8,2022,01-19,13:05
046 P�re Soulas,3,5,8,2022,01-19,13:05
047 Place Viala,1,7,8,2022,01-19,13:05
048 H�tel du D�partement,0,8,8,2022,01-19,13:05
049 Tonnelles,5,3,8,2022,01-19,13:05
050 Parvis Jules Ferry - Gare Saint-Roch,2,6,8,2022,01-19,13:05
051 Pont de Lattes - Gare Saint-Roch,2,10,12,2022,01-19,13:05
053 Deux Ponts - Gare Saint-Roch,1,7,8,2022,01-19,13:05
054 Providence - Ovalie,3,5,8,2022,01-19,13:05
055 P�rols Etang de l'Or,23,45,68,2022,01-19,13:05
056 Albert 1er - Cath�drale,7,5,12,2022,01-19,13:05
057 Saint-Guilhem - Courreau,2,6,8,2022,01-19,13:05
059 Sud De France,0,8,8,2022,01-19,13:05
001 Rue Jules Ferry - Gare Saint-Roch,7,5,12,2022,01-19,13:15
002 Com�die,12,12,24,2022,01-19,13:15
003 Esplanade,16,16,32,2022,01-19,13:15
004 H�tel de Ville,7,9,16,2022,01-19,13:15
005 Corum,8,4,12,2022,01-19,13:15
006 Place Albert 1er - St Charles,19,12,31,2022,01-19,13:15
007 Foch,7,1,8,2022,01-19,13:15
008 Halles Castellane,7,5,12,2022,01-19,13:15
009 Observatoire,7,1,8,2022,01-19,13:15
010 Rondelet,4,12,16,2022,01-19,13:15
011 Plan Cabanes,7,5,12,2022,01-19,13:15
012 Boutonnet,5,7,12,2022,01-19,13:15
013 Emile Combes,1,7,8,2022,01-19,13:15
014 Beaux-Arts,3,5,8,2022,01-19,13:15
015 Les Aubes,6,2,8,2022,01-19,13:15
016 Antigone centre,14,2,16,2022,01-19,13:15
017 M�diath�que Emile Zola,13,3,16,2022,01-19,13:15
018 Nombre d'Or,3,13,16,2022,01-19,13:15
019 Louis Blanc,11,5,16,2022,01-19,13:15
020 Gambetta,3,5,8,2022,01-19,13:15
021 Port Marianne,5,11,16,2022,01-19,13:15
022 Clemenceau,2,10,12,2022,01-19,13:15
023 Les Arceaux,1,15,16,2022,01-19,13:15
024 Cit� Mion,1,7,8,2022,01-19,13:15
025 Nouveau Saint-Roch,3,5,8,2022,01-19,13:15
026 Renouvier,3,5,8,2022,01-19,13:15
027 Odysseum,4,4,8,2022,01-19,13:15
028 Saint-Denis,5,3,8,2022,01-19,13:15
029 Richter,12,4,16,2022,01-19,13:15
030 Charles Flahault,3,5,8,2022,01-19,13:15
031 Voltaire,1,7,8,2022,01-19,13:15
032 Pr�s d'Ar�nes,8,0,8,2022,01-19,13:15
033 Garcia Lorca,5,3,8,2022,01-19,13:15
034 Vert Bois,0,16,16,2022,01-19,13:15
035 Malbosc,1,7,8,2022,01-19,13:15
036 Occitanie,5,27,32,2022,01-19,13:15
037 FacdesSciences,12,12,24,2022,01-19,13:15
038 Fac de Lettres,2,14,16,2022,01-19,13:15
039 Aiguelongue,2,6,8,2022,01-19,13:15
040 Jeu de Mail des Abb�s,5,3,8,2022,01-19,13:15
041 Eurom�decine,0,8,8,2022,01-19,13:15
042 Marie Caizergues,3,5,8,2022,01-19,13:15
043 Sabines,4,4,8,2022,01-19,13:15
044 Celleneuve,0,8,8,2022,01-19,13:15
045 Jardin de la Lironde,1,7,8,2022,01-19,13:15
046 P�re Soulas,3,5,8,2022,01-19,13:15
047 Place Viala,2,6,8,2022,01-19,13:15
048 H�tel du D�partement,0,8,8,2022,01-19,13:15
049 Tonnelles,5,3,8,2022,01-19,13:15
050 Parvis Jules Ferry - Gare Saint-Roch,2,6,8,2022,01-19,13:15
051 Pont de Lattes - Gare Saint-Roch,2,10,12,2022,01-19,13:15
053 Deux Ponts - Gare Saint-Roch,1,7,8,2022,01-19,13:15
054 Providence - Ovalie,3,5,8,2022,01-19,13:15
055 P�rols Etang de l'Or,23,45,68,2022,01-19,13:15
056 Albert 1er - Cath�drale,7,5,12,2022,01-19,13:15
057 Saint-Guilhem - Courreau,2,6,8,2022,01-19,13:15
059 Sud De France,0,8,8,2022,01-19,13:15
001 Rue Jules Ferry - Gare Saint-Roch,7,5,12,2022,01-19,13:25
002 Com�die,12,12,24,2022,01-19,13:25
003 Esplanade,16,16,32,2022,01-19,13:25
004 H�tel de Ville,7,9,16,2022,01-19,13:25
005 Corum,8,4,12,2022,01-19,13:25
006 Place Albert 1er - St Charles,19,12,31,2022,01-19,13:25
007 Foch,7,1,8,2022,01-19,13:25
008 Halles Castellane,7,5,12,2022,01-19,13:25
009 Observatoire,7,1,8,2022,01-19,13:25
010 Rondelet,4,12,16,2022,01-19,13:25
011 Plan Cabanes,7,5,12,2022,01-19,13:25
012 Boutonnet,5,7,12,2022,01-19,13:25
013 Emile Combes,1,7,8,2022,01-19,13:25
014 Beaux-Arts,3,5,8,2022,01-19,13:25
015 Les Aubes,6,2,8,2022,01-19,13:25
016 Antigone centre,14,2,16,2022,01-19,13:25
017 M�diath�que Emile Zola,14,2,16,2022,01-19,13:25
018 Nombre d'Or,3,13,16,2022,01-19,13:25
019 Louis Blanc,11,5,16,2022,01-19,13:25
020 Gambetta,3,5,8,2022,01-19,13:25
021 Port Marianne,5,11,16,2022,01-19,13:25
022 Clemenceau,2,10,12,2022,01-19,13:25
023 Les Arceaux,1,15,16,2022,01-19,13:25
024 Cit� Mion,2,6,8,2022,01-19,13:25
025 Nouveau Saint-Roch,2,6,8,2022,01-19,13:25
026 Renouvier,3,5,8,2022,01-19,13:25
027 Odysseum,4,4,8,2022,01-19,13:25
028 Saint-Denis,4,4,8,2022,01-19,13:25
029 Richter,12,4,16,2022,01-19,13:25
030 Charles Flahault,3,5,8,2022,01-19,13:25
031 Voltaire,1,7,8,2022,01-19,13:25
032 Pr�s d'Ar�nes,8,0,8,2022,01-19,13:25
033 Garcia Lorca,5,3,8,2022,01-19,13:25
034 Vert Bois,0,16,16,2022,01-19,13:25
035 Malbosc,1,7,8,2022,01-19,13:25
036 Occitanie,6,26,32,2022,01-19,13:25
037 FacdesSciences,12,12,24,2022,01-19,13:25
038 Fac de Lettres,2,14,16,2022,01-19,13:25
039 Aiguelongue,2,6,8,2022,01-19,13:25
040 Jeu de Mail des Abb�s,4,4,8,2022,01-19,13:25
041 Eurom�decine,0,8,8,2022,01-19,13:25
042 Marie Caizergues,3,5,8,2022,01-19,13:25
043 Sabines,4,4,8,2022,01-19,13:25
044 Celleneuve,0,8,8,2022,01-19,13:25
045 Jardin de la Lironde,1,7,8,2022,01-19,13:25
046 P�re Soulas,3,5,8,2022,01-19,13:25
047 Place Viala,1,7,8,2022,01-19,13:25
048 H�tel du D�partement,0,8,8,2022,01-19,13:25
049 Tonnelles,5,3,8,2022,01-19,13:25
050 Parvis Jules Ferry - Gare Saint-Roch,2,6,8,2022,01-19,13:25
051 Pont de Lattes - Gare Saint-Roch,2,10,12,2022,01-19,13:25
053 Deux Ponts - Gare Saint-Roch,1,7,8,2022,01-19,13:25
054 Providence - Ovalie,3,5,8,2022,01-19,13:25
055 P�rols Etang de l'Or,23,45,68,2022,01-19,13:25
056 Albert 1er - Cath�drale,7,5,12,2022,01-19,13:25
057 Saint-Guilhem - Courreau,2,6,8,2022,01-19,13:25
059 Sud De France,0,8,8,2022,01-19,13:25
001 Rue Jules Ferry - Gare Saint-Roch,7,5,12,2022,01-19,13:35
002 Com�die,12,12,24,2022,01-19,13:35
003 Esplanade,17,15,32,2022,01-19,13:35
004 H�tel de Ville,7,9,16,2022,01-19,13:35
005 Corum,8,4,12,2022,01-19,13:35
006 Place Albert 1er - St Charles,21,10,31,2022,01-19,13:35
007 Foch,7,1,8,2022,01-19,13:35
008 Halles Castellane,7,5,12,2022,01-19,13:35
009 Observatoire,7,1,8,2022,01-19,13:35
010 Rondelet,4,12,16,2022,01-19,13:35
011 Plan Cabanes,7,5,12,2022,01-19,13:35
012 Boutonnet,5,7,12,2022,01-19,13:35
013 Emile Combes,1,7,8,2022,01-19,13:35
014 Beaux-Arts,3,5,8,2022,01-19,13:35
015 Les Aubes,6,2,8,2022,01-19,13:35
016 Antigone centre,14,2,16,2022,01-19,13:35
017 M�diath�que Emile Zola,15,1,16,2022,01-19,13:35
018 Nombre d'Or,2,14,16,2022,01-19,13:35
019 Louis Blanc,11,5,16,2022,01-19,13:35
020 Gambetta,3,5,8,2022,01-19,13:35
021 Port Marianne,5,11,16,2022,01-19,13:35
022 Clemenceau,2,10,12,2022,01-19,13:35
023 Les Arceaux,1,15,16,2022,01-19,13:35
024 Cit� Mion,2,6,8,2022,01-19,13:35
025 Nouveau Saint-Roch,2,6,8,2022,01-19,13:35
026 Renouvier,3,5,8,2022,01-19,13:35
027 Odysseum,4,4,8,2022,01-19,13:35
028 Saint-Denis,4,4,8,2022,01-19,13:35
029 Richter,12,4,16,2022,01-19,13:35
030 Charles Flahault,3,5,8,2022,01-19,13:35
031 Voltaire,1,7,8,2022,01-19,13:35
032 Pr�s d'Ar�nes,8,0,8,2022,01-19,13:35
033 Garcia Lorca,5,3,8,2022,01-19,13:35
034 Vert Bois,0,16,16,2022,01-19,13:35
035 Malbosc,1,7,8,2022,01-19,13:35
036 Occitanie,7,25,32,2022,01-19,13:35
037 FacdesSciences,11,13,24,2022,01-19,13:35
038 Fac de Lettres,2,14,16,2022,01-19,13:35
039 Aiguelongue,2,6,8,2022,01-19,13:35
040 Jeu de Mail des Abb�s,4,4,8,2022,01-19,13:35
041 Eurom�decine,0,8,8,2022,01-19,13:35
042 Marie Caizergues,3,5,8,2022,01-19,13:35
043 Sabines,4,4,8,2022,01-19,13:35
044 Celleneuve,0,8,8,2022,01-19,13:35
045 Jardin de la Lironde,1,7,8,2022,01-19,13:35
046 P�re Soulas,3,5,8,2022,01-19,13:35
047 Place Viala,1,7,8,2022,01-19,13:35
048 H�tel du D�partement,0,8,8,2022,01-19,13:35
049 Tonnelles,5,3,8,2022,01-19,13:35
050 Parvis Jules Ferry - Gare Saint-Roch,2,6,8,2022,01-19,13:35
051 Pont de Lattes - Gare Saint-Roch,2,10,12,2022,01-19,13:35
053 Deux Ponts - Gare Saint-Roch,1,7,8,2022,01-19,13:35
054 Providence - Ovalie,3,5,8,2022,01-19,13:35
055 P�rols Etang de l'Or,23,45,68,2022,01-19,13:35
056 Albert 1er - Cath�drale,7,5,12,2022,01-19,13:35
057 Saint-Guilhem - Courreau,2,6,8,2022,01-19,13:35
059 Sud De France,0,8,8,2022,01-19,13:35
001 Rue Jules Ferry - Gare Saint-Roch,6,6,12,2022,01-19,13:46
002 Com�die,12,12,24,2022,01-19,13:46
003 Esplanade,17,15,32,2022,01-19,13:46
004 H�tel de Ville,7,9,16,2022,01-19,13:46
005 Corum,8,4,12,2022,01-19,13:46
006 Place Albert 1er - St Charles,20,11,31,2022,01-19,13:46
007 Foch,7,1,8,2022,01-19,13:46
008 Halles Castellane,7,5,12,2022,01-19,13:46
009 Observatoire,7,1,8,2022,01-19,13:46
010 Rondelet,4,12,16,2022,01-19,13:46
011 Plan Cabanes,6,6,12,2022,01-19,13:46
012 Boutonnet,7,5,12,2022,01-19,13:46
013 Emile Combes,1,7,8,2022,01-19,13:46
014 Beaux-Arts,3,5,8,2022,01-19,13:46
015 Les Aubes,6,2,8,2022,01-19,13:46
016 Antigone centre,15,1,16,2022,01-19,13:46
017 M�diath�que Emile Zola,15,1,16,2022,01-19,13:46
018 Nombre d'Or,3,13,16,2022,01-19,13:46
019 Louis Blanc,11,5,16,2022,01-19,13:46
020 Gambetta,4,4,8,2022,01-19,13:46
021 Port Marianne,5,11,16,2022,01-19,13:46
022 Clemenceau,2,10,12,2022,01-19,13:46
023 Les Arceaux,2,14,16,2022,01-19,13:46
024 Cit� Mion,2,6,8,2022,01-19,13:46
025 Nouveau Saint-Roch,2,6,8,2022,01-19,13:46
026 Renouvier,3,5,8,2022,01-19,13:46
027 Odysseum,4,4,8,2022,01-19,13:46
028 Saint-Denis,4,4,8,2022,01-19,13:46
029 Richter,11,5,16,2022,01-19,13:46
030 Charles Flahault,5,3,8,2022,01-19,13:46
031 Voltaire,1,7,8,2022,01-19,13:46
032 Pr�s d'Ar�nes,8,0,8,2022,01-19,13:46
033 Garcia Lorca,5,3,8,2022,01-19,13:46
034 Vert Bois,0,16,16,2022,01-19,13:46
035 Malbosc,1,7,8,2022,01-19,13:46
036 Occitanie,7,25,32,2022,01-19,13:46
037 FacdesSciences,11,13,24,2022,01-19,13:46
038 Fac de Lettres,1,15,16,2022,01-19,13:46
039 Aiguelongue,3,5,8,2022,01-19,13:46
040 Jeu de Mail des Abb�s,4,4,8,2022,01-19,13:46
041 Eurom�decine,0,8,8,2022,01-19,13:46
042 Marie Caizergues,3,5,8,2022,01-19,13:46
043 Sabines,4,4,8,2022,01-19,13:46
044 Celleneuve,0,8,8,2022,01-19,13:46
045 Jardin de la Lironde,1,7,8,2022,01-19,13:46
046 P�re Soulas,2,6,8,2022,01-19,13:46
047 Place Viala,1,7,8,2022,01-19,13:46
048 H�tel du D�partement,0,8,8,2022,01-19,13:46
049 Tonnelles,5,3,8,2022,01-19,13:46
050 Parvis Jules Ferry - Gare Saint-Roch,2,6,8,2022,01-19,13:46
051 Pont de Lattes - Gare Saint-Roch,2,10,12,2022,01-19,13:46
053 Deux Ponts - Gare Saint-Roch,0,8,8,2022,01-19,13:46
054 Providence - Ovalie,3,5,8,2022,01-19,13:46
055 P�rols Etang de l'Or,23,45,68,2022,01-19,13:46
056 Albert 1er - Cath�drale,7,5,12,2022,01-19,13:46
057 Saint-Guilhem - Courreau,1,7,8,2022,01-19,13:46
059 Sud De France,0,8,8,2022,01-19,13:46
001 Rue Jules Ferry - Gare Saint-Roch,5,7,12,2022,01-19,13:56
002 Com�die,12,12,24,2022,01-19,13:56
003 Esplanade,17,15,32,2022,01-19,13:56
004 H�tel de Ville,7,9,16,2022,01-19,13:56
005 Corum,8,4,12,2022,01-19,13:56
006 Place Albert 1er - St Charles,21,10,31,2022,01-19,13:56
007 Foch,7,1,8,2022,01-19,13:56
008 Halles Castellane,6,6,12,2022,01-19,13:56
009 Observatoire,7,1,8,2022,01-19,13:56
010 Rondelet,4,12,16,2022,01-19,13:56
011 Plan Cabanes,5,7,12,2022,01-19,13:56
012 Boutonnet,8,4,12,2022,01-19,13:56
013 Emile Combes,1,7,8,2022,01-19,13:56
014 Beaux-Arts,3,5,8,2022,01-19,13:56
015 Les Aubes,6,2,8,2022,01-19,13:56
016 Antigone centre,14,2,16,2022,01-19,13:56
017 M�diath�que Emile Zola,14,2,16,2022,01-19,13:56
018 Nombre d'Or,3,13,16,2022,01-19,13:56
019 Louis Blanc,12,4,16,2022,01-19,13:56
020 Gambetta,4,4,8,2022,01-19,13:56
021 Port Marianne,5,11,16,2022,01-19,13:56
022 Clemenceau,2,10,12,2022,01-19,13:56
023 Les Arceaux,2,14,16,2022,01-19,13:56
024 Cit� Mion,2,6,8,2022,01-19,13:56
025 Nouveau Saint-Roch,2,6,8,2022,01-19,13:56
026 Renouvier,3,5,8,2022,01-19,13:56
027 Odysseum,4,4,8,2022,01-19,13:56
028 Saint-Denis,4,4,8,2022,01-19,13:56
029 Richter,11,5,16,2022,01-19,13:56
030 Charles Flahault,5,3,8,2022,01-19,13:56
031 Voltaire,1,7,8,2022,01-19,13:56
032 Pr�s d'Ar�nes,8,0,8,2022,01-19,13:56
033 Garcia Lorca,5,3,8,2022,01-19,13:56
034 Vert Bois,0,16,16,2022,01-19,13:56
035 Malbosc,1,7,8,2022,01-19,13:56
036 Occitanie,7,25,32,2022,01-19,13:56
037 FacdesSciences,11,13,24,2022,01-19,13:56
038 Fac de Lettres,1,15,16,2022,01-19,13:56
039 Aiguelongue,3,5,8,2022,01-19,13:56
040 Jeu de Mail des Abb�s,4,4,8,2022,01-19,13:56
041 Eurom�decine,0,8,8,2022,01-19,13:56
042 Marie Caizergues,3,5,8,2022,01-19,13:56
043 Sabines,4,4,8,2022,01-19,13:56
044 Celleneuve,0,8,8,2022,01-19,13:56
045 Jardin de la Lironde,1,7,8,2022,01-19,13:56
046 P�re Soulas,2,6,8,2022,01-19,13:56
047 Place Viala,1,7,8,2022,01-19,13:56
048 H�tel du D�partement,0,8,8,2022,01-19,13:56
049 Tonnelles,5,3,8,2022,01-19,13:56
050 Parvis Jules Ferry - Gare Saint-Roch,2,6,8,2022,01-19,13:56
051 Pont de Lattes - Gare Saint-Roch,2,10,12,2022,01-19,13:56
053 Deux Ponts - Gare Saint-Roch,0,8,8,2022,01-19,13:56
054 Providence - Ovalie,3,5,8,2022,01-19,13:56
055 P�rols Etang de l'Or,23,45,68,2022,01-19,13:56
056 Albert 1er - Cath�drale,6,6,12,2022,01-19,13:56
057 Saint-Guilhem - Courreau,1,7,8,2022,01-19,13:56
059 Sud De France,0,8,8,2022,01-19,13:56
001 Rue Jules Ferry - Gare Saint-Roch,5,7,12,2022,01-19,14:06
002 Com�die,12,12,24,2022,01-19,14:06
003 Esplanade,16,16,32,2022,01-19,14:06
004 H�tel de Ville,7,9,16,2022,01-19,14:06
005 Corum,8,4,12,2022,01-19,14:06
006 Place Albert 1er - St Charles,21,10,31,2022,01-19,14:06
007 Foch,7,1,8,2022,01-19,14:06
008 Halles Castellane,6,6,12,2022,01-19,14:06
009 Observatoire,6,2,8,2022,01-19,14:06
010 Rondelet,4,12,16,2022,01-19,14:06
011 Plan Cabanes,5,7,12,2022,01-19,14:06
012 Boutonnet,8,4,12,2022,01-19,14:06
013 Emile Combes,1,7,8,2022,01-19,14:06
014 Beaux-Arts,4,4,8,2022,01-19,14:06
015 Les Aubes,6,2,8,2022,01-19,14:06
016 Antigone centre,12,4,16,2022,01-19,14:06
017 M�diath�que Emile Zola,13,3,16,2022,01-19,14:06
018 Nombre d'Or,3,13,16,2022,01-19,14:06
019 Louis Blanc,12,4,16,2022,01-19,14:06
020 Gambetta,4,4,8,2022,01-19,14:06
021 Port Marianne,5,11,16,2022,01-19,14:06
022 Clemenceau,2,10,12,2022,01-19,14:06
023 Les Arceaux,2,14,16,2022,01-19,14:06
024 Cit� Mion,2,6,8,2022,01-19,14:06
025 Nouveau Saint-Roch,2,6,8,2022,01-19,14:06
026 Renouvier,3,5,8,2022,01-19,14:06
027 Odysseum,4,4,8,2022,01-19,14:06
028 Saint-Denis,4,4,8,2022,01-19,14:06
029 Richter,12,4,16,2022,01-19,14:06
030 Charles Flahault,5,3,8,2022,01-19,14:06
031 Voltaire,0,8,8,2022,01-19,14:06
032 Pr�s d'Ar�nes,8,0,8,2022,01-19,14:06
033 Garcia Lorca,5,3,8,2022,01-19,14:06
034 Vert Bois,0,16,16,2022,01-19,14:06
035 Malbosc,1,7,8,2022,01-19,14:06
036 Occitanie,7,25,32,2022,01-19,14:06
037 FacdesSciences,11,13,24,2022,01-19,14:06
038 Fac de Lettres,1,15,16,2022,01-19,14:06
039 Aiguelongue,1,7,8,2022,01-19,14:06
040 Jeu de Mail des Abb�s,4,4,8,2022,01-19,14:06
041 Eurom�decine,0,8,8,2022,01-19,14:06
042 Marie Caizergues,3,5,8,2022,01-19,14:06
043 Sabines,4,4,8,2022,01-19,14:06
044 Celleneuve,0,8,8,2022,01-19,14:06
045 Jardin de la Lironde,2,6,8,2022,01-19,14:06
046 P�re Soulas,2,6,8,2022,01-19,14:06
047 Place Viala,1,7,8,2022,01-19,14:06
048 H�tel du D�partement,0,8,8,2022,01-19,14:06
049 Tonnelles,5,3,8,2022,01-19,14:06
050 Parvis Jules Ferry - Gare Saint-Roch,2,6,8,2022,01-19,14:06
051 Pont de Lattes - Gare Saint-Roch,2,10,12,2022,01-19,14:06
053 Deux Ponts - Gare Saint-Roch,0,8,8,2022,01-19,14:06
054 Providence - Ovalie,3,5,8,2022,01-19,14:06
055 P�rols Etang de l'Or,22,46,68,2022,01-19,14:06
056 Albert 1er - Cath�drale,6,6,12,2022,01-19,14:06
057 Saint-Guilhem - Courreau,2,6,8,2022,01-19,14:06
059 Sud De France,0,8,8,2022,01-19,14:06
001 Rue Jules Ferry - Gare Saint-Roch,5,7,12,2022,01-19,14:16
002 Com�die,12,12,24,2022,01-19,14:16
003 Esplanade,16,16,32,2022,01-19,14:16
004 H�tel de Ville,7,9,16,2022,01-19,14:16
005 Corum,8,4,12,2022,01-19,14:16
006 Place Albert 1er - St Charles,21,10,31,2022,01-19,14:16
007 Foch,7,1,8,2022,01-19,14:16
008 Halles Castellane,6,6,12,2022,01-19,14:16
009 Observatoire,6,2,8,2022,01-19,14:16
010 Rondelet,4,12,16,2022,01-19,14:16
011 Plan Cabanes,4,8,12,2022,01-19,14:16
012 Boutonnet,8,4,12,2022,01-19,14:16
013 Emile Combes,1,7,8,2022,01-19,14:16
014 Beaux-Arts,4,4,8,2022,01-19,14:16
015 Les Aubes,6,2,8,2022,01-19,14:16
016 Antigone centre,13,3,16,2022,01-19,14:16
017 M�diath�que Emile Zola,14,2,16,2022,01-19,14:16
018 Nombre d'Or,4,12,16,2022,01-19,14:16
019 Louis Blanc,12,4,16,2022,01-19,14:16
020 Gambetta,4,4,8,2022,01-19,14:16
021 Port Marianne,7,9,16,2022,01-19,14:16
022 Clemenceau,2,10,12,2022,01-19,14:16
023 Les Arceaux,2,14,16,2022,01-19,14:16
024 Cit� Mion,2,6,8,2022,01-19,14:16
025 Nouveau Saint-Roch,2,6,8,2022,01-19,14:16
026 Renouvier,3,5,8,2022,01-19,14:16
027 Odysseum,4,4,8,2022,01-19,14:16
028 Saint-Denis,4,4,8,2022,01-19,14:16
029 Richter,12,4,16,2022,01-19,14:16
030 Charles Flahault,5,3,8,2022,01-19,14:16
031 Voltaire,1,7,8,2022,01-19,14:16
032 Pr�s d'Ar�nes,8,0,8,2022,01-19,14:16
033 Garcia Lorca,5,3,8,2022,01-19,14:16
034 Vert Bois,0,16,16,2022,01-19,14:16
035 Malbosc,1,7,8,2022,01-19,14:16
036 Occitanie,8,24,32,2022,01-19,14:16
037 FacdesSciences,12,12,24,2022,01-19,14:16
038 Fac de Lettres,1,15,16,2022,01-19,14:16
039 Aiguelongue,1,7,8,2022,01-19,14:16
040 Jeu de Mail des Abb�s,4,4,8,2022,01-19,14:16
041 Eurom�decine,0,8,8,2022,01-19,14:16
042 Marie Caizergues,3,5,8,2022,01-19,14:16
043 Sabines,4,4,8,2022,01-19,14:16
044 Celleneuve,0,8,8,2022,01-19,14:16
045 Jardin de la Lironde,2,6,8,2022,01-19,14:16
046 P�re Soulas,2,6,8,2022,01-19,14:16
047 Place Viala,1,7,8,2022,01-19,14:16
048 H�tel du D�partement,0,8,8,2022,01-19,14:16
049 Tonnelles,5,3,8,2022,01-19,14:16
050 Parvis Jules Ferry - Gare Saint-Roch,2,6,8,2022,01-19,14:16
051 Pont de Lattes - Gare Saint-Roch,2,10,12,2022,01-19,14:16
053 Deux Ponts - Gare Saint-Roch,0,8,8,2022,01-19,14:16
054 Providence - Ovalie,3,5,8,2022,01-19,14:16
055 P�rols Etang de l'Or,22,46,68,2022,01-19,14:16
056 Albert 1er - Cath�drale,6,6,12,2022,01-19,14:16
057 Saint-Guilhem - Courreau,2,6,8,2022,01-19,14:16
059 Sud De France,0,8,8,2022,01-19,14:16
001 Rue Jules Ferry - Gare Saint-Roch,5,7,12,2022,01-19,14:26
002 Com�die,12,12,24,2022,01-19,14:26
003 Esplanade,16,16,32,2022,01-19,14:26
004 H�tel de Ville,7,9,16,2022,01-19,14:26
005 Corum,8,4,12,2022,01-19,14:26
006 Place Albert 1er - St Charles,21,10,31,2022,01-19,14:26
007 Foch,7,1,8,2022,01-19,14:26
008 Halles Castellane,6,6,12,2022,01-19,14:26
009 Observatoire,6,2,8,2022,01-19,14:26
010 Rondelet,4,12,16,2022,01-19,14:26
011 Plan Cabanes,4,8,12,2022,01-19,14:26
012 Boutonnet,8,4,12,2022,01-19,14:26
013 Emile Combes,1,7,8,2022,01-19,14:26
014 Beaux-Arts,4,4,8,2022,01-19,14:26
015 Les Aubes,6,2,8,2022,01-19,14:26
016 Antigone centre,14,2,16,2022,01-19,14:26
017 M�diath�que Emile Zola,14,2,16,2022,01-19,14:26
018 Nombre d'Or,4,12,16,2022,01-19,14:26
019 Louis Blanc,12,4,16,2022,01-19,14:26
020 Gambetta,4,4,8,2022,01-19,14:26
021 Port Marianne,7,9,16,2022,01-19,14:26
022 Clemenceau,2,10,12,2022,01-19,14:26
023 Les Arceaux,2,14,16,2022,01-19,14:26
024 Cit� Mion,2,6,8,2022,01-19,14:26
025 Nouveau Saint-Roch,2,6,8,2022,01-19,14:26
026 Renouvier,3,5,8,2022,01-19,14:26
027 Odysseum,4,4,8,2022,01-19,14:26
028 Saint-Denis,4,4,8,2022,01-19,14:26
029 Richter,12,4,16,2022,01-19,14:26
030 Charles Flahault,5,3,8,2022,01-19,14:26
031 Voltaire,1,7,8,2022,01-19,14:26
032 Pr�s d'Ar�nes,8,0,8,2022,01-19,14:26
033 Garcia Lorca,5,3,8,2022,01-19,14:26
034 Vert Bois,0,16,16,2022,01-19,14:26
035 Malbosc,1,7,8,2022,01-19,14:26
036 Occitanie,8,24,32,2022,01-19,14:26
037 FacdesSciences,12,12,24,2022,01-19,14:26
038 Fac de Lettres,1,15,16,2022,01-19,14:26
039 Aiguelongue,1,7,8,2022,01-19,14:26
040 Jeu de Mail des Abb�s,4,4,8,2022,01-19,14:26
041 Eurom�decine,0,8,8,2022,01-19,14:26
042 Marie Caizergues,5,3,8,2022,01-19,14:26
043 Sabines,4,4,8,2022,01-19,14:26
044 Celleneuve,0,8,8,2022,01-19,14:26
045 Jardin de la Lironde,2,6,8,2022,01-19,14:26
046 P�re Soulas,3,5,8,2022,01-19,14:26
047 Place Viala,1,7,8,2022,01-19,14:26
048 H�tel du D�partement,0,8,8,2022,01-19,14:26
049 Tonnelles,5,3,8,2022,01-19,14:26
050 Parvis Jules Ferry - Gare Saint-Roch,2,6,8,2022,01-19,14:26
051 Pont de Lattes - Gare Saint-Roch,2,10,12,2022,01-19,14:26
053 Deux Ponts - Gare Saint-Roch,1,7,8,2022,01-19,14:26
054 Providence - Ovalie,3,5,8,2022,01-19,14:26
055 P�rols Etang de l'Or,22,46,68,2022,01-19,14:26
056 Albert 1er - Cath�drale,6,6,12,2022,01-19,14:26
057 Saint-Guilhem - Courreau,1,7,8,2022,01-19,14:26
059 Sud De France,0,8,8,2022,01-19,14:26
001 Rue Jules Ferry - Gare Saint-Roch,5,7,12,2022,01-19,14:37
002 Com�die,12,12,24,2022,01-19,14:37
003 Esplanade,15,17,32,2022,01-19,14:37
004 H�tel de Ville,7,9,16,2022,01-19,14:37
005 Corum,8,4,12,2022,01-19,14:37
006 Place Albert 1er - St Charles,19,12,31,2022,01-19,14:37
007 Foch,7,1,8,2022,01-19,14:37
008 Halles Castellane,5,7,12,2022,01-19,14:37
009 Observatoire,6,2,8,2022,01-19,14:37
010 Rondelet,3,13,16,2022,01-19,14:37
011 Plan Cabanes,4,8,12,2022,01-19,14:37
012 Boutonnet,8,4,12,2022,01-19,14:37
013 Emile Combes,1,7,8,2022,01-19,14:37
014 Beaux-Arts,4,4,8,2022,01-19,14:37
015 Les Aubes,6,2,8,2022,01-19,14:37
016 Antigone centre,14,2,16,2022,01-19,14:37
017 M�diath�que Emile Zola,14,2,16,2022,01-19,14:37
018 Nombre d'Or,4,12,16,2022,01-19,14:37
019 Louis Blanc,12,4,16,2022,01-19,14:37
020 Gambetta,4,4,8,2022,01-19,14:37
021 Port Marianne,7,9,16,2022,01-19,14:37
022 Clemenceau,2,10,12,2022,01-19,14:37
023 Les Arceaux,2,14,16,2022,01-19,14:37
024 Cit� Mion,2,6,8,2022,01-19,14:37
025 Nouveau Saint-Roch,1,7,8,2022,01-19,14:37
026 Renouvier,3,5,8,2022,01-19,14:37
027 Odysseum,5,3,8,2022,01-19,14:37
028 Saint-Denis,4,4,8,2022,01-19,14:37
029 Richter,12,4,16,2022,01-19,14:37
030 Charles Flahault,5,3,8,2022,01-19,14:37
031 Voltaire,1,7,8,2022,01-19,14:37
032 Pr�s d'Ar�nes,8,0,8,2022,01-19,14:37
033 Garcia Lorca,5,3,8,2022,01-19,14:37
034 Vert Bois,0,16,16,2022,01-19,14:37
035 Malbosc,1,7,8,2022,01-19,14:37
036 Occitanie,8,24,32,2022,01-19,14:37
037 FacdesSciences,12,12,24,2022,01-19,14:37
038 Fac de Lettres,1,15,16,2022,01-19,14:37
039 Aiguelongue,1,7,8,2022,01-19,14:37
040 Jeu de Mail des Abb�s,4,4,8,2022,01-19,14:37
041 Eurom�decine,0,8,8,2022,01-19,14:37
042 Marie Caizergues,5,3,8,2022,01-19,14:37
043 Sabines,4,4,8,2022,01-19,14:37
044 Celleneuve,0,8,8,2022,01-19,14:37
045 Jardin de la Lironde,2,6,8,2022,01-19,14:37
046 P�re Soulas,3,5,8,2022,01-19,14:37
047 Place Viala,0,8,8,2022,01-19,14:37
048 H�tel du D�partement,0,8,8,2022,01-19,14:37
049 Tonnelles,4,4,8,2022,01-19,14:37
050 Parvis Jules Ferry - Gare Saint-Roch,2,6,8,2022,01-19,14:37
051 Pont de Lattes - Gare Saint-Roch,2,10,12,2022,01-19,14:37
053 Deux Ponts - Gare Saint-Roch,1,7,8,2022,01-19,14:37
054 Providence - Ovalie,3,5,8,2022,01-19,14:37
055 P�rols Etang de l'Or,22,46,68,2022,01-19,14:37
056 Albert 1er - Cath�drale,6,6,12,2022,01-19,14:37
057 Saint-Guilhem - Courreau,1,7,8,2022,01-19,14:37
059 Sud De France,0,8,8,2022,01-19,14:37
001 Rue Jules Ferry - Gare Saint-Roch,5,7,12,2022,01-19,14:47
002 Com�die,12,12,24,2022,01-19,14:47
003 Esplanade,16,16,32,2022,01-19,14:47
004 H�tel de Ville,7,9,16,2022,01-19,14:47
005 Corum,8,4,12,2022,01-19,14:47
006 Place Albert 1er - St Charles,19,12,31,2022,01-19,14:47
007 Foch,6,2,8,2022,01-19,14:47
008 Halles Castellane,5,7,12,2022,01-19,14:47
009 Observatoire,6,2,8,2022,01-19,14:47
010 Rondelet,3,13,16,2022,01-19,14:47
011 Plan Cabanes,5,7,12,2022,01-19,14:47
012 Boutonnet,8,4,12,2022,01-19,14:47
013 Emile Combes,1,7,8,2022,01-19,14:47
014 Beaux-Arts,4,4,8,2022,01-19,14:47
015 Les Aubes,6,2,8,2022,01-19,14:47
016 Antigone centre,14,2,16,2022,01-19,14:47
017 M�diath�que Emile Zola,14,2,16,2022,01-19,14:47
018 Nombre d'Or,4,12,16,2022,01-19,14:47
019 Louis Blanc,12,4,16,2022,01-19,14:47
020 Gambetta,4,4,8,2022,01-19,14:47
021 Port Marianne,7,9,16,2022,01-19,14:47
022 Clemenceau,2,10,12,2022,01-19,14:47
023 Les Arceaux,2,14,16,2022,01-19,14:47
024 Cit� Mion,2,6,8,2022,01-19,14:47
025 Nouveau Saint-Roch,1,7,8,2022,01-19,14:47
026 Renouvier,3,5,8,2022,01-19,14:47
027 Odysseum,5,3,8,2022,01-19,14:47
028 Saint-Denis,4,4,8,2022,01-19,14:47
029 Richter,11,5,16,2022,01-19,14:47
030 Charles Flahault,5,3,8,2022,01-19,14:47
031 Voltaire,1,7,8,2022,01-19,14:47
032 Pr�s d'Ar�nes,8,0,8,2022,01-19,14:47
033 Garcia Lorca,5,3,8,2022,01-19,14:47
034 Vert Bois,0,16,16,2022,01-19,14:47
035 Malbosc,1,7,8,2022,01-19,14:47
036 Occitanie,8,24,32,2022,01-19,14:47
037 FacdesSciences,12,12,24,2022,01-19,14:47
038 Fac de Lettres,0,16,16,2022,01-19,14:47
039 Aiguelongue,1,7,8,2022,01-19,14:47
040 Jeu de Mail des Abb�s,4,4,8,2022,01-19,14:47
041 Eurom�decine,0,8,8,2022,01-19,14:47
042 Marie Caizergues,5,3,8,2022,01-19,14:47
043 Sabines,4,4,8,2022,01-19,14:47
044 Celleneuve,0,8,8,2022,01-19,14:47
045 Jardin de la Lironde,2,6,8,2022,01-19,14:47
046 P�re Soulas,3,5,8,2022,01-19,14:47
047 Place Viala,0,8,8,2022,01-19,14:47
048 H�tel du D�partement,0,8,8,2022,01-19,14:47
049 Tonnelles,4,4,8,2022,01-19,14:47
050 Parvis Jules Ferry - Gare Saint-Roch,2,6,8,2022,01-19,14:47
051 Pont de Lattes - Gare Saint-Roch,2,10,12,2022,01-19,14:47
053 Deux Ponts - Gare Saint-Roch,1,7,8,2022,01-19,14:47
054 Providence - Ovalie,3,5,8,2022,01-19,14:47
055 P�rols Etang de l'Or,22,46,68,2022,01-19,14:47
056 Albert 1er - Cath�drale,6,6,12,2022,01-19,14:47
057 Saint-Guilhem - Courreau,1,7,8,2022,01-19,14:47
059 Sud De France,0,8,8,2022,01-19,14:47
001 Rue Jules Ferry - Gare Saint-Roch,4,8,12,2022,01-19,14:57
002 Com�die,12,12,24,2022,01-19,14:57
003 Esplanade,16,16,32,2022,01-19,14:57
004 H�tel de Ville,7,9,16,2022,01-19,14:57
005 Corum,8,4,12,2022,01-19,14:57
006 Place Albert 1er - St Charles,19,12,31,2022,01-19,14:57
007 Foch,6,2,8,2022,01-19,14:57
008 Halles Castellane,6,6,12,2022,01-19,14:57
009 Observatoire,6,2,8,2022,01-19,14:57
010 Rondelet,3,13,16,2022,01-19,14:57
011 Plan Cabanes,5,7,12,2022,01-19,14:57
012 Boutonnet,9,3,12,2022,01-19,14:57
013 Emile Combes,1,7,8,2022,01-19,14:57
014 Beaux-Arts,4,4,8,2022,01-19,14:57
015 Les Aubes,6,2,8,2022,01-19,14:57
016 Antigone centre,14,2,16,2022,01-19,14:57
017 M�diath�que Emile Zola,14,2,16,2022,01-19,14:57
018 Nombre d'Or,4,12,16,2022,01-19,14:57
019 Louis Blanc,13,3,16,2022,01-19,14:57
020 Gambetta,4,4,8,2022,01-19,14:57
021 Port Marianne,7,9,16,2022,01-19,14:57
022 Clemenceau,2,10,12,2022,01-19,14:57
023 Les Arceaux,2,14,16,2022,01-19,14:57
024 Cit� Mion,2,6,8,2022,01-19,14:57
025 Nouveau Saint-Roch,1,7,8,2022,01-19,14:57
026 Renouvier,3,5,8,2022,01-19,14:57
027 Odysseum,5,3,8,2022,01-19,14:57
028 Saint-Denis,4,4,8,2022,01-19,14:57
029 Richter,11,5,16,2022,01-19,14:57
030 Charles Flahault,4,4,8,2022,01-19,14:57
031 Voltaire,1,7,8,2022,01-19,14:57
032 Pr�s d'Ar�nes,8,0,8,2022,01-19,14:57
033 Garcia Lorca,5,3,8,2022,01-19,14:57
034 Vert Bois,0,16,16,2022,01-19,14:57
035 Malbosc,1,7,8,2022,01-19,14:57
036 Occitanie,8,24,32,2022,01-19,14:57
037 FacdesSciences,13,11,24,2022,01-19,14:57
038 Fac de Lettres,0,16,16,2022,01-19,14:57
039 Aiguelongue,1,7,8,2022,01-19,14:57
040 Jeu de Mail des Abb�s,4,4,8,2022,01-19,14:57
041 Eurom�decine,0,8,8,2022,01-19,14:57
042 Marie Caizergues,6,2,8,2022,01-19,14:57
043 Sabines,4,4,8,2022,01-19,14:57
044 Celleneuve,0,8,8,2022,01-19,14:57
045 Jardin de la Lironde,2,6,8,2022,01-19,14:57
046 P�re Soulas,3,5,8,2022,01-19,14:57
047 Place Viala,2,6,8,2022,01-19,14:57
048 H�tel du D�partement,0,8,8,2022,01-19,14:57
049 Tonnelles,4,4,8,2022,01-19,14:57
050 Parvis Jules Ferry - Gare Saint-Roch,2,6,8,2022,01-19,14:57
051 Pont de Lattes - Gare Saint-Roch,2,10,12,2022,01-19,14:57
053 Deux Ponts - Gare Saint-Roch,1,7,8,2022,01-19,14:57
054 Providence - Ovalie,3,5,8,2022,01-19,14:57
055 P�rols Etang de l'Or,22,46,68,2022,01-19,14:57
056 Albert 1er - Cath�drale,6,6,12,2022,01-19,14:57
057 Saint-Guilhem - Courreau,1,7,8,2022,01-19,14:57
059 Sud De France,0,8,8,2022,01-19,14:57
001 Rue Jules Ferry - Gare Saint-Roch,4,8,12,2022,01-19,15:07
002 Com�die,12,12,24,2022,01-19,15:07
003 Esplanade,16,16,32,2022,01-19,15:07
004 H�tel de Ville,7,9,16,2022,01-19,15:07
005 Corum,8,4,12,2022,01-19,15:07
006 Place Albert 1er - St Charles,19,12,31,2022,01-19,15:07
007 Foch,6,2,8,2022,01-19,15:07
008 Halles Castellane,6,6,12,2022,01-19,15:07
009 Observatoire,6,2,8,2022,01-19,15:07
010 Rondelet,3,13,16,2022,01-19,15:07
011 Plan Cabanes,5,7,12,2022,01-19,15:07
012 Boutonnet,9,3,12,2022,01-19,15:07
013 Emile Combes,1,7,8,2022,01-19,15:07
014 Beaux-Arts,4,4,8,2022,01-19,15:07
015 Les Aubes,6,2,8,2022,01-19,15:07
016 Antigone centre,14,2,16,2022,01-19,15:07
017 M�diath�que Emile Zola,14,2,16,2022,01-19,15:07
018 Nombre d'Or,4,12,16,2022,01-19,15:07
019 Louis Blanc,13,3,16,2022,01-19,15:07
020 Gambetta,4,4,8,2022,01-19,15:07
021 Port Marianne,7,9,16,2022,01-19,15:07
022 Clemenceau,2,10,12,2022,01-19,15:07
023 Les Arceaux,2,14,16,2022,01-19,15:07
024 Cit� Mion,2,6,8,2022,01-19,15:07
025 Nouveau Saint-Roch,1,7,8,2022,01-19,15:07
026 Renouvier,3,5,8,2022,01-19,15:07
027 Odysseum,4,4,8,2022,01-19,15:07
028 Saint-Denis,4,4,8,2022,01-19,15:07
029 Richter,11,5,16,2022,01-19,15:07
030 Charles Flahault,4,4,8,2022,01-19,15:07
031 Voltaire,1,7,8,2022,01-19,15:07
032 Pr�s d'Ar�nes,8,0,8,2022,01-19,15:07
033 Garcia Lorca,5,3,8,2022,01-19,15:07
034 Vert Bois,0,16,16,2022,01-19,15:07
035 Malbosc,1,7,8,2022,01-19,15:07
036 Occitanie,7,25,32,2022,01-19,15:07
037 FacdesSciences,13,11,24,2022,01-19,15:07
038 Fac de Lettres,0,16,16,2022,01-19,15:07
039 Aiguelongue,1,7,8,2022,01-19,15:07
040 Jeu de Mail des Abb�s,4,4,8,2022,01-19,15:07
041 Eurom�decine,0,8,8,2022,01-19,15:07
042 Marie Caizergues,6,2,8,2022,01-19,15:07
043 Sabines,4,4,8,2022,01-19,15:07
044 Celleneuve,0,8,8,2022,01-19,15:07
045 Jardin de la Lironde,2,6,8,2022,01-19,15:07
046 P�re Soulas,3,5,8,2022,01-19,15:07
047 Place Viala,2,6,8,2022,01-19,15:07
048 H�tel du D�partement,0,8,8,2022,01-19,15:07
049 Tonnelles,4,4,8,2022,01-19,15:07
050 Parvis Jules Ferry - Gare Saint-Roch,2,6,8,2022,01-19,15:07
051 Pont de Lattes - Gare Saint-Roch,2,10,12,2022,01-19,15:07
053 Deux Ponts - Gare Saint-Roch,1,7,8,2022,01-19,15:07
054 Providence - Ovalie,3,5,8,2022,01-19,15:07
055 P�rols Etang de l'Or,22,46,68,2022,01-19,15:07
056 Albert 1er - Cath�drale,6,6,12,2022,01-19,15:07
057 Saint-Guilhem - Courreau,1,7,8,2022,01-19,15:07
059 Sud De France,0,8,8,2022,01-19,15:07
001 Rue Jules Ferry - Gare Saint-Roch,4,8,12,2022,01-19,15:17
002 Com�die,12,12,24,2022,01-19,15:17
003 Esplanade,16,16,32,2022,01-19,15:17
004 H�tel de Ville,7,9,16,2022,01-19,15:17
005 Corum,8,4,12,2022,01-19,15:17
006 Place Albert 1er - St Charles,20,11,31,2022,01-19,15:17
007 Foch,6,2,8,2022,01-19,15:17
008 Halles Castellane,5,7,12,2022,01-19,15:17
009 Observatoire,6,2,8,2022,01-19,15:17
010 Rondelet,3,13,16,2022,01-19,15:17
011 Plan Cabanes,5,7,12,2022,01-19,15:17
012 Boutonnet,9,3,12,2022,01-19,15:17
013 Emile Combes,1,7,8,2022,01-19,15:17
014 Beaux-Arts,4,4,8,2022,01-19,15:17
015 Les Aubes,6,2,8,2022,01-19,15:17
016 Antigone centre,13,3,16,2022,01-19,15:17
017 M�diath�que Emile Zola,14,2,16,2022,01-19,15:17
018 Nombre d'Or,4,12,16,2022,01-19,15:17
019 Louis Blanc,13,3,16,2022,01-19,15:17
020 Gambetta,3,5,8,2022,01-19,15:17
021 Port Marianne,7,9,16,2022,01-19,15:17
022 Clemenceau,2,10,12,2022,01-19,15:17
023 Les Arceaux,2,14,16,2022,01-19,15:17
024 Cit� Mion,2,6,8,2022,01-19,15:17
025 Nouveau Saint-Roch,1,7,8,2022,01-19,15:17
026 Renouvier,3,5,8,2022,01-19,15:17
027 Odysseum,4,4,8,2022,01-19,15:17
028 Saint-Denis,4,4,8,2022,01-19,15:17
029 Richter,12,4,16,2022,01-19,15:17
030 Charles Flahault,4,4,8,2022,01-19,15:17
031 Voltaire,1,7,8,2022,01-19,15:17
032 Pr�s d'Ar�nes,8,0,8,2022,01-19,15:17
033 Garcia Lorca,5,3,8,2022,01-19,15:17
034 Vert Bois,0,16,16,2022,01-19,15:17
035 Malbosc,1,7,8,2022,01-19,15:17
036 Occitanie,7,25,32,2022,01-19,15:17
037 FacdesSciences,11,13,24,2022,01-19,15:17
038 Fac de Lettres,0,16,16,2022,01-19,15:17
039 Aiguelongue,1,7,8,2022,01-19,15:17
040 Jeu de Mail des Abb�s,4,4,8,2022,01-19,15:17
041 Eurom�decine,0,8,8,2022,01-19,15:17
042 Marie Caizergues,6,2,8,2022,01-19,15:17
043 Sabines,4,4,8,2022,01-19,15:17
044 Celleneuve,0,8,8,2022,01-19,15:17
045 Jardin de la Lironde,2,6,8,2022,01-19,15:17
046 P�re Soulas,3,5,8,2022,01-19,15:17
047 Place Viala,3,5,8,2022,01-19,15:17
048 H�tel du D�partement,0,8,8,2022,01-19,15:17
049 Tonnelles,4,4,8,2022,01-19,15:17
050 Parvis Jules Ferry - Gare Saint-Roch,2,6,8,2022,01-19,15:17
051 Pont de Lattes - Gare Saint-Roch,2,10,12,2022,01-19,15:17
053 Deux Ponts - Gare Saint-Roch,1,7,8,2022,01-19,15:17
054 Providence - Ovalie,3,5,8,2022,01-19,15:17
055 P�rols Etang de l'Or,22,46,68,2022,01-19,15:17
056 Albert 1er - Cath�drale,6,6,12,2022,01-19,15:17
057 Saint-Guilhem - Courreau,1,7,8,2022,01-19,15:17
059 Sud De France,0,8,8,2022,01-19,15:17
001 Rue Jules Ferry - Gare Saint-Roch,3,9,12,2022,01-19,15:27
002 Com�die,12,12,24,2022,01-19,15:27
003 Esplanade,16,16,32,2022,01-19,15:27
004 H�tel de Ville,7,9,16,2022,01-19,15:27
005 Corum,8,4,12,2022,01-19,15:27
006 Place Albert 1er - St Charles,20,11,31,2022,01-19,15:27
007 Foch,6,2,8,2022,01-19,15:27
008 Halles Castellane,5,7,12,2022,01-19,15:27
009 Observatoire,7,1,8,2022,01-19,15:27
010 Rondelet,3,13,16,2022,01-19,15:27
011 Plan Cabanes,5,7,12,2022,01-19,15:27
012 Boutonnet,9,3,12,2022,01-19,15:27
013 Emile Combes,1,7,8,2022,01-19,15:27
014 Beaux-Arts,4,4,8,2022,01-19,15:27
015 Les Aubes,6,2,8,2022,01-19,15:27
016 Antigone centre,13,3,16,2022,01-19,15:27
017 M�diath�que Emile Zola,16,0,16,2022,01-19,15:27
018 Nombre d'Or,4,12,16,2022,01-19,15:27
019 Louis Blanc,13,3,16,2022,01-19,15:27
020 Gambetta,3,5,8,2022,01-19,15:27
021 Port Marianne,7,9,16,2022,01-19,15:27
022 Clemenceau,2,10,12,2022,01-19,15:27
023 Les Arceaux,2,14,16,2022,01-19,15:27
024 Cit� Mion,3,5,8,2022,01-19,15:27
025 Nouveau Saint-Roch,1,7,8,2022,01-19,15:27
026 Renouvier,3,5,8,2022,01-19,15:27
027 Odysseum,4,4,8,2022,01-19,15:27
028 Saint-Denis,4,4,8,2022,01-19,15:27
029 Richter,12,4,16,2022,01-19,15:27
030 Charles Flahault,4,4,8,2022,01-19,15:27
031 Voltaire,1,7,8,2022,01-19,15:27
032 Pr�s d'Ar�nes,8,0,8,2022,01-19,15:27
033 Garcia Lorca,5,3,8,2022,01-19,15:27
034 Vert Bois,0,16,16,2022,01-19,15:27
035 Malbosc,1,7,8,2022,01-19,15:27
036 Occitanie,6,26,32,2022,01-19,15:27
037 FacdesSciences,11,13,24,2022,01-19,15:27
038 Fac de Lettres,0,16,16,2022,01-19,15:27
039 Aiguelongue,1,7,8,2022,01-19,15:27
040 Jeu de Mail des Abb�s,4,4,8,2022,01-19,15:27
041 Eurom�decine,0,8,8,2022,01-19,15:27
042 Marie Caizergues,6,2,8,2022,01-19,15:27
043 Sabines,4,4,8,2022,01-19,15:27
044 Celleneuve,0,8,8,2022,01-19,15:27
045 Jardin de la Lironde,2,6,8,2022,01-19,15:27
046 P�re Soulas,3,5,8,2022,01-19,15:27
047 Place Viala,3,5,8,2022,01-19,15:27
048 H�tel du D�partement,0,8,8,2022,01-19,15:27
049 Tonnelles,4,4,8,2022,01-19,15:27
050 Parvis Jules Ferry - Gare Saint-Roch,2,6,8,2022,01-19,15:27
051 Pont de Lattes - Gare Saint-Roch,2,10,12,2022,01-19,15:27
053 Deux Ponts - Gare Saint-Roch,1,7,8,2022,01-19,15:27
054 Providence - Ovalie,3,5,8,2022,01-19,15:27
055 P�rols Etang de l'Or,21,47,68,2022,01-19,15:27
056 Albert 1er - Cath�drale,6,6,12,2022,01-19,15:27
057 Saint-Guilhem - Courreau,1,7,8,2022,01-19,15:27
059 Sud De France,0,8,8,2022,01-19,15:27
001 Rue Jules Ferry - Gare Saint-Roch,3,9,12,2022,01-19,15:38
002 Com�die,12,12,24,2022,01-19,15:38
003 Esplanade,16,16,32,2022,01-19,15:38
004 H�tel de Ville,7,9,16,2022,01-19,15:38
005 Corum,8,4,12,2022,01-19,15:38
006 Place Albert 1er - St Charles,20,11,31,2022,01-19,15:38
007 Foch,6,2,8,2022,01-19,15:38
008 Halles Castellane,5,7,12,2022,01-19,15:38
009 Observatoire,7,1,8,2022,01-19,15:38
010 Rondelet,3,13,16,2022,01-19,15:38
011 Plan Cabanes,5,7,12,2022,01-19,15:38
012 Boutonnet,9,3,12,2022,01-19,15:38
013 Emile Combes,1,7,8,2022,01-19,15:38
014 Beaux-Arts,4,4,8,2022,01-19,15:38
015 Les Aubes,6,2,8,2022,01-19,15:38
016 Antigone centre,13,3,16,2022,01-19,15:38
017 M�diath�que Emile Zola,16,0,16,2022,01-19,15:38
018 Nombre d'Or,4,12,16,2022,01-19,15:38
019 Louis Blanc,13,3,16,2022,01-19,15:38
020 Gambetta,3,5,8,2022,01-19,15:38
021 Port Marianne,7,9,16,2022,01-19,15:38
022 Clemenceau,2,10,12,2022,01-19,15:38
023 Les Arceaux,2,14,16,2022,01-19,15:38
024 Cit� Mion,3,5,8,2022,01-19,15:38
025 Nouveau Saint-Roch,1,7,8,2022,01-19,15:38
026 Renouvier,3,5,8,2022,01-19,15:38
027 Odysseum,3,5,8,2022,01-19,15:38
028 Saint-Denis,4,4,8,2022,01-19,15:38
029 Richter,12,4,16,2022,01-19,15:38
030 Charles Flahault,4,4,8,2022,01-19,15:38
031 Voltaire,1,7,8,2022,01-19,15:38
032 Pr�s d'Ar�nes,8,0,8,2022,01-19,15:38
033 Garcia Lorca,5,3,8,2022,01-19,15:38
034 Vert Bois,0,16,16,2022,01-19,15:38
035 Malbosc,1,7,8,2022,01-19,15:38
036 Occitanie,5,27,32,2022,01-19,15:38
037 FacdesSciences,11,13,24,2022,01-19,15:38
038 Fac de Lettres,0,16,16,2022,01-19,15:38
039 Aiguelongue,1,7,8,2022,01-19,15:38
040 Jeu de Mail des Abb�s,4,4,8,2022,01-19,15:38
041 Eurom�decine,0,8,8,2022,01-19,15:38
042 Marie Caizergues,5,3,8,2022,01-19,15:38
043 Sabines,4,4,8,2022,01-19,15:38
044 Celleneuve,0,8,8,2022,01-19,15:38
045 Jardin de la Lironde,2,6,8,2022,01-19,15:38
046 P�re Soulas,3,5,8,2022,01-19,15:38
047 Place Viala,3,5,8,2022,01-19,15:38
048 H�tel du D�partement,0,8,8,2022,01-19,15:38
049 Tonnelles,3,5,8,2022,01-19,15:38
050 Parvis Jules Ferry - Gare Saint-Roch,2,6,8,2022,01-19,15:38
051 Pont de Lattes - Gare Saint-Roch,2,10,12,2022,01-19,15:38
053 Deux Ponts - Gare Saint-Roch,1,7,8,2022,01-19,15:38
054 Providence - Ovalie,3,5,8,2022,01-19,15:38
055 P�rols Etang de l'Or,20,48,68,2022,01-19,15:38
056 Albert 1er - Cath�drale,6,6,12,2022,01-19,15:38
057 Saint-Guilhem - Courreau,1,7,8,2022,01-19,15:38
059 Sud De France,0,8,8,2022,01-19,15:38
001 Rue Jules Ferry - Gare Saint-Roch,4,8,12,2022,01-19,15:48
002 Com�die,12,12,24,2022,01-19,15:48
003 Esplanade,16,16,32,2022,01-19,15:48
004 H�tel de Ville,7,9,16,2022,01-19,15:48
005 Corum,7,5,12,2022,01-19,15:48
006 Place Albert 1er - St Charles,20,11,31,2022,01-19,15:48
007 Foch,6,2,8,2022,01-19,15:48
008 Halles Castellane,5,7,12,2022,01-19,15:48
009 Observatoire,7,1,8,2022,01-19,15:48
010 Rondelet,3,13,16,2022,01-19,15:48
011 Plan Cabanes,5,7,12,2022,01-19,15:48
012 Boutonnet,8,4,12,2022,01-19,15:48
013 Emile Combes,1,7,8,2022,01-19,15:48
014 Beaux-Arts,4,4,8,2022,01-19,15:48
015 Les Aubes,6,2,8,2022,01-19,15:48
016 Antigone centre,13,3,16,2022,01-19,15:48
017 M�diath�que Emile Zola,16,0,16,2022,01-19,15:48
018 Nombre d'Or,5,11,16,2022,01-19,15:48
019 Louis Blanc,16,0,16,2022,01-19,15:48
020 Gambetta,3,5,8,2022,01-19,15:48
021 Port Marianne,7,9,16,2022,01-19,15:48
022 Clemenceau,2,10,12,2022,01-19,15:48
023 Les Arceaux,2,14,16,2022,01-19,15:48
024 Cit� Mion,3,5,8,2022,01-19,15:48
025 Nouveau Saint-Roch,1,7,8,2022,01-19,15:48
026 Renouvier,3,5,8,2022,01-19,15:48
027 Odysseum,3,5,8,2022,01-19,15:48
028 Saint-Denis,4,4,8,2022,01-19,15:48
029 Richter,12,4,16,2022,01-19,15:48
030 Charles Flahault,4,4,8,2022,01-19,15:48
031 Voltaire,1,7,8,2022,01-19,15:48
032 Pr�s d'Ar�nes,8,0,8,2022,01-19,15:48
033 Garcia Lorca,5,3,8,2022,01-19,15:48
034 Vert Bois,0,16,16,2022,01-19,15:48
035 Malbosc,1,7,8,2022,01-19,15:48
036 Occitanie,5,27,32,2022,01-19,15:48
037 FacdesSciences,11,13,24,2022,01-19,15:48
038 Fac de Lettres,0,16,16,2022,01-19,15:48
039 Aiguelongue,1,7,8,2022,01-19,15:48
040 Jeu de Mail des Abb�s,2,6,8,2022,01-19,15:48
041 Eurom�decine,0,8,8,2022,01-19,15:48
042 Marie Caizergues,5,3,8,2022,01-19,15:48
043 Sabines,4,4,8,2022,01-19,15:48
044 Celleneuve,0,8,8,2022,01-19,15:48
045 Jardin de la Lironde,2,6,8,2022,01-19,15:48
046 P�re Soulas,3,5,8,2022,01-19,15:48
047 Place Viala,3,5,8,2022,01-19,15:48
048 H�tel du D�partement,0,8,8,2022,01-19,15:48
049 Tonnelles,4,4,8,2022,01-19,15:48
050 Parvis Jules Ferry - Gare Saint-Roch,2,6,8,2022,01-19,15:48
051 Pont de Lattes - Gare Saint-Roch,2,10,12,2022,01-19,15:48
053 Deux Ponts - Gare Saint-Roch,1,7,8,2022,01-19,15:48
054 Providence - Ovalie,3,5,8,2022,01-19,15:48
055 P�rols Etang de l'Or,20,48,68,2022,01-19,15:48
056 Albert 1er - Cath�drale,7,5,12,2022,01-19,15:48
057 Saint-Guilhem - Courreau,1,7,8,2022,01-19,15:48
059 Sud De France,0,8,8,2022,01-19,15:48
001 Rue Jules Ferry - Gare Saint-Roch,4,8,12,2022,01-19,15:58
002 Com�die,12,12,24,2022,01-19,15:58
003 Esplanade,16,16,32,2022,01-19,15:58
004 H�tel de Ville,7,9,16,2022,01-19,15:58
005 Corum,2,10,12,2022,01-19,15:58
006 Place Albert 1er - St Charles,20,11,31,2022,01-19,15:58
007 Foch,6,2,8,2022,01-19,15:58
008 Halles Castellane,6,6,12,2022,01-19,15:58
009 Observatoire,7,1,8,2022,01-19,15:58
010 Rondelet,3,13,16,2022,01-19,15:58
011 Plan Cabanes,5,7,12,2022,01-19,15:58
012 Boutonnet,8,4,12,2022,01-19,15:58
013 Emile Combes,1,7,8,2022,01-19,15:58
014 Beaux-Arts,4,4,8,2022,01-19,15:58
015 Les Aubes,6,2,8,2022,01-19,15:58
016 Antigone centre,14,2,16,2022,01-19,15:58
017 M�diath�que Emile Zola,16,0,16,2022,01-19,15:58
018 Nombre d'Or,5,11,16,2022,01-19,15:58
019 Louis Blanc,15,1,16,2022,01-19,15:58
020 Gambetta,3,5,8,2022,01-19,15:58
021 Port Marianne,7,9,16,2022,01-19,15:58
022 Clemenceau,2,10,12,2022,01-19,15:58
023 Les Arceaux,2,14,16,2022,01-19,15:58
024 Cit� Mion,3,5,8,2022,01-19,15:58
025 Nouveau Saint-Roch,1,7,8,2022,01-19,15:58
026 Renouvier,3,5,8,2022,01-19,15:58
027 Odysseum,3,5,8,2022,01-19,15:58
028 Saint-Denis,4,4,8,2022,01-19,15:58
029 Richter,12,4,16,2022,01-19,15:58
030 Charles Flahault,4,4,8,2022,01-19,15:58
031 Voltaire,1,7,8,2022,01-19,15:58
032 Pr�s d'Ar�nes,8,0,8,2022,01-19,15:58
033 Garcia Lorca,5,3,8,2022,01-19,15:58
034 Vert Bois,0,16,16,2022,01-19,15:58
035 Malbosc,1,7,8,2022,01-19,15:58
036 Occitanie,5,27,32,2022,01-19,15:58
037 FacdesSciences,10,14,24,2022,01-19,15:58
038 Fac de Lettres,0,16,16,2022,01-19,15:58
039 Aiguelongue,1,7,8,2022,01-19,15:58
040 Jeu de Mail des Abb�s,2,6,8,2022,01-19,15:58
041 Eurom�decine,0,8,8,2022,01-19,15:58
042 Marie Caizergues,5,3,8,2022,01-19,15:58
043 Sabines,4,4,8,2022,01-19,15:58
044 Celleneuve,0,8,8,2022,01-19,15:58
045 Jardin de la Lironde,2,6,8,2022,01-19,15:58
046 P�re Soulas,3,5,8,2022,01-19,15:58
047 Place Viala,3,5,8,2022,01-19,15:58
048 H�tel du D�partement,0,8,8,2022,01-19,15:58
049 Tonnelles,4,4,8,2022,01-19,15:58
050 Parvis Jules Ferry - Gare Saint-Roch,2,6,8,2022,01-19,15:58
051 Pont de Lattes - Gare Saint-Roch,2,10,12,2022,01-19,15:58
053 Deux Ponts - Gare Saint-Roch,1,7,8,2022,01-19,15:58
054 Providence - Ovalie,3,5,8,2022,01-19,15:58
055 P�rols Etang de l'Or,20,48,68,2022,01-19,15:58
056 Albert 1er - Cath�drale,7,5,12,2022,01-19,15:58
057 Saint-Guilhem - Courreau,1,7,8,2022,01-19,15:58
059 Sud De France,0,8,8,2022,01-19,15:58
001 Rue Jules Ferry - Gare Saint-Roch,4,8,12,2022,01-19,16:08
002 Com�die,11,13,24,2022,01-19,16:08
003 Esplanade,14,18,32,2022,01-19,16:08
004 H�tel de Ville,7,9,16,2022,01-19,16:08
005 Corum,2,10,12,2022,01-19,16:08
006 Place Albert 1er - St Charles,20,11,31,2022,01-19,16:08
007 Foch,6,2,8,2022,01-19,16:08
008 Halles Castellane,6,6,12,2022,01-19,16:08
009 Observatoire,7,1,8,2022,01-19,16:08
010 Rondelet,3,13,16,2022,01-19,16:08
011 Plan Cabanes,5,7,12,2022,01-19,16:08
012 Boutonnet,8,4,12,2022,01-19,16:08
013 Emile Combes,1,7,8,2022,01-19,16:08
014 Beaux-Arts,4,4,8,2022,01-19,16:08
015 Les Aubes,6,2,8,2022,01-19,16:08
016 Antigone centre,14,2,16,2022,01-19,16:08
017 M�diath�que Emile Zola,16,0,16,2022,01-19,16:08
018 Nombre d'Or,5,11,16,2022,01-19,16:08
019 Louis Blanc,15,1,16,2022,01-19,16:08
020 Gambetta,3,5,8,2022,01-19,16:08
021 Port Marianne,7,9,16,2022,01-19,16:08
022 Clemenceau,2,10,12,2022,01-19,16:08
023 Les Arceaux,2,14,16,2022,01-19,16:08
024 Cit� Mion,3,5,8,2022,01-19,16:08
025 Nouveau Saint-Roch,1,7,8,2022,01-19,16:08
026 Renouvier,3,5,8,2022,01-19,16:08
027 Odysseum,3,5,8,2022,01-19,16:08
028 Saint-Denis,4,4,8,2022,01-19,16:08
029 Richter,12,4,16,2022,01-19,16:08
030 Charles Flahault,4,4,8,2022,01-19,16:08
031 Voltaire,1,7,8,2022,01-19,16:08
032 Pr�s d'Ar�nes,8,0,8,2022,01-19,16:08
033 Garcia Lorca,5,3,8,2022,01-19,16:08
034 Vert Bois,0,16,16,2022,01-19,16:08
035 Malbosc,1,7,8,2022,01-19,16:08
036 Occitanie,4,28,32,2022,01-19,16:08
037 FacdesSciences,10,14,24,2022,01-19,16:08
038 Fac de Lettres,0,16,16,2022,01-19,16:08
039 Aiguelongue,1,7,8,2022,01-19,16:08
040 Jeu de Mail des Abb�s,2,6,8,2022,01-19,16:08
041 Eurom�decine,0,8,8,2022,01-19,16:08
042 Marie Caizergues,5,3,8,2022,01-19,16:08
043 Sabines,4,4,8,2022,01-19,16:08
044 Celleneuve,0,8,8,2022,01-19,16:08
045 Jardin de la Lironde,2,6,8,2022,01-19,16:08
046 P�re Soulas,3,5,8,2022,01-19,16:08
047 Place Viala,3,5,8,2022,01-19,16:08
048 H�tel du D�partement,0,8,8,2022,01-19,16:08
049 Tonnelles,4,4,8,2022,01-19,16:08
050 Parvis Jules Ferry - Gare Saint-Roch,2,6,8,2022,01-19,16:08
051 Pont de Lattes - Gare Saint-Roch,2,10,12,2022,01-19,16:08
053 Deux Ponts - Gare Saint-Roch,1,7,8,2022,01-19,16:08
054 Providence - Ovalie,3,5,8,2022,01-19,16:08
055 P�rols Etang de l'Or,22,46,68,2022,01-19,16:08
056 Albert 1er - Cath�drale,7,5,12,2022,01-19,16:08
057 Saint-Guilhem - Courreau,1,7,8,2022,01-19,16:08
059 Sud De France,0,8,8,2022,01-19,16:08
001 Rue Jules Ferry - Gare Saint-Roch,5,7,12,2022,01-19,16:18
002 Com�die,12,12,24,2022,01-19,16:18
003 Esplanade,14,18,32,2022,01-19,16:18
004 H�tel de Ville,7,9,16,2022,01-19,16:18
005 Corum,2,10,12,2022,01-19,16:18
006 Place Albert 1er - St Charles,21,10,31,2022,01-19,16:18
007 Foch,6,2,8,2022,01-19,16:18
008 Halles Castellane,6,6,12,2022,01-19,16:18
009 Observatoire,7,1,8,2022,01-19,16:18
010 Rondelet,3,13,16,2022,01-19,16:18
011 Plan Cabanes,4,8,12,2022,01-19,16:18
012 Boutonnet,7,5,12,2022,01-19,16:18
013 Emile Combes,1,7,8,2022,01-19,16:18
014 Beaux-Arts,3,5,8,2022,01-19,16:18
015 Les Aubes,6,2,8,2022,01-19,16:18
016 Antigone centre,15,1,16,2022,01-19,16:18
017 M�diath�que Emile Zola,16,0,16,2022,01-19,16:18
018 Nombre d'Or,5,11,16,2022,01-19,16:18
019 Louis Blanc,15,1,16,2022,01-19,16:18
020 Gambetta,3,5,8,2022,01-19,16:18
021 Port Marianne,7,9,16,2022,01-19,16:18
022 Clemenceau,2,10,12,2022,01-19,16:18
023 Les Arceaux,2,14,16,2022,01-19,16:18
024 Cit� Mion,3,5,8,2022,01-19,16:18
025 Nouveau Saint-Roch,1,7,8,2022,01-19,16:18
026 Renouvier,3,5,8,2022,01-19,16:18
027 Odysseum,3,5,8,2022,01-19,16:18
028 Saint-Denis,4,4,8,2022,01-19,16:18
029 Richter,10,6,16,2022,01-19,16:18
030 Charles Flahault,3,5,8,2022,01-19,16:18
031 Voltaire,1,7,8,2022,01-19,16:18
032 Pr�s d'Ar�nes,8,0,8,2022,01-19,16:18
033 Garcia Lorca,5,3,8,2022,01-19,16:18
034 Vert Bois,0,16,16,2022,01-19,16:18
035 Malbosc,1,7,8,2022,01-19,16:18
036 Occitanie,4,28,32,2022,01-19,16:18
037 FacdesSciences,10,14,24,2022,01-19,16:18
038 Fac de Lettres,0,16,16,2022,01-19,16:18
039 Aiguelongue,1,7,8,2022,01-19,16:18
040 Jeu de Mail des Abb�s,2,6,8,2022,01-19,16:18
041 Eurom�decine,0,8,8,2022,01-19,16:18
042 Marie Caizergues,5,3,8,2022,01-19,16:18
043 Sabines,4,4,8,2022,01-19,16:18
044 Celleneuve,0,8,8,2022,01-19,16:18
045 Jardin de la Lironde,1,7,8,2022,01-19,16:18
046 P�re Soulas,3,5,8,2022,01-19,16:18
047 Place Viala,2,6,8,2022,01-19,16:18
048 H�tel du D�partement,0,8,8,2022,01-19,16:18
049 Tonnelles,4,4,8,2022,01-19,16:18
050 Parvis Jules Ferry - Gare Saint-Roch,3,5,8,2022,01-19,16:18
051 Pont de Lattes - Gare Saint-Roch,2,10,12,2022,01-19,16:18
053 Deux Ponts - Gare Saint-Roch,1,7,8,2022,01-19,16:18
054 Providence - Ovalie,4,4,8,2022,01-19,16:18
055 P�rols Etang de l'Or,20,48,68,2022,01-19,16:18
056 Albert 1er - Cath�drale,7,5,12,2022,01-19,16:18
057 Saint-Guilhem - Courreau,0,8,8,2022,01-19,16:18
059 Sud De France,0,8,8,2022,01-19,16:18
001 Rue Jules Ferry - Gare Saint-Roch,5,7,12,2022,01-19,16:28
002 Com�die,12,12,24,2022,01-19,16:28
003 Esplanade,14,18,32,2022,01-19,16:28
004 H�tel de Ville,7,9,16,2022,01-19,16:28
005 Corum,4,8,12,2022,01-19,16:28
006 Place Albert 1er - St Charles,21,10,31,2022,01-19,16:28
007 Foch,6,2,8,2022,01-19,16:28
008 Halles Castellane,6,6,12,2022,01-19,16:28
009 Observatoire,7,1,8,2022,01-19,16:28
010 Rondelet,4,12,16,2022,01-19,16:28
011 Plan Cabanes,5,7,12,2022,01-19,16:28
012 Boutonnet,7,5,12,2022,01-19,16:28
013 Emile Combes,1,7,8,2022,01-19,16:28
014 Beaux-Arts,3,5,8,2022,01-19,16:28
015 Les Aubes,6,2,8,2022,01-19,16:28
016 Antigone centre,15,1,16,2022,01-19,16:28
017 M�diath�que Emile Zola,16,0,16,2022,01-19,16:28
018 Nombre d'Or,6,10,16,2022,01-19,16:28
019 Louis Blanc,13,3,16,2022,01-19,16:28
020 Gambetta,3,5,8,2022,01-19,16:28
021 Port Marianne,6,10,16,2022,01-19,16:28
022 Clemenceau,2,10,12,2022,01-19,16:28
023 Les Arceaux,2,14,16,2022,01-19,16:28
024 Cit� Mion,3,5,8,2022,01-19,16:28
025 Nouveau Saint-Roch,1,7,8,2022,01-19,16:28
026 Renouvier,4,4,8,2022,01-19,16:28
027 Odysseum,3,5,8,2022,01-19,16:28
028 Saint-Denis,4,4,8,2022,01-19,16:28
029 Richter,10,6,16,2022,01-19,16:28
030 Charles Flahault,3,5,8,2022,01-19,16:28
031 Voltaire,1,7,8,2022,01-19,16:28
032 Pr�s d'Ar�nes,8,0,8,2022,01-19,16:28
033 Garcia Lorca,5,3,8,2022,01-19,16:28
034 Vert Bois,0,16,16,2022,01-19,16:28
035 Malbosc,2,6,8,2022,01-19,16:28
036 Occitanie,4,28,32,2022,01-19,16:28
037 FacdesSciences,10,14,24,2022,01-19,16:28
038 Fac de Lettres,0,16,16,2022,01-19,16:28
039 Aiguelongue,1,7,8,2022,01-19,16:28
040 Jeu de Mail des Abb�s,3,5,8,2022,01-19,16:28
041 Eurom�decine,0,8,8,2022,01-19,16:28
042 Marie Caizergues,4,4,8,2022,01-19,16:28
043 Sabines,4,4,8,2022,01-19,16:28
044 Celleneuve,0,8,8,2022,01-19,16:28
045 Jardin de la Lironde,1,7,8,2022,01-19,16:28
046 P�re Soulas,3,5,8,2022,01-19,16:28
047 Place Viala,1,7,8,2022,01-19,16:28
048 H�tel du D�partement,0,8,8,2022,01-19,16:28
049 Tonnelles,4,4,8,2022,01-19,16:28
050 Parvis Jules Ferry - Gare Saint-Roch,3,5,8,2022,01-19,16:28
051 Pont de Lattes - Gare Saint-Roch,2,10,12,2022,01-19,16:28
053 Deux Ponts - Gare Saint-Roch,1,7,8,2022,01-19,16:28
054 Providence - Ovalie,4,4,8,2022,01-19,16:28
055 P�rols Etang de l'Or,20,48,68,2022,01-19,16:28
056 Albert 1er - Cath�drale,7,5,12,2022,01-19,16:28
057 Saint-Guilhem - Courreau,0,8,8,2022,01-19,16:28
059 Sud De France,0,8,8,2022,01-19,16:28
001 Rue Jules Ferry - Gare Saint-Roch,5,7,12,2022,01-19,16:39
002 Com�die,12,12,24,2022,01-19,16:39
003 Esplanade,14,18,32,2022,01-19,16:39
004 H�tel de Ville,7,9,16,2022,01-19,16:39
005 Corum,4,8,12,2022,01-19,16:39
006 Place Albert 1er - St Charles,21,10,31,2022,01-19,16:39
007 Foch,6,2,8,2022,01-19,16:39
008 Halles Castellane,5,7,12,2022,01-19,16:39
009 Observatoire,7,1,8,2022,01-19,16:39
010 Rondelet,4,12,16,2022,01-19,16:39
011 Plan Cabanes,5,7,12,2022,01-19,16:39
012 Boutonnet,7,5,12,2022,01-19,16:39
013 Emile Combes,1,7,8,2022,01-19,16:39
014 Beaux-Arts,3,5,8,2022,01-19,16:39
015 Les Aubes,6,2,8,2022,01-19,16:39
016 Antigone centre,15,1,16,2022,01-19,16:39
017 M�diath�que Emile Zola,16,0,16,2022,01-19,16:39
018 Nombre d'Or,6,10,16,2022,01-19,16:39
019 Louis Blanc,14,2,16,2022,01-19,16:39
020 Gambetta,3,5,8,2022,01-19,16:39
021 Port Marianne,6,10,16,2022,01-19,16:39
022 Clemenceau,2,10,12,2022,01-19,16:39
023 Les Arceaux,2,14,16,2022,01-19,16:39
024 Cit� Mion,3,5,8,2022,01-19,16:39
025 Nouveau Saint-Roch,1,7,8,2022,01-19,16:39
026 Renouvier,4,4,8,2022,01-19,16:39
027 Odysseum,3,5,8,2022,01-19,16:39
028 Saint-Denis,4,4,8,2022,01-19,16:39
029 Richter,10,6,16,2022,01-19,16:39
030 Charles Flahault,3,5,8,2022,01-19,16:39
031 Voltaire,1,7,8,2022,01-19,16:39
032 Pr�s d'Ar�nes,7,1,8,2022,01-19,16:39
033 Garcia Lorca,5,3,8,2022,01-19,16:39
034 Vert Bois,0,16,16,2022,01-19,16:39
035 Malbosc,2,6,8,2022,01-19,16:39
036 Occitanie,3,29,32,2022,01-19,16:39
037 FacdesSciences,9,15,24,2022,01-19,16:39
038 Fac de Lettres,0,16,16,2022,01-19,16:39
039 Aiguelongue,1,7,8,2022,01-19,16:39
040 Jeu de Mail des Abb�s,4,4,8,2022,01-19,16:39
041 Eurom�decine,0,8,8,2022,01-19,16:39
042 Marie Caizergues,4,4,8,2022,01-19,16:39
043 Sabines,4,4,8,2022,01-19,16:39
044 Celleneuve,0,8,8,2022,01-19,16:39
045 Jardin de la Lironde,1,7,8,2022,01-19,16:39
046 P�re Soulas,3,5,8,2022,01-19,16:39
047 Place Viala,1,7,8,2022,01-19,16:39
048 H�tel du D�partement,0,8,8,2022,01-19,16:39
049 Tonnelles,4,4,8,2022,01-19,16:39
050 Parvis Jules Ferry - Gare Saint-Roch,3,5,8,2022,01-19,16:39
051 Pont de Lattes - Gare Saint-Roch,2,10,12,2022,01-19,16:39
053 Deux Ponts - Gare Saint-Roch,1,7,8,2022,01-19,16:39
054 Providence - Ovalie,4,4,8,2022,01-19,16:39
055 P�rols Etang de l'Or,20,48,68,2022,01-19,16:39
056 Albert 1er - Cath�drale,7,5,12,2022,01-19,16:39
057 Saint-Guilhem - Courreau,0,8,8,2022,01-19,16:39
059 Sud De France,0,8,8,2022,01-19,16:39
001 Rue Jules Ferry - Gare Saint-Roch,5,7,12,2022,01-19,16:49
002 Com�die,12,12,24,2022,01-19,16:49
003 Esplanade,16,16,32,2022,01-19,16:49
004 H�tel de Ville,7,9,16,2022,01-19,16:49
005 Corum,4,8,12,2022,01-19,16:49
006 Place Albert 1er - St Charles,19,12,31,2022,01-19,16:49
007 Foch,6,2,8,2022,01-19,16:49
008 Halles Castellane,5,7,12,2022,01-19,16:49
009 Observatoire,7,1,8,2022,01-19,16:49
010 Rondelet,4,12,16,2022,01-19,16:49
011 Plan Cabanes,5,7,12,2022,01-19,16:49
012 Boutonnet,7,5,12,2022,01-19,16:49
013 Emile Combes,1,7,8,2022,01-19,16:49
014 Beaux-Arts,3,5,8,2022,01-19,16:49
015 Les Aubes,6,2,8,2022,01-19,16:49
016 Antigone centre,15,1,16,2022,01-19,16:49
017 M�diath�que Emile Zola,16,0,16,2022,01-19,16:49
018 Nombre d'Or,6,10,16,2022,01-19,16:49
019 Louis Blanc,14,2,16,2022,01-19,16:49
020 Gambetta,3,5,8,2022,01-19,16:49
021 Port Marianne,6,10,16,2022,01-19,16:49
022 Clemenceau,2,10,12,2022,01-19,16:49
023 Les Arceaux,2,14,16,2022,01-19,16:49
024 Cit� Mion,3,5,8,2022,01-19,16:49
025 Nouveau Saint-Roch,1,7,8,2022,01-19,16:49
026 Renouvier,4,4,8,2022,01-19,16:49
027 Odysseum,3,5,8,2022,01-19,16:49
028 Saint-Denis,4,4,8,2022,01-19,16:49
029 Richter,10,6,16,2022,01-19,16:49
030 Charles Flahault,3,5,8,2022,01-19,16:49
031 Voltaire,1,7,8,2022,01-19,16:49
032 Pr�s d'Ar�nes,7,1,8,2022,01-19,16:49
033 Garcia Lorca,5,3,8,2022,01-19,16:49
034 Vert Bois,0,16,16,2022,01-19,16:49
035 Malbosc,2,6,8,2022,01-19,16:49
036 Occitanie,4,28,32,2022,01-19,16:49
037 FacdesSciences,8,16,24,2022,01-19,16:49
038 Fac de Lettres,0,16,16,2022,01-19,16:49
039 Aiguelongue,1,7,8,2022,01-19,16:49
040 Jeu de Mail des Abb�s,6,2,8,2022,01-19,16:49
041 Eurom�decine,0,8,8,2022,01-19,16:49
042 Marie Caizergues,4,4,8,2022,01-19,16:49
043 Sabines,4,4,8,2022,01-19,16:49
044 Celleneuve,0,8,8,2022,01-19,16:49
045 Jardin de la Lironde,1,7,8,2022,01-19,16:49
046 P�re Soulas,3,5,8,2022,01-19,16:49
047 Place Viala,1,7,8,2022,01-19,16:49
048 H�tel du D�partement,0,8,8,2022,01-19,16:49
049 Tonnelles,4,4,8,2022,01-19,16:49
050 Parvis Jules Ferry - Gare Saint-Roch,3,5,8,2022,01-19,16:49
051 Pont de Lattes - Gare Saint-Roch,2,10,12,2022,01-19,16:49
053 Deux Ponts - Gare Saint-Roch,1,7,8,2022,01-19,16:49
054 Providence - Ovalie,4,4,8,2022,01-19,16:49
055 P�rols Etang de l'Or,21,47,68,2022,01-19,16:49
056 Albert 1er - Cath�drale,7,5,12,2022,01-19,16:49
057 Saint-Guilhem - Courreau,0,8,8,2022,01-19,16:49
059 Sud De France,0,8,8,2022,01-19,16:49
001 Rue Jules Ferry - Gare Saint-Roch,5,7,12,2022,01-19,16:59
002 Com�die,12,12,24,2022,01-19,16:59
003 Esplanade,16,16,32,2022,01-19,16:59
004 H�tel de Ville,7,9,16,2022,01-19,16:59
005 Corum,4,8,12,2022,01-19,16:59
006 Place Albert 1er - St Charles,19,12,31,2022,01-19,16:59
007 Foch,6,2,8,2022,01-19,16:59
008 Halles Castellane,5,7,12,2022,01-19,16:59
009 Observatoire,7,1,8,2022,01-19,16:59
010 Rondelet,4,12,16,2022,01-19,16:59
011 Plan Cabanes,4,8,12,2022,01-19,16:59
012 Boutonnet,7,5,12,2022,01-19,16:59
013 Emile Combes,1,7,8,2022,01-19,16:59
014 Beaux-Arts,3,5,8,2022,01-19,16:59
015 Les Aubes,6,2,8,2022,01-19,16:59
016 Antigone centre,15,1,16,2022,01-19,16:59
017 M�diath�que Emile Zola,16,0,16,2022,01-19,16:59
018 Nombre d'Or,6,10,16,2022,01-19,16:59
019 Louis Blanc,14,2,16,2022,01-19,16:59
020 Gambetta,2,6,8,2022,01-19,16:59
021 Port Marianne,6,10,16,2022,01-19,16:59
022 Clemenceau,2,10,12,2022,01-19,16:59
023 Les Arceaux,2,14,16,2022,01-19,16:59
024 Cit� Mion,3,5,8,2022,01-19,16:59
025 Nouveau Saint-Roch,1,7,8,2022,01-19,16:59
026 Renouvier,4,4,8,2022,01-19,16:59
027 Odysseum,3,5,8,2022,01-19,16:59
028 Saint-Denis,4,4,8,2022,01-19,16:59
029 Richter,10,6,16,2022,01-19,16:59
030 Charles Flahault,3,5,8,2022,01-19,16:59
031 Voltaire,1,7,8,2022,01-19,16:59
032 Pr�s d'Ar�nes,7,1,8,2022,01-19,16:59
033 Garcia Lorca,6,2,8,2022,01-19,16:59
034 Vert Bois,0,16,16,2022,01-19,16:59
035 Malbosc,3,5,8,2022,01-19,16:59
036 Occitanie,3,29,32,2022,01-19,16:59
037 FacdesSciences,8,16,24,2022,01-19,16:59
038 Fac de Lettres,0,16,16,2022,01-19,16:59
039 Aiguelongue,2,6,8,2022,01-19,16:59
040 Jeu de Mail des Abb�s,6,2,8,2022,01-19,16:59
041 Eurom�decine,0,8,8,2022,01-19,16:59
042 Marie Caizergues,3,5,8,2022,01-19,16:59
043 Sabines,4,4,8,2022,01-19,16:59
044 Celleneuve,0,8,8,2022,01-19,16:59
045 Jardin de la Lironde,2,6,8,2022,01-19,16:59
046 P�re Soulas,3,5,8,2022,01-19,16:59
047 Place Viala,1,7,8,2022,01-19,16:59
048 H�tel du D�partement,0,8,8,2022,01-19,16:59
049 Tonnelles,4,4,8,2022,01-19,16:59
050 Parvis Jules Ferry - Gare Saint-Roch,3,5,8,2022,01-19,16:59
051 Pont de Lattes - Gare Saint-Roch,2,10,12,2022,01-19,16:59
053 Deux Ponts - Gare Saint-Roch,1,7,8,2022,01-19,16:59
054 Providence - Ovalie,4,4,8,2022,01-19,16:59
055 P�rols Etang de l'Or,21,47,68,2022,01-19,16:59
056 Albert 1er - Cath�drale,7,5,12,2022,01-19,16:59
057 Saint-Guilhem - Courreau,0,8,8,2022,01-19,16:59
059 Sud De France,0,8,8,2022,01-19,16:59
001 Rue Jules Ferry - Gare Saint-Roch,5,7,12,2022,01-19,17:09
002 Com�die,12,12,24,2022,01-19,17:09
003 Esplanade,16,16,32,2022,01-19,17:09
004 H�tel de Ville,7,9,16,2022,01-19,17:09
005 Corum,4,8,12,2022,01-19,17:09
006 Place Albert 1er - St Charles,20,11,31,2022,01-19,17:09
007 Foch,6,2,8,2022,01-19,17:09
008 Halles Castellane,6,6,12,2022,01-19,17:09
009 Observatoire,7,1,8,2022,01-19,17:09
010 Rondelet,4,12,16,2022,01-19,17:09
011 Plan Cabanes,4,8,12,2022,01-19,17:09
012 Boutonnet,8,4,12,2022,01-19,17:09
013 Emile Combes,1,7,8,2022,01-19,17:09
014 Beaux-Arts,3,5,8,2022,01-19,17:09
015 Les Aubes,6,2,8,2022,01-19,17:09
016 Antigone centre,15,1,16,2022,01-19,17:09
017 M�diath�que Emile Zola,16,0,16,2022,01-19,17:09
018 Nombre d'Or,5,11,16,2022,01-19,17:09
019 Louis Blanc,14,2,16,2022,01-19,17:09
020 Gambetta,2,6,8,2022,01-19,17:09
021 Port Marianne,6,10,16,2022,01-19,17:09
022 Clemenceau,2,10,12,2022,01-19,17:09
023 Les Arceaux,2,14,16,2022,01-19,17:09
024 Cit� Mion,3,5,8,2022,01-19,17:09
025 Nouveau Saint-Roch,1,7,8,2022,01-19,17:09
026 Renouvier,4,4,8,2022,01-19,17:09
027 Odysseum,3,5,8,2022,01-19,17:09
028 Saint-Denis,4,4,8,2022,01-19,17:09
029 Richter,9,7,16,2022,01-19,17:09
030 Charles Flahault,3,5,8,2022,01-19,17:09
031 Voltaire,1,7,8,2022,01-19,17:09
032 Pr�s d'Ar�nes,6,2,8,2022,01-19,17:09
033 Garcia Lorca,6,2,8,2022,01-19,17:09
034 Vert Bois,0,16,16,2022,01-19,17:09
035 Malbosc,2,6,8,2022,01-19,17:09
036 Occitanie,3,29,32,2022,01-19,17:09
037 FacdesSciences,8,16,24,2022,01-19,17:09
038 Fac de Lettres,0,16,16,2022,01-19,17:09
039 Aiguelongue,2,6,8,2022,01-19,17:09
040 Jeu de Mail des Abb�s,6,2,8,2022,01-19,17:09
041 Eurom�decine,0,8,8,2022,01-19,17:09
042 Marie Caizergues,3,5,8,2022,01-19,17:09
043 Sabines,4,4,8,2022,01-19,17:09
044 Celleneuve,1,7,8,2022,01-19,17:09
045 Jardin de la Lironde,2,6,8,2022,01-19,17:09
046 P�re Soulas,3,5,8,2022,01-19,17:09
047 Place Viala,0,8,8,2022,01-19,17:09
048 H�tel du D�partement,0,8,8,2022,01-19,17:09
049 Tonnelles,3,5,8,2022,01-19,17:09
050 Parvis Jules Ferry - Gare Saint-Roch,3,5,8,2022,01-19,17:09
051 Pont de Lattes - Gare Saint-Roch,2,10,12,2022,01-19,17:09
053 Deux Ponts - Gare Saint-Roch,1,7,8,2022,01-19,17:09
054 Providence - Ovalie,4,4,8,2022,01-19,17:09
055 P�rols Etang de l'Or,19,49,68,2022,01-19,17:09
056 Albert 1er - Cath�drale,7,5,12,2022,01-19,17:09
057 Saint-Guilhem - Courreau,0,8,8,2022,01-19,17:09
059 Sud De France,0,8,8,2022,01-19,17:09
001 Rue Jules Ferry - Gare Saint-Roch,5,7,12,2022,01-19,17:19
002 Com�die,14,10,24,2022,01-19,17:19
003 Esplanade,15,17,32,2022,01-19,17:19
004 H�tel de Ville,8,8,16,2022,01-19,17:19
005 Corum,4,8,12,2022,01-19,17:19
006 Place Albert 1er - St Charles,20,11,31,2022,01-19,17:19
007 Foch,6,2,8,2022,01-19,17:19
008 Halles Castellane,6,6,12,2022,01-19,17:19
009 Observatoire,7,1,8,2022,01-19,17:19
010 Rondelet,3,13,16,2022,01-19,17:19
011 Plan Cabanes,4,8,12,2022,01-19,17:19
012 Boutonnet,8,4,12,2022,01-19,17:19
013 Emile Combes,1,7,8,2022,01-19,17:19
014 Beaux-Arts,3,5,8,2022,01-19,17:19
015 Les Aubes,6,2,8,2022,01-19,17:19
016 Antigone centre,15,1,16,2022,01-19,17:19
017 M�diath�que Emile Zola,15,1,16,2022,01-19,17:19
018 Nombre d'Or,5,11,16,2022,01-19,17:19
019 Louis Blanc,16,0,16,2022,01-19,17:19
020 Gambetta,2,6,8,2022,01-19,17:19
021 Port Marianne,7,9,16,2022,01-19,17:19
022 Clemenceau,2,10,12,2022,01-19,17:19
023 Les Arceaux,2,14,16,2022,01-19,17:19
024 Cit� Mion,3,5,8,2022,01-19,17:19
025 Nouveau Saint-Roch,1,7,8,2022,01-19,17:19
026 Renouvier,4,4,8,2022,01-19,17:19
027 Odysseum,3,5,8,2022,01-19,17:19
028 Saint-Denis,4,4,8,2022,01-19,17:19
029 Richter,9,7,16,2022,01-19,17:19
030 Charles Flahault,4,4,8,2022,01-19,17:19
031 Voltaire,1,7,8,2022,01-19,17:19
032 Pr�s d'Ar�nes,6,2,8,2022,01-19,17:19
033 Garcia Lorca,6,2,8,2022,01-19,17:19
034 Vert Bois,0,16,16,2022,01-19,17:19
035 Malbosc,1,7,8,2022,01-19,17:19
036 Occitanie,3,29,32,2022,01-19,17:19
037 FacdesSciences,7,17,24,2022,01-19,17:19
038 Fac de Lettres,1,15,16,2022,01-19,17:19
039 Aiguelongue,2,6,8,2022,01-19,17:19
040 Jeu de Mail des Abb�s,6,2,8,2022,01-19,17:19
041 Eurom�decine,0,8,8,2022,01-19,17:19
042 Marie Caizergues,0,8,8,2022,01-19,17:19
043 Sabines,4,4,8,2022,01-19,17:19
044 Celleneuve,1,7,8,2022,01-19,17:19
045 Jardin de la Lironde,2,6,8,2022,01-19,17:19
046 P�re Soulas,4,4,8,2022,01-19,17:19
047 Place Viala,0,8,8,2022,01-19,17:19
048 H�tel du D�partement,0,8,8,2022,01-19,17:19
049 Tonnelles,3,5,8,2022,01-19,17:19
050 Parvis Jules Ferry - Gare Saint-Roch,3,5,8,2022,01-19,17:19
051 Pont de Lattes - Gare Saint-Roch,1,11,12,2022,01-19,17:19
053 Deux Ponts - Gare Saint-Roch,1,7,8,2022,01-19,17:19
054 Providence - Ovalie,4,4,8,2022,01-19,17:19
055 P�rols Etang de l'Or,21,47,68,2022,01-19,17:19
056 Albert 1er - Cath�drale,7,5,12,2022,01-19,17:19
057 Saint-Guilhem - Courreau,0,8,8,2022,01-19,17:19
059 Sud De France,0,8,8,2022,01-19,17:19
001 Rue Jules Ferry - Gare Saint-Roch,5,7,12,2022,01-19,17:29
002 Com�die,13,11,24,2022,01-19,17:29
003 Esplanade,15,17,32,2022,01-19,17:29
004 H�tel de Ville,8,8,16,2022,01-19,17:29
005 Corum,4,8,12,2022,01-19,17:29
006 Place Albert 1er - St Charles,21,10,31,2022,01-19,17:29
007 Foch,6,2,8,2022,01-19,17:29
008 Halles Castellane,6,6,12,2022,01-19,17:29
009 Observatoire,7,1,8,2022,01-19,17:29
010 Rondelet,3,13,16,2022,01-19,17:29
011 Plan Cabanes,5,7,12,2022,01-19,17:29
012 Boutonnet,8,4,12,2022,01-19,17:29
013 Emile Combes,1,7,8,2022,01-19,17:29
014 Beaux-Arts,3,5,8,2022,01-19,17:29
015 Les Aubes,6,2,8,2022,01-19,17:29
016 Antigone centre,15,1,16,2022,01-19,17:29
017 M�diath�que Emile Zola,14,2,16,2022,01-19,17:29
018 Nombre d'Or,6,10,16,2022,01-19,17:29
019 Louis Blanc,16,0,16,2022,01-19,17:29
020 Gambetta,2,6,8,2022,01-19,17:29
021 Port Marianne,7,9,16,2022,01-19,17:29
022 Clemenceau,2,10,12,2022,01-19,17:29
023 Les Arceaux,2,14,16,2022,01-19,17:29
024 Cit� Mion,3,5,8,2022,01-19,17:29
025 Nouveau Saint-Roch,2,6,8,2022,01-19,17:29
026 Renouvier,4,4,8,2022,01-19,17:29
027 Odysseum,3,5,8,2022,01-19,17:29
028 Saint-Denis,4,4,8,2022,01-19,17:29
029 Richter,10,6,16,2022,01-19,17:29
030 Charles Flahault,4,4,8,2022,01-19,17:29
031 Voltaire,1,7,8,2022,01-19,17:29
032 Pr�s d'Ar�nes,6,2,8,2022,01-19,17:29
033 Garcia Lorca,6,2,8,2022,01-19,17:29
034 Vert Bois,0,16,16,2022,01-19,17:29
035 Malbosc,1,7,8,2022,01-19,17:29
036 Occitanie,4,28,32,2022,01-19,17:29
037 FacdesSciences,5,19,24,2022,01-19,17:29
038 Fac de Lettres,1,15,16,2022,01-19,17:29
039 Aiguelongue,2,6,8,2022,01-19,17:29
040 Jeu de Mail des Abb�s,6,2,8,2022,01-19,17:29
041 Eurom�decine,0,8,8,2022,01-19,17:29
042 Marie Caizergues,0,8,8,2022,01-19,17:29
043 Sabines,4,4,8,2022,01-19,17:29
044 Celleneuve,1,7,8,2022,01-19,17:29
045 Jardin de la Lironde,2,6,8,2022,01-19,17:29
046 P�re Soulas,4,4,8,2022,01-19,17:29
047 Place Viala,0,8,8,2022,01-19,17:29
048 H�tel du D�partement,0,8,8,2022,01-19,17:29
049 Tonnelles,3,5,8,2022,01-19,17:29
050 Parvis Jules Ferry - Gare Saint-Roch,3,5,8,2022,01-19,17:29
051 Pont de Lattes - Gare Saint-Roch,1,11,12,2022,01-19,17:29
053 Deux Ponts - Gare Saint-Roch,1,7,8,2022,01-19,17:29
054 Providence - Ovalie,4,4,8,2022,01-19,17:29
055 P�rols Etang de l'Or,21,47,68,2022,01-19,17:29
056 Albert 1er - Cath�drale,7,5,12,2022,01-19,17:29
057 Saint-Guilhem - Courreau,1,7,8,2022,01-19,17:29
059 Sud De France,0,8,8,2022,01-19,17:29
001 Rue Jules Ferry - Gare Saint-Roch,5,7,12,2022,01-19,17:40
002 Com�die,13,11,24,2022,01-19,17:40
003 Esplanade,14,18,32,2022,01-19,17:40
004 H�tel de Ville,8,8,16,2022,01-19,17:40
005 Corum,3,9,12,2022,01-19,17:40
006 Place Albert 1er - St Charles,21,10,31,2022,01-19,17:40
007 Foch,6,2,8,2022,01-19,17:40
008 Halles Castellane,7,5,12,2022,01-19,17:40
009 Observatoire,7,1,8,2022,01-19,17:40
010 Rondelet,3,13,16,2022,01-19,17:40
011 Plan Cabanes,4,8,12,2022,01-19,17:40
012 Boutonnet,8,4,12,2022,01-19,17:40
013 Emile Combes,1,7,8,2022,01-19,17:40
014 Beaux-Arts,3,5,8,2022,01-19,17:40
015 Les Aubes,6,2,8,2022,01-19,17:40
016 Antigone centre,15,1,16,2022,01-19,17:40
017 M�diath�que Emile Zola,15,1,16,2022,01-19,17:40
018 Nombre d'Or,6,10,16,2022,01-19,17:40
019 Louis Blanc,16,0,16,2022,01-19,17:40
020 Gambetta,2,6,8,2022,01-19,17:40
021 Port Marianne,6,10,16,2022,01-19,17:40
022 Clemenceau,2,10,12,2022,01-19,17:40
023 Les Arceaux,2,14,16,2022,01-19,17:40
024 Cit� Mion,3,5,8,2022,01-19,17:40
025 Nouveau Saint-Roch,2,6,8,2022,01-19,17:40
026 Renouvier,3,5,8,2022,01-19,17:40
027 Odysseum,3,5,8,2022,01-19,17:40
028 Saint-Denis,4,4,8,2022,01-19,17:40
029 Richter,10,6,16,2022,01-19,17:40
030 Charles Flahault,4,4,8,2022,01-19,17:40
031 Voltaire,0,8,8,2022,01-19,17:40
032 Pr�s d'Ar�nes,6,2,8,2022,01-19,17:40
033 Garcia Lorca,7,1,8,2022,01-19,17:40
034 Vert Bois,0,16,16,2022,01-19,17:40
035 Malbosc,1,7,8,2022,01-19,17:40
036 Occitanie,4,28,32,2022,01-19,17:40
037 FacdesSciences,4,20,24,2022,01-19,17:40
038 Fac de Lettres,1,15,16,2022,01-19,17:40
039 Aiguelongue,2,6,8,2022,01-19,17:40
040 Jeu de Mail des Abb�s,6,2,8,2022,01-19,17:40
041 Eurom�decine,0,8,8,2022,01-19,17:40
042 Marie Caizergues,0,8,8,2022,01-19,17:40
043 Sabines,4,4,8,2022,01-19,17:40
044 Celleneuve,1,7,8,2022,01-19,17:40
045 Jardin de la Lironde,2,6,8,2022,01-19,17:40
046 P�re Soulas,4,4,8,2022,01-19,17:40
047 Place Viala,0,8,8,2022,01-19,17:40
048 H�tel du D�partement,0,8,8,2022,01-19,17:40
049 Tonnelles,4,4,8,2022,01-19,17:40
050 Parvis Jules Ferry - Gare Saint-Roch,3,5,8,2022,01-19,17:40
051 Pont de Lattes - Gare Saint-Roch,1,11,12,2022,01-19,17:40
053 Deux Ponts - Gare Saint-Roch,1,7,8,2022,01-19,17:40
054 Providence - Ovalie,4,4,8,2022,01-19,17:40
055 P�rols Etang de l'Or,23,45,68,2022,01-19,17:40
056 Albert 1er - Cath�drale,6,6,12,2022,01-19,17:40
057 Saint-Guilhem - Courreau,1,7,8,2022,01-19,17:40
059 Sud De France,0,8,8,2022,01-19,17:40
001 Rue Jules Ferry - Gare Saint-Roch,5,7,12,2022,01-19,17:50
002 Com�die,14,10,24,2022,01-19,17:50
003 Esplanade,14,18,32,2022,01-19,17:50
004 H�tel de Ville,8,8,16,2022,01-19,17:50
005 Corum,3,9,12,2022,01-19,17:50
006 Place Albert 1er - St Charles,20,11,31,2022,01-19,17:50
007 Foch,7,1,8,2022,01-19,17:50
008 Halles Castellane,6,6,12,2022,01-19,17:50
009 Observatoire,7,1,8,2022,01-19,17:50
010 Rondelet,3,13,16,2022,01-19,17:50
011 Plan Cabanes,4,8,12,2022,01-19,17:50
012 Boutonnet,9,3,12,2022,01-19,17:50
013 Emile Combes,1,7,8,2022,01-19,17:50
014 Beaux-Arts,3,5,8,2022,01-19,17:50
015 Les Aubes,6,2,8,2022,01-19,17:50
016 Antigone centre,14,2,16,2022,01-19,17:50
017 M�diath�que Emile Zola,14,2,16,2022,01-19,17:50
018 Nombre d'Or,6,10,16,2022,01-19,17:50
019 Louis Blanc,16,0,16,2022,01-19,17:50
020 Gambetta,2,6,8,2022,01-19,17:50
021 Port Marianne,6,10,16,2022,01-19,17:50
022 Clemenceau,3,9,12,2022,01-19,17:50
023 Les Arceaux,3,13,16,2022,01-19,17:50
024 Cit� Mion,3,5,8,2022,01-19,17:50
025 Nouveau Saint-Roch,2,6,8,2022,01-19,17:50
026 Renouvier,3,5,8,2022,01-19,17:50
027 Odysseum,3,5,8,2022,01-19,17:50
028 Saint-Denis,4,4,8,2022,01-19,17:50
029 Richter,10,6,16,2022,01-19,17:50
030 Charles Flahault,4,4,8,2022,01-19,17:50
031 Voltaire,0,8,8,2022,01-19,17:50
032 Pr�s d'Ar�nes,6,2,8,2022,01-19,17:50
033 Garcia Lorca,7,1,8,2022,01-19,17:50
034 Vert Bois,0,16,16,2022,01-19,17:50
035 Malbosc,1,7,8,2022,01-19,17:50
036 Occitanie,4,28,32,2022,01-19,17:50
037 FacdesSciences,4,20,24,2022,01-19,17:50
038 Fac de Lettres,1,15,16,2022,01-19,17:50
039 Aiguelongue,2,6,8,2022,01-19,17:50
040 Jeu de Mail des Abb�s,6,2,8,2022,01-19,17:50
041 Eurom�decine,0,8,8,2022,01-19,17:50
042 Marie Caizergues,0,8,8,2022,01-19,17:50
043 Sabines,4,4,8,2022,01-19,17:50
044 Celleneuve,1,7,8,2022,01-19,17:50
045 Jardin de la Lironde,2,6,8,2022,01-19,17:50
046 P�re Soulas,2,6,8,2022,01-19,17:50
047 Place Viala,0,8,8,2022,01-19,17:50
048 H�tel du D�partement,0,8,8,2022,01-19,17:50
049 Tonnelles,3,5,8,2022,01-19,17:50
050 Parvis Jules Ferry - Gare Saint-Roch,3,5,8,2022,01-19,17:50
051 Pont de Lattes - Gare Saint-Roch,1,11,12,2022,01-19,17:50
053 Deux Ponts - Gare Saint-Roch,1,7,8,2022,01-19,17:50
054 Providence - Ovalie,4,4,8,2022,01-19,17:50
055 P�rols Etang de l'Or,23,45,68,2022,01-19,17:50
056 Albert 1er - Cath�drale,6,6,12,2022,01-19,17:50
057 Saint-Guilhem - Courreau,1,7,8,2022,01-19,17:50
059 Sud De France,0,8,8,2022,01-19,17:50
001 Rue Jules Ferry - Gare Saint-Roch,6,6,12,2022,01-19,18:00
002 Com�die,14,10,24,2022,01-19,18:00
003 Esplanade,14,18,32,2022,01-19,18:00
004 H�tel de Ville,8,8,16,2022,01-19,18:00
005 Corum,3,9,12,2022,01-19,18:00
006 Place Albert 1er - St Charles,20,11,31,2022,01-19,18:00
007 Foch,7,1,8,2022,01-19,18:00
008 Halles Castellane,6,6,12,2022,01-19,18:00
009 Observatoire,7,1,8,2022,01-19,18:00
010 Rondelet,4,12,16,2022,01-19,18:00
011 Plan Cabanes,5,7,12,2022,01-19,18:00
012 Boutonnet,9,3,12,2022,01-19,18:00
013 Emile Combes,2,6,8,2022,01-19,18:00
014 Beaux-Arts,3,5,8,2022,01-19,18:00
015 Les Aubes,6,2,8,2022,01-19,18:00
016 Antigone centre,14,2,16,2022,01-19,18:00
017 M�diath�que Emile Zola,14,2,16,2022,01-19,18:00
018 Nombre d'Or,6,10,16,2022,01-19,18:00
019 Louis Blanc,16,0,16,2022,01-19,18:00
020 Gambetta,2,6,8,2022,01-19,18:00
021 Port Marianne,6,10,16,2022,01-19,18:00
022 Clemenceau,4,8,12,2022,01-19,18:00
023 Les Arceaux,3,13,16,2022,01-19,18:00
024 Cit� Mion,3,5,8,2022,01-19,18:00
025 Nouveau Saint-Roch,2,6,8,2022,01-19,18:00
026 Renouvier,3,5,8,2022,01-19,18:00
027 Odysseum,3,5,8,2022,01-19,18:00
028 Saint-Denis,4,4,8,2022,01-19,18:00
029 Richter,10,6,16,2022,01-19,18:00
030 Charles Flahault,4,4,8,2022,01-19,18:00
031 Voltaire,0,8,8,2022,01-19,18:00
032 Pr�s d'Ar�nes,6,2,8,2022,01-19,18:00
033 Garcia Lorca,7,1,8,2022,01-19,18:00
034 Vert Bois,0,16,16,2022,01-19,18:00
035 Malbosc,1,7,8,2022,01-19,18:00
036 Occitanie,4,28,32,2022,01-19,18:00
037 FacdesSciences,4,20,24,2022,01-19,18:00
038 Fac de Lettres,2,14,16,2022,01-19,18:00
039 Aiguelongue,2,6,8,2022,01-19,18:00
040 Jeu de Mail des Abb�s,5,3,8,2022,01-19,18:00
041 Eurom�decine,0,8,8,2022,01-19,18:00
042 Marie Caizergues,1,7,8,2022,01-19,18:00
043 Sabines,4,4,8,2022,01-19,18:00
044 Celleneuve,1,7,8,2022,01-19,18:00
045 Jardin de la Lironde,1,7,8,2022,01-19,18:00
046 P�re Soulas,2,6,8,2022,01-19,18:00
047 Place Viala,0,8,8,2022,01-19,18:00
048 H�tel du D�partement,0,8,8,2022,01-19,18:00
049 Tonnelles,5,3,8,2022,01-19,18:00
050 Parvis Jules Ferry - Gare Saint-Roch,4,4,8,2022,01-19,18:00
051 Pont de Lattes - Gare Saint-Roch,1,11,12,2022,01-19,18:00
053 Deux Ponts - Gare Saint-Roch,1,7,8,2022,01-19,18:00
054 Providence - Ovalie,4,4,8,2022,01-19,18:00
055 P�rols Etang de l'Or,25,43,68,2022,01-19,18:00
056 Albert 1er - Cath�drale,6,6,12,2022,01-19,18:00
057 Saint-Guilhem - Courreau,1,7,8,2022,01-19,18:00
059 Sud De France,0,8,8,2022,01-19,18:00
001 Rue Jules Ferry - Gare Saint-Roch,7,5,12,2022,01-19,18:10
002 Com�die,14,10,24,2022,01-19,18:10
003 Esplanade,14,18,32,2022,01-19,18:10
004 H�tel de Ville,7,9,16,2022,01-19,18:10
005 Corum,3,9,12,2022,01-19,18:10
006 Place Albert 1er - St Charles,20,11,31,2022,01-19,18:10
007 Foch,7,1,8,2022,01-19,18:10
008 Halles Castellane,5,7,12,2022,01-19,18:10
009 Observatoire,7,1,8,2022,01-19,18:10
010 Rondelet,4,12,16,2022,01-19,18:10
011 Plan Cabanes,5,7,12,2022,01-19,18:10
012 Boutonnet,8,4,12,2022,01-19,18:10
013 Emile Combes,2,6,8,2022,01-19,18:10
014 Beaux-Arts,3,5,8,2022,01-19,18:10
015 Les Aubes,6,2,8,2022,01-19,18:10
016 Antigone centre,15,1,16,2022,01-19,18:10
017 M�diath�que Emile Zola,15,1,16,2022,01-19,18:10
018 Nombre d'Or,6,10,16,2022,01-19,18:10
019 Louis Blanc,16,0,16,2022,01-19,18:10
020 Gambetta,2,6,8,2022,01-19,18:10
021 Port Marianne,6,10,16,2022,01-19,18:10
022 Clemenceau,4,8,12,2022,01-19,18:10
023 Les Arceaux,3,13,16,2022,01-19,18:10
024 Cit� Mion,3,5,8,2022,01-19,18:10
025 Nouveau Saint-Roch,2,6,8,2022,01-19,18:10
026 Renouvier,3,5,8,2022,01-19,18:10
027 Odysseum,3,5,8,2022,01-19,18:10
028 Saint-Denis,4,4,8,2022,01-19,18:10
029 Richter,10,6,16,2022,01-19,18:10
030 Charles Flahault,4,4,8,2022,01-19,18:10
031 Voltaire,0,8,8,2022,01-19,18:10
032 Pr�s d'Ar�nes,6,2,8,2022,01-19,18:10
033 Garcia Lorca,7,1,8,2022,01-19,18:10
034 Vert Bois,0,16,16,2022,01-19,18:10
035 Malbosc,1,7,8,2022,01-19,18:10
036 Occitanie,4,28,32,2022,01-19,18:10
037 FacdesSciences,3,21,24,2022,01-19,18:10
038 Fac de Lettres,1,15,16,2022,01-19,18:10
039 Aiguelongue,2,6,8,2022,01-19,18:10
040 Jeu de Mail des Abb�s,5,3,8,2022,01-19,18:10
041 Eurom�decine,0,8,8,2022,01-19,18:10
042 Marie Caizergues,1,7,8,2022,01-19,18:10
043 Sabines,4,4,8,2022,01-19,18:10
044 Celleneuve,1,7,8,2022,01-19,18:10
045 Jardin de la Lironde,1,7,8,2022,01-19,18:10
046 P�re Soulas,2,6,8,2022,01-19,18:10
047 Place Viala,0,8,8,2022,01-19,18:10
048 H�tel du D�partement,0,8,8,2022,01-19,18:10
049 Tonnelles,5,3,8,2022,01-19,18:10
050 Parvis Jules Ferry - Gare Saint-Roch,4,4,8,2022,01-19,18:10
051 Pont de Lattes - Gare Saint-Roch,1,11,12,2022,01-19,18:10
053 Deux Ponts - Gare Saint-Roch,1,7,8,2022,01-19,18:10
054 Providence - Ovalie,4,4,8,2022,01-19,18:10
055 P�rols Etang de l'Or,25,43,68,2022,01-19,18:10
056 Albert 1er - Cath�drale,6,6,12,2022,01-19,18:10
057 Saint-Guilhem - Courreau,1,7,8,2022,01-19,18:10
059 Sud De France,0,8,8,2022,01-19,18:10
001 Rue Jules Ferry - Gare Saint-Roch,7,5,12,2022,01-19,18:20
002 Com�die,14,10,24,2022,01-19,18:20
003 Esplanade,14,18,32,2022,01-19,18:20
004 H�tel de Ville,6,10,16,2022,01-19,18:20
005 Corum,4,8,12,2022,01-19,18:20
006 Place Albert 1er - St Charles,21,10,31,2022,01-19,18:20
007 Foch,7,1,8,2022,01-19,18:20
008 Halles Castellane,5,7,12,2022,01-19,18:20
009 Observatoire,7,1,8,2022,01-19,18:20
010 Rondelet,4,12,16,2022,01-19,18:20
011 Plan Cabanes,5,7,12,2022,01-19,18:20
012 Boutonnet,8,4,12,2022,01-19,18:20
013 Emile Combes,2,6,8,2022,01-19,18:20
014 Beaux-Arts,4,4,8,2022,01-19,18:20
015 Les Aubes,5,3,8,2022,01-19,18:20
016 Antigone centre,15,1,16,2022,01-19,18:20
017 M�diath�que Emile Zola,15,1,16,2022,01-19,18:20
018 Nombre d'Or,6,10,16,2022,01-19,18:20
019 Louis Blanc,16,0,16,2022,01-19,18:20
020 Gambetta,3,5,8,2022,01-19,18:20
021 Port Marianne,6,10,16,2022,01-19,18:20
022 Clemenceau,4,8,12,2022,01-19,18:20
023 Les Arceaux,3,13,16,2022,01-19,18:20
024 Cit� Mion,3,5,8,2022,01-19,18:20
025 Nouveau Saint-Roch,2,6,8,2022,01-19,18:20
026 Renouvier,3,5,8,2022,01-19,18:20
027 Odysseum,3,5,8,2022,01-19,18:20
028 Saint-Denis,4,4,8,2022,01-19,18:20
029 Richter,10,6,16,2022,01-19,18:20
030 Charles Flahault,4,4,8,2022,01-19,18:20
031 Voltaire,0,8,8,2022,01-19,18:20
032 Pr�s d'Ar�nes,6,2,8,2022,01-19,18:20
033 Garcia Lorca,7,1,8,2022,01-19,18:20
034 Vert Bois,0,16,16,2022,01-19,18:20
035 Malbosc,1,7,8,2022,01-19,18:20
036 Occitanie,4,28,32,2022,01-19,18:20
037 FacdesSciences,2,22,24,2022,01-19,18:20
038 Fac de Lettres,1,15,16,2022,01-19,18:20
039 Aiguelongue,2,6,8,2022,01-19,18:20
040 Jeu de Mail des Abb�s,5,3,8,2022,01-19,18:20
041 Eurom�decine,0,8,8,2022,01-19,18:20
042 Marie Caizergues,1,7,8,2022,01-19,18:20
043 Sabines,4,4,8,2022,01-19,18:20
044 Celleneuve,1,7,8,2022,01-19,18:20
045 Jardin de la Lironde,1,7,8,2022,01-19,18:20
046 P�re Soulas,2,6,8,2022,01-19,18:20
047 Place Viala,0,8,8,2022,01-19,18:20
048 H�tel du D�partement,0,8,8,2022,01-19,18:20
049 Tonnelles,3,5,8,2022,01-19,18:20
050 Parvis Jules Ferry - Gare Saint-Roch,4,4,8,2022,01-19,18:20
051 Pont de Lattes - Gare Saint-Roch,1,11,12,2022,01-19,18:20
053 Deux Ponts - Gare Saint-Roch,1,7,8,2022,01-19,18:20
054 Providence - Ovalie,4,4,8,2022,01-19,18:20
055 P�rols Etang de l'Or,25,43,68,2022,01-19,18:20
056 Albert 1er - Cath�drale,6,6,12,2022,01-19,18:20
057 Saint-Guilhem - Courreau,0,8,8,2022,01-19,18:20
059 Sud De France,0,8,8,2022,01-19,18:20
001 Rue Jules Ferry - Gare Saint-Roch,8,4,12,2022,01-19,18:30
002 Com�die,14,10,24,2022,01-19,18:30
003 Esplanade,14,18,32,2022,01-19,18:30
004 H�tel de Ville,6,10,16,2022,01-19,18:30
005 Corum,4,8,12,2022,01-19,18:30
006 Place Albert 1er - St Charles,22,9,31,2022,01-19,18:30
007 Foch,7,1,8,2022,01-19,18:30
008 Halles Castellane,6,6,12,2022,01-19,18:30
009 Observatoire,7,1,8,2022,01-19,18:30
010 Rondelet,4,12,16,2022,01-19,18:30
011 Plan Cabanes,5,7,12,2022,01-19,18:30
012 Boutonnet,8,4,12,2022,01-19,18:30
013 Emile Combes,3,5,8,2022,01-19,18:30
014 Beaux-Arts,4,4,8,2022,01-19,18:30
015 Les Aubes,5,3,8,2022,01-19,18:30
016 Antigone centre,16,0,16,2022,01-19,18:30
017 M�diath�que Emile Zola,15,1,16,2022,01-19,18:30
018 Nombre d'Or,6,10,16,2022,01-19,18:30
019 Louis Blanc,16,0,16,2022,01-19,18:30
020 Gambetta,3,5,8,2022,01-19,18:30
021 Port Marianne,6,10,16,2022,01-19,18:30
022 Clemenceau,4,8,12,2022,01-19,18:30
023 Les Arceaux,3,13,16,2022,01-19,18:30
024 Cit� Mion,3,5,8,2022,01-19,18:30
025 Nouveau Saint-Roch,2,6,8,2022,01-19,18:30
026 Renouvier,3,5,8,2022,01-19,18:30
027 Odysseum,3,5,8,2022,01-19,18:30
028 Saint-Denis,4,4,8,2022,01-19,18:30
029 Richter,10,6,16,2022,01-19,18:30
030 Charles Flahault,2,6,8,2022,01-19,18:30
031 Voltaire,0,8,8,2022,01-19,18:30
032 Pr�s d'Ar�nes,6,2,8,2022,01-19,18:30
033 Garcia Lorca,7,1,8,2022,01-19,18:30
034 Vert Bois,0,16,16,2022,01-19,18:30
035 Malbosc,2,6,8,2022,01-19,18:30
036 Occitanie,4,28,32,2022,01-19,18:30
037 FacdesSciences,1,23,24,2022,01-19,18:30
038 Fac de Lettres,1,15,16,2022,01-19,18:30
039 Aiguelongue,2,6,8,2022,01-19,18:30
040 Jeu de Mail des Abb�s,5,3,8,2022,01-19,18:30
041 Eurom�decine,0,8,8,2022,01-19,18:30
042 Marie Caizergues,1,7,8,2022,01-19,18:30
043 Sabines,4,4,8,2022,01-19,18:30
044 Celleneuve,1,7,8,2022,01-19,18:30
045 Jardin de la Lironde,1,7,8,2022,01-19,18:30
046 P�re Soulas,2,6,8,2022,01-19,18:30
047 Place Viala,0,8,8,2022,01-19,18:30
048 H�tel du D�partement,0,8,8,2022,01-19,18:30
049 Tonnelles,3,5,8,2022,01-19,18:30
050 Parvis Jules Ferry - Gare Saint-Roch,4,4,8,2022,01-19,18:30
051 Pont de Lattes - Gare Saint-Roch,1,11,12,2022,01-19,18:30
053 Deux Ponts - Gare Saint-Roch,1,7,8,2022,01-19,18:30
054 Providence - Ovalie,4,4,8,2022,01-19,18:30
055 P�rols Etang de l'Or,25,43,68,2022,01-19,18:30
056 Albert 1er - Cath�drale,6,6,12,2022,01-19,18:30
057 Saint-Guilhem - Courreau,0,8,8,2022,01-19,18:30
059 Sud De France,0,8,8,2022,01-19,18:30
001 Rue Jules Ferry - Gare Saint-Roch,8,4,12,2022,01-19,18:41
002 Com�die,14,10,24,2022,01-19,18:41
003 Esplanade,14,18,32,2022,01-19,18:41
004 H�tel de Ville,6,10,16,2022,01-19,18:41
005 Corum,5,7,12,2022,01-19,18:41
006 Place Albert 1er - St Charles,21,10,31,2022,01-19,18:41
007 Foch,7,1,8,2022,01-19,18:41
008 Halles Castellane,5,7,12,2022,01-19,18:41
009 Observatoire,7,1,8,2022,01-19,18:41
010 Rondelet,4,12,16,2022,01-19,18:41
011 Plan Cabanes,5,7,12,2022,01-19,18:41
012 Boutonnet,8,4,12,2022,01-19,18:41
013 Emile Combes,3,5,8,2022,01-19,18:41
014 Beaux-Arts,4,4,8,2022,01-19,18:41
015 Les Aubes,5,3,8,2022,01-19,18:41
016 Antigone centre,16,0,16,2022,01-19,18:41
017 M�diath�que Emile Zola,16,0,16,2022,01-19,18:41
018 Nombre d'Or,6,10,16,2022,01-19,18:41
019 Louis Blanc,16,0,16,2022,01-19,18:41
020 Gambetta,3,5,8,2022,01-19,18:41
021 Port Marianne,6,10,16,2022,01-19,18:41
022 Clemenceau,4,8,12,2022,01-19,18:41
023 Les Arceaux,3,13,16,2022,01-19,18:41
024 Cit� Mion,3,5,8,2022,01-19,18:41
025 Nouveau Saint-Roch,2,6,8,2022,01-19,18:41
026 Renouvier,2,6,8,2022,01-19,18:41
027 Odysseum,3,5,8,2022,01-19,18:41
028 Saint-Denis,4,4,8,2022,01-19,18:41
029 Richter,10,6,16,2022,01-19,18:41
030 Charles Flahault,2,6,8,2022,01-19,18:41
031 Voltaire,0,8,8,2022,01-19,18:41
032 Pr�s d'Ar�nes,6,2,8,2022,01-19,18:41
033 Garcia Lorca,7,1,8,2022,01-19,18:41
034 Vert Bois,0,16,16,2022,01-19,18:41
035 Malbosc,2,6,8,2022,01-19,18:41
036 Occitanie,4,28,32,2022,01-19,18:41
037 FacdesSciences,1,23,24,2022,01-19,18:41
038 Fac de Lettres,1,15,16,2022,01-19,18:41
039 Aiguelongue,2,6,8,2022,01-19,18:41
040 Jeu de Mail des Abb�s,5,3,8,2022,01-19,18:41
041 Eurom�decine,0,8,8,2022,01-19,18:41
042 Marie Caizergues,1,7,8,2022,01-19,18:41
043 Sabines,4,4,8,2022,01-19,18:41
044 Celleneuve,1,7,8,2022,01-19,18:41
045 Jardin de la Lironde,2,6,8,2022,01-19,18:41
046 P�re Soulas,2,6,8,2022,01-19,18:41
047 Place Viala,1,7,8,2022,01-19,18:41
048 H�tel du D�partement,0,8,8,2022,01-19,18:41
049 Tonnelles,3,5,8,2022,01-19,18:41
050 Parvis Jules Ferry - Gare Saint-Roch,5,3,8,2022,01-19,18:41
051 Pont de Lattes - Gare Saint-Roch,1,11,12,2022,01-19,18:41
053 Deux Ponts - Gare Saint-Roch,1,7,8,2022,01-19,18:41
054 Providence - Ovalie,4,4,8,2022,01-19,18:41
055 P�rols Etang de l'Or,25,43,68,2022,01-19,18:41
056 Albert 1er - Cath�drale,6,6,12,2022,01-19,18:41
057 Saint-Guilhem - Courreau,0,8,8,2022,01-19,18:41
059 Sud De France,0,8,8,2022,01-19,18:41
001 Rue Jules Ferry - Gare Saint-Roch,8,4,12,2022,01-19,18:51
002 Com�die,14,10,24,2022,01-19,18:51
003 Esplanade,14,18,32,2022,01-19,18:51
004 H�tel de Ville,6,10,16,2022,01-19,18:51
005 Corum,5,7,12,2022,01-19,18:51
006 Place Albert 1er - St Charles,21,10,31,2022,01-19,18:51
007 Foch,7,1,8,2022,01-19,18:51
008 Halles Castellane,4,8,12,2022,01-19,18:51
009 Observatoire,7,1,8,2022,01-19,18:51
010 Rondelet,4,12,16,2022,01-19,18:51
011 Plan Cabanes,6,6,12,2022,01-19,18:51
012 Boutonnet,7,5,12,2022,01-19,18:51
013 Emile Combes,3,5,8,2022,01-19,18:51
014 Beaux-Arts,4,4,8,2022,01-19,18:51
015 Les Aubes,5,3,8,2022,01-19,18:51
016 Antigone centre,15,1,16,2022,01-19,18:51
017 M�diath�que Emile Zola,16,0,16,2022,01-19,18:51
018 Nombre d'Or,6,10,16,2022,01-19,18:51
019 Louis Blanc,16,0,16,2022,01-19,18:51
020 Gambetta,3,5,8,2022,01-19,18:51
021 Port Marianne,6,10,16,2022,01-19,18:51
022 Clemenceau,4,8,12,2022,01-19,18:51
023 Les Arceaux,3,13,16,2022,01-19,18:51
024 Cit� Mion,3,5,8,2022,01-19,18:51
025 Nouveau Saint-Roch,2,6,8,2022,01-19,18:51
026 Renouvier,2,6,8,2022,01-19,18:51
027 Odysseum,3,5,8,2022,01-19,18:51
028 Saint-Denis,4,4,8,2022,01-19,18:51
029 Richter,10,6,16,2022,01-19,18:51
030 Charles Flahault,2,6,8,2022,01-19,18:51
031 Voltaire,0,8,8,2022,01-19,18:51
032 Pr�s d'Ar�nes,7,1,8,2022,01-19,18:51
033 Garcia Lorca,7,1,8,2022,01-19,18:51
034 Vert Bois,0,16,16,2022,01-19,18:51
035 Malbosc,2,6,8,2022,01-19,18:51
036 Occitanie,4,28,32,2022,01-19,18:51
037 FacdesSciences,1,23,24,2022,01-19,18:51
038 Fac de Lettres,0,16,16,2022,01-19,18:51
039 Aiguelongue,2,6,8,2022,01-19,18:51
040 Jeu de Mail des Abb�s,5,3,8,2022,01-19,18:51
041 Eurom�decine,0,8,8,2022,01-19,18:51
042 Marie Caizergues,0,8,8,2022,01-19,18:51
043 Sabines,4,4,8,2022,01-19,18:51
044 Celleneuve,1,7,8,2022,01-19,18:51
045 Jardin de la Lironde,2,6,8,2022,01-19,18:51
046 P�re Soulas,2,6,8,2022,01-19,18:51
047 Place Viala,1,7,8,2022,01-19,18:51
048 H�tel du D�partement,0,8,8,2022,01-19,18:51
049 Tonnelles,3,5,8,2022,01-19,18:51
050 Parvis Jules Ferry - Gare Saint-Roch,5,3,8,2022,01-19,18:51
051 Pont de Lattes - Gare Saint-Roch,1,11,12,2022,01-19,18:51
053 Deux Ponts - Gare Saint-Roch,1,7,8,2022,01-19,18:51
054 Providence - Ovalie,4,4,8,2022,01-19,18:51
055 P�rols Etang de l'Or,25,43,68,2022,01-19,18:51
056 Albert 1er - Cath�drale,6,6,12,2022,01-19,18:51
057 Saint-Guilhem - Courreau,0,8,8,2022,01-19,18:51
059 Sud De France,0,8,8,2022,01-19,18:51
001 Rue Jules Ferry - Gare Saint-Roch,8,4,12,2022,01-19,19:01
002 Com�die,13,11,24,2022,01-19,19:01
003 Esplanade,14,18,32,2022,01-19,19:01
004 H�tel de Ville,6,10,16,2022,01-19,19:01
005 Corum,5,7,12,2022,01-19,19:01
006 Place Albert 1er - St Charles,22,9,31,2022,01-19,19:01
007 Foch,7,1,8,2022,01-19,19:01
008 Halles Castellane,3,9,12,2022,01-19,19:01
009 Observatoire,7,1,8,2022,01-19,19:01
010 Rondelet,4,12,16,2022,01-19,19:01
011 Plan Cabanes,6,6,12,2022,01-19,19:01
012 Boutonnet,7,5,12,2022,01-19,19:01
013 Emile Combes,3,5,8,2022,01-19,19:01
014 Beaux-Arts,4,4,8,2022,01-19,19:01
015 Les Aubes,5,3,8,2022,01-19,19:01
016 Antigone centre,15,1,16,2022,01-19,19:01
017 M�diath�que Emile Zola,15,1,16,2022,01-19,19:01
018 Nombre d'Or,6,10,16,2022,01-19,19:01
019 Louis Blanc,16,0,16,2022,01-19,19:01
020 Gambetta,3,5,8,2022,01-19,19:01
021 Port Marianne,6,10,16,2022,01-19,19:01
022 Clemenceau,4,8,12,2022,01-19,19:01
023 Les Arceaux,3,13,16,2022,01-19,19:01
024 Cit� Mion,3,5,8,2022,01-19,19:01
025 Nouveau Saint-Roch,3,5,8,2022,01-19,19:01
026 Renouvier,2,6,8,2022,01-19,19:01
027 Odysseum,3,5,8,2022,01-19,19:01
028 Saint-Denis,4,4,8,2022,01-19,19:01
029 Richter,10,6,16,2022,01-19,19:01
030 Charles Flahault,2,6,8,2022,01-19,19:01
031 Voltaire,0,8,8,2022,01-19,19:01
032 Pr�s d'Ar�nes,7,1,8,2022,01-19,19:01
033 Garcia Lorca,7,1,8,2022,01-19,19:01
034 Vert Bois,0,16,16,2022,01-19,19:01
035 Malbosc,2,6,8,2022,01-19,19:01
036 Occitanie,4,28,32,2022,01-19,19:01
037 FacdesSciences,1,23,24,2022,01-19,19:01
038 Fac de Lettres,0,16,16,2022,01-19,19:01
039 Aiguelongue,1,7,8,2022,01-19,19:01
040 Jeu de Mail des Abb�s,5,3,8,2022,01-19,19:01
041 Eurom�decine,0,8,8,2022,01-19,19:01
042 Marie Caizergues,0,8,8,2022,01-19,19:01
043 Sabines,4,4,8,2022,01-19,19:01
044 Celleneuve,1,7,8,2022,01-19,19:01
045 Jardin de la Lironde,2,6,8,2022,01-19,19:01
046 P�re Soulas,2,6,8,2022,01-19,19:01
047 Place Viala,1,7,8,2022,01-19,19:01
048 H�tel du D�partement,0,8,8,2022,01-19,19:01
049 Tonnelles,3,5,8,2022,01-19,19:01
050 Parvis Jules Ferry - Gare Saint-Roch,4,4,8,2022,01-19,19:01
051 Pont de Lattes - Gare Saint-Roch,1,11,12,2022,01-19,19:01
053 Deux Ponts - Gare Saint-Roch,1,7,8,2022,01-19,19:01
054 Providence - Ovalie,4,4,8,2022,01-19,19:01
055 P�rols Etang de l'Or,25,43,68,2022,01-19,19:01
056 Albert 1er - Cath�drale,6,6,12,2022,01-19,19:01
057 Saint-Guilhem - Courreau,0,8,8,2022,01-19,19:01
059 Sud De France,0,8,8,2022,01-19,19:01
001 Rue Jules Ferry - Gare Saint-Roch,8,4,12,2022,01-19,19:11
002 Com�die,13,11,24,2022,01-19,19:11
003 Esplanade,15,17,32,2022,01-19,19:11
004 H�tel de Ville,6,10,16,2022,01-19,19:11
005 Corum,5,7,12,2022,01-19,19:11
006 Place Albert 1er - St Charles,22,9,31,2022,01-19,19:11
007 Foch,7,1,8,2022,01-19,19:11
008 Halles Castellane,4,8,12,2022,01-19,19:11
009 Observatoire,7,1,8,2022,01-19,19:11
010 Rondelet,4,12,16,2022,01-19,19:11
011 Plan Cabanes,6,6,12,2022,01-19,19:11
012 Boutonnet,7,5,12,2022,01-19,19:11
013 Emile Combes,3,5,8,2022,01-19,19:11
014 Beaux-Arts,4,4,8,2022,01-19,19:11
015 Les Aubes,5,3,8,2022,01-19,19:11
016 Antigone centre,15,1,16,2022,01-19,19:11
017 M�diath�que Emile Zola,15,1,16,2022,01-19,19:11
018 Nombre d'Or,6,10,16,2022,01-19,19:11
019 Louis Blanc,16,0,16,2022,01-19,19:11
020 Gambetta,4,4,8,2022,01-19,19:11
021 Port Marianne,6,10,16,2022,01-19,19:11
022 Clemenceau,4,8,12,2022,01-19,19:11
023 Les Arceaux,3,13,16,2022,01-19,19:11
024 Cit� Mion,3,5,8,2022,01-19,19:11
025 Nouveau Saint-Roch,4,4,8,2022,01-19,19:11
026 Renouvier,2,6,8,2022,01-19,19:11
027 Odysseum,3,5,8,2022,01-19,19:11
028 Saint-Denis,4,4,8,2022,01-19,19:11
029 Richter,10,6,16,2022,01-19,19:11
030 Charles Flahault,2,6,8,2022,01-19,19:11
031 Voltaire,0,8,8,2022,01-19,19:11
032 Pr�s d'Ar�nes,7,1,8,2022,01-19,19:11
033 Garcia Lorca,7,1,8,2022,01-19,19:11
034 Vert Bois,0,16,16,2022,01-19,19:11
035 Malbosc,2,6,8,2022,01-19,19:11
036 Occitanie,4,28,32,2022,01-19,19:11
037 FacdesSciences,0,24,24,2022,01-19,19:11
038 Fac de Lettres,0,16,16,2022,01-19,19:11
039 Aiguelongue,1,7,8,2022,01-19,19:11
040 Jeu de Mail des Abb�s,6,2,8,2022,01-19,19:11
041 Eurom�decine,0,8,8,2022,01-19,19:11
042 Marie Caizergues,1,7,8,2022,01-19,19:11
043 Sabines,4,4,8,2022,01-19,19:11
044 Celleneuve,1,7,8,2022,01-19,19:11
045 Jardin de la Lironde,2,6,8,2022,01-19,19:11
046 P�re Soulas,2,6,8,2022,01-19,19:11
047 Place Viala,1,7,8,2022,01-19,19:11
048 H�tel du D�partement,0,8,8,2022,01-19,19:11
049 Tonnelles,3,5,8,2022,01-19,19:11
050 Parvis Jules Ferry - Gare Saint-Roch,4,4,8,2022,01-19,19:11
051 Pont de Lattes - Gare Saint-Roch,1,11,12,2022,01-19,19:11
053 Deux Ponts - Gare Saint-Roch,1,7,8,2022,01-19,19:11
054 Providence - Ovalie,4,4,8,2022,01-19,19:11
055 P�rols Etang de l'Or,25,43,68,2022,01-19,19:11
056 Albert 1er - Cath�drale,6,6,12,2022,01-19,19:11
057 Saint-Guilhem - Courreau,0,8,8,2022,01-19,19:11
059 Sud De France,0,8,8,2022,01-19,19:11
001 Rue Jules Ferry - Gare Saint-Roch,8,4,12,2022,01-19,19:21
002 Com�die,11,13,24,2022,01-19,19:21
003 Esplanade,14,18,32,2022,01-19,19:21
004 H�tel de Ville,6,10,16,2022,01-19,19:21
005 Corum,5,7,12,2022,01-19,19:21
006 Place Albert 1er - St Charles,22,9,31,2022,01-19,19:21
007 Foch,7,1,8,2022,01-19,19:21
008 Halles Castellane,4,8,12,2022,01-19,19:21
009 Observatoire,7,1,8,2022,01-19,19:21
010 Rondelet,4,12,16,2022,01-19,19:21
011 Plan Cabanes,6,6,12,2022,01-19,19:21
012 Boutonnet,7,5,12,2022,01-19,19:21
013 Emile Combes,3,5,8,2022,01-19,19:21
014 Beaux-Arts,4,4,8,2022,01-19,19:21
015 Les Aubes,5,3,8,2022,01-19,19:21
016 Antigone centre,15,1,16,2022,01-19,19:21
017 M�diath�que Emile Zola,15,1,16,2022,01-19,19:21
018 Nombre d'Or,6,10,16,2022,01-19,19:21
019 Louis Blanc,16,0,16,2022,01-19,19:21
020 Gambetta,4,4,8,2022,01-19,19:21
021 Port Marianne,6,10,16,2022,01-19,19:21
022 Clemenceau,4,8,12,2022,01-19,19:21
023 Les Arceaux,3,13,16,2022,01-19,19:21
024 Cit� Mion,3,5,8,2022,01-19,19:21
025 Nouveau Saint-Roch,4,4,8,2022,01-19,19:21
026 Renouvier,2,6,8,2022,01-19,19:21
027 Odysseum,3,5,8,2022,01-19,19:21
028 Saint-Denis,3,5,8,2022,01-19,19:21
029 Richter,10,6,16,2022,01-19,19:21
030 Charles Flahault,2,6,8,2022,01-19,19:21
031 Voltaire,0,8,8,2022,01-19,19:21
032 Pr�s d'Ar�nes,7,1,8,2022,01-19,19:21
033 Garcia Lorca,7,1,8,2022,01-19,19:21
034 Vert Bois,0,16,16,2022,01-19,19:21
035 Malbosc,3,5,8,2022,01-19,19:21
036 Occitanie,4,28,32,2022,01-19,19:21
037 FacdesSciences,0,24,24,2022,01-19,19:21
038 Fac de Lettres,1,15,16,2022,01-19,19:21
039 Aiguelongue,1,7,8,2022,01-19,19:21
040 Jeu de Mail des Abb�s,6,2,8,2022,01-19,19:21
041 Eurom�decine,0,8,8,2022,01-19,19:21
042 Marie Caizergues,3,5,8,2022,01-19,19:21
043 Sabines,4,4,8,2022,01-19,19:21
044 Celleneuve,1,7,8,2022,01-19,19:21
045 Jardin de la Lironde,2,6,8,2022,01-19,19:21
046 P�re Soulas,2,6,8,2022,01-19,19:21
047 Place Viala,1,7,8,2022,01-19,19:21
048 H�tel du D�partement,0,8,8,2022,01-19,19:21
049 Tonnelles,3,5,8,2022,01-19,19:21
050 Parvis Jules Ferry - Gare Saint-Roch,4,4,8,2022,01-19,19:21
051 Pont de Lattes - Gare Saint-Roch,1,11,12,2022,01-19,19:21
053 Deux Ponts - Gare Saint-Roch,1,7,8,2022,01-19,19:21
054 Providence - Ovalie,4,4,8,2022,01-19,19:21
055 P�rols Etang de l'Or,25,43,68,2022,01-19,19:21
056 Albert 1er - Cath�drale,6,6,12,2022,01-19,19:21
057 Saint-Guilhem - Courreau,0,8,8,2022,01-19,19:21
059 Sud De France,0,8,8,2022,01-19,19:21
001 Rue Jules Ferry - Gare Saint-Roch,8,4,12,2022,01-19,19:31
002 Com�die,10,14,24,2022,01-19,19:31
003 Esplanade,14,18,32,2022,01-19,19:31
004 H�tel de Ville,6,10,16,2022,01-19,19:31
005 Corum,5,7,12,2022,01-19,19:31
006 Place Albert 1er - St Charles,22,9,31,2022,01-19,19:31
007 Foch,7,1,8,2022,01-19,19:31
008 Halles Castellane,4,8,12,2022,01-19,19:31
009 Observatoire,7,1,8,2022,01-19,19:31
010 Rondelet,4,12,16,2022,01-19,19:31
011 Plan Cabanes,6,6,12,2022,01-19,19:31
012 Boutonnet,7,5,12,2022,01-19,19:31
013 Emile Combes,3,5,8,2022,01-19,19:31
014 Beaux-Arts,4,4,8,2022,01-19,19:31
015 Les Aubes,5,3,8,2022,01-19,19:31
016 Antigone centre,15,1,16,2022,01-19,19:31
017 M�diath�que Emile Zola,14,2,16,2022,01-19,19:31
018 Nombre d'Or,6,10,16,2022,01-19,19:31
019 Louis Blanc,16,0,16,2022,01-19,19:31
020 Gambetta,4,4,8,2022,01-19,19:31
021 Port Marianne,6,10,16,2022,01-19,19:31
022 Clemenceau,3,9,12,2022,01-19,19:31
023 Les Arceaux,3,13,16,2022,01-19,19:31
024 Cit� Mion,3,5,8,2022,01-19,19:31
025 Nouveau Saint-Roch,4,4,8,2022,01-19,19:31
026 Renouvier,2,6,8,2022,01-19,19:31
027 Odysseum,3,5,8,2022,01-19,19:31
028 Saint-Denis,3,5,8,2022,01-19,19:31
029 Richter,11,5,16,2022,01-19,19:31
030 Charles Flahault,2,6,8,2022,01-19,19:31
031 Voltaire,0,8,8,2022,01-19,19:31
032 Pr�s d'Ar�nes,7,1,8,2022,01-19,19:31
033 Garcia Lorca,7,1,8,2022,01-19,19:31
034 Vert Bois,0,16,16,2022,01-19,19:31
035 Malbosc,3,5,8,2022,01-19,19:31
036 Occitanie,4,28,32,2022,01-19,19:31
037 FacdesSciences,0,24,24,2022,01-19,19:31
038 Fac de Lettres,1,15,16,2022,01-19,19:31
039 Aiguelongue,1,7,8,2022,01-19,19:31
040 Jeu de Mail des Abb�s,6,2,8,2022,01-19,19:31
041 Eurom�decine,0,8,8,2022,01-19,19:31
042 Marie Caizergues,4,4,8,2022,01-19,19:31
043 Sabines,4,4,8,2022,01-19,19:31
044 Celleneuve,1,7,8,2022,01-19,19:31
045 Jardin de la Lironde,2,6,8,2022,01-19,19:31
046 P�re Soulas,2,6,8,2022,01-19,19:31
047 Place Viala,1,7,8,2022,01-19,19:31
048 H�tel du D�partement,0,8,8,2022,01-19,19:31
049 Tonnelles,3,5,8,2022,01-19,19:31
050 Parvis Jules Ferry - Gare Saint-Roch,4,4,8,2022,01-19,19:31
051 Pont de Lattes - Gare Saint-Roch,1,11,12,2022,01-19,19:31
053 Deux Ponts - Gare Saint-Roch,1,7,8,2022,01-19,19:31
054 Providence - Ovalie,4,4,8,2022,01-19,19:31
055 P�rols Etang de l'Or,25,43,68,2022,01-19,19:31
056 Albert 1er - Cath�drale,6,6,12,2022,01-19,19:31
057 Saint-Guilhem - Courreau,0,8,8,2022,01-19,19:31
059 Sud De France,0,8,8,2022,01-19,19:31
001 Rue Jules Ferry - Gare Saint-Roch,8,4,12,2022,01-19,19:42
002 Com�die,10,14,24,2022,01-19,19:42
003 Esplanade,14,18,32,2022,01-19,19:42
004 H�tel de Ville,6,10,16,2022,01-19,19:42
005 Corum,5,7,12,2022,01-19,19:42
006 Place Albert 1er - St Charles,22,9,31,2022,01-19,19:42
007 Foch,7,1,8,2022,01-19,19:42
008 Halles Castellane,4,8,12,2022,01-19,19:42
009 Observatoire,7,1,8,2022,01-19,19:42
010 Rondelet,4,12,16,2022,01-19,19:42
011 Plan Cabanes,6,6,12,2022,01-19,19:42
012 Boutonnet,7,5,12,2022,01-19,19:42
013 Emile Combes,3,5,8,2022,01-19,19:42
014 Beaux-Arts,3,5,8,2022,01-19,19:42
015 Les Aubes,5,3,8,2022,01-19,19:42
016 Antigone centre,15,1,16,2022,01-19,19:42
017 M�diath�que Emile Zola,15,1,16,2022,01-19,19:42
018 Nombre d'Or,6,10,16,2022,01-19,19:42
019 Louis Blanc,16,0,16,2022,01-19,19:42
020 Gambetta,4,4,8,2022,01-19,19:42
021 Port Marianne,6,10,16,2022,01-19,19:42
022 Clemenceau,3,9,12,2022,01-19,19:42
023 Les Arceaux,2,14,16,2022,01-19,19:42
024 Cit� Mion,4,4,8,2022,01-19,19:42
025 Nouveau Saint-Roch,3,5,8,2022,01-19,19:42
026 Renouvier,2,6,8,2022,01-19,19:42
027 Odysseum,3,5,8,2022,01-19,19:42
028 Saint-Denis,3,5,8,2022,01-19,19:42
029 Richter,11,5,16,2022,01-19,19:42
030 Charles Flahault,2,6,8,2022,01-19,19:42
031 Voltaire,0,8,8,2022,01-19,19:42
032 Pr�s d'Ar�nes,7,1,8,2022,01-19,19:42
033 Garcia Lorca,7,1,8,2022,01-19,19:42
034 Vert Bois,0,16,16,2022,01-19,19:42
035 Malbosc,3,5,8,2022,01-19,19:42
036 Occitanie,4,28,32,2022,01-19,19:42
037 FacdesSciences,0,24,24,2022,01-19,19:42
038 Fac de Lettres,1,15,16,2022,01-19,19:42
039 Aiguelongue,3,5,8,2022,01-19,19:42
040 Jeu de Mail des Abb�s,6,2,8,2022,01-19,19:42
041 Eurom�decine,0,8,8,2022,01-19,19:42
042 Marie Caizergues,5,3,8,2022,01-19,19:42
043 Sabines,4,4,8,2022,01-19,19:42
044 Celleneuve,1,7,8,2022,01-19,19:42
045 Jardin de la Lironde,2,6,8,2022,01-19,19:42
046 P�re Soulas,2,6,8,2022,01-19,19:42
047 Place Viala,1,7,8,2022,01-19,19:42
048 H�tel du D�partement,0,8,8,2022,01-19,19:42
049 Tonnelles,3,5,8,2022,01-19,19:42
050 Parvis Jules Ferry - Gare Saint-Roch,4,4,8,2022,01-19,19:42
051 Pont de Lattes - Gare Saint-Roch,1,11,12,2022,01-19,19:42
053 Deux Ponts - Gare Saint-Roch,1,7,8,2022,01-19,19:42
054 Providence - Ovalie,4,4,8,2022,01-19,19:42
055 P�rols Etang de l'Or,25,43,68,2022,01-19,19:42
056 Albert 1er - Cath�drale,6,6,12,2022,01-19,19:42
057 Saint-Guilhem - Courreau,0,8,8,2022,01-19,19:42
059 Sud De France,0,8,8,2022,01-19,19:42
001 Rue Jules Ferry - Gare Saint-Roch,8,4,12,2022,01-19,19:52
002 Com�die,10,14,24,2022,01-19,19:52
003 Esplanade,14,18,32,2022,01-19,19:52
004 H�tel de Ville,6,10,16,2022,01-19,19:52
005 Corum,5,7,12,2022,01-19,19:52
006 Place Albert 1er - St Charles,24,7,31,2022,01-19,19:52
007 Foch,7,1,8,2022,01-19,19:52
008 Halles Castellane,4,8,12,2022,01-19,19:52
009 Observatoire,7,1,8,2022,01-19,19:52
010 Rondelet,4,12,16,2022,01-19,19:52
011 Plan Cabanes,6,6,12,2022,01-19,19:52
012 Boutonnet,7,5,12,2022,01-19,19:52
013 Emile Combes,3,5,8,2022,01-19,19:52
014 Beaux-Arts,3,5,8,2022,01-19,19:52
015 Les Aubes,5,3,8,2022,01-19,19:52
016 Antigone centre,15,1,16,2022,01-19,19:52
017 M�diath�que Emile Zola,16,0,16,2022,01-19,19:52
018 Nombre d'Or,7,9,16,2022,01-19,19:52
019 Louis Blanc,16,0,16,2022,01-19,19:52
020 Gambetta,4,4,8,2022,01-19,19:52
021 Port Marianne,6,10,16,2022,01-19,19:52
022 Clemenceau,3,9,12,2022,01-19,19:52
023 Les Arceaux,1,15,16,2022,01-19,19:52
024 Cit� Mion,4,4,8,2022,01-19,19:52
025 Nouveau Saint-Roch,3,5,8,2022,01-19,19:52
026 Renouvier,2,6,8,2022,01-19,19:52
027 Odysseum,3,5,8,2022,01-19,19:52
028 Saint-Denis,3,5,8,2022,01-19,19:52
029 Richter,10,6,16,2022,01-19,19:52
030 Charles Flahault,2,6,8,2022,01-19,19:52
031 Voltaire,0,8,8,2022,01-19,19:52
032 Pr�s d'Ar�nes,7,1,8,2022,01-19,19:52
033 Garcia Lorca,7,1,8,2022,01-19,19:52
034 Vert Bois,0,16,16,2022,01-19,19:52
035 Malbosc,1,7,8,2022,01-19,19:52
036 Occitanie,4,28,32,2022,01-19,19:52
037 FacdesSciences,0,24,24,2022,01-19,19:52
038 Fac de Lettres,1,15,16,2022,01-19,19:52
039 Aiguelongue,3,5,8,2022,01-19,19:52
040 Jeu de Mail des Abb�s,6,2,8,2022,01-19,19:52
041 Eurom�decine,0,8,8,2022,01-19,19:52
042 Marie Caizergues,5,3,8,2022,01-19,19:52
043 Sabines,4,4,8,2022,01-19,19:52
044 Celleneuve,1,7,8,2022,01-19,19:52
045 Jardin de la Lironde,2,6,8,2022,01-19,19:52
046 P�re Soulas,3,5,8,2022,01-19,19:52
047 Place Viala,1,7,8,2022,01-19,19:52
048 H�tel du D�partement,0,8,8,2022,01-19,19:52
049 Tonnelles,3,5,8,2022,01-19,19:52
050 Parvis Jules Ferry - Gare Saint-Roch,4,4,8,2022,01-19,19:52
051 Pont de Lattes - Gare Saint-Roch,1,11,12,2022,01-19,19:52
053 Deux Ponts - Gare Saint-Roch,1,7,8,2022,01-19,19:52
054 Providence - Ovalie,4,4,8,2022,01-19,19:52
055 P�rols Etang de l'Or,25,43,68,2022,01-19,19:52
056 Albert 1er - Cath�drale,5,7,12,2022,01-19,19:52
057 Saint-Guilhem - Courreau,1,7,8,2022,01-19,19:52
059 Sud De France,0,8,8,2022,01-19,19:52
001 Rue Jules Ferry - Gare Saint-Roch,8,4,12,2022,01-19,20:02
002 Com�die,10,14,24,2022,01-19,20:02
003 Esplanade,14,18,32,2022,01-19,20:02
004 H�tel de Ville,6,10,16,2022,01-19,20:02
005 Corum,5,7,12,2022,01-19,20:02
006 Place Albert 1er - St Charles,25,6,31,2022,01-19,20:02
007 Foch,7,1,8,2022,01-19,20:02
008 Halles Castellane,4,8,12,2022,01-19,20:02
009 Observatoire,7,1,8,2022,01-19,20:02
010 Rondelet,3,13,16,2022,01-19,20:02
011 Plan Cabanes,6,6,12,2022,01-19,20:02
012 Boutonnet,7,5,12,2022,01-19,20:02
013 Emile Combes,3,5,8,2022,01-19,20:02
014 Beaux-Arts,3,5,8,2022,01-19,20:02
015 Les Aubes,5,3,8,2022,01-19,20:02
016 Antigone centre,15,1,16,2022,01-19,20:02
017 M�diath�que Emile Zola,16,0,16,2022,01-19,20:02
018 Nombre d'Or,7,9,16,2022,01-19,20:02
019 Louis Blanc,16,0,16,2022,01-19,20:02
020 Gambetta,4,4,8,2022,01-19,20:02
021 Port Marianne,6,10,16,2022,01-19,20:02
022 Clemenceau,3,9,12,2022,01-19,20:02
023 Les Arceaux,1,15,16,2022,01-19,20:02
024 Cit� Mion,4,4,8,2022,01-19,20:02
025 Nouveau Saint-Roch,3,5,8,2022,01-19,20:02
026 Renouvier,2,6,8,2022,01-19,20:02
027 Odysseum,3,5,8,2022,01-19,20:02
028 Saint-Denis,3,5,8,2022,01-19,20:02
029 Richter,10,6,16,2022,01-19,20:02
030 Charles Flahault,2,6,8,2022,01-19,20:02
031 Voltaire,0,8,8,2022,01-19,20:02
032 Pr�s d'Ar�nes,7,1,8,2022,01-19,20:02
033 Garcia Lorca,7,1,8,2022,01-19,20:02
034 Vert Bois,0,16,16,2022,01-19,20:02
035 Malbosc,1,7,8,2022,01-19,20:02
036 Occitanie,4,28,32,2022,01-19,20:02
037 FacdesSciences,0,24,24,2022,01-19,20:02
038 Fac de Lettres,1,15,16,2022,01-19,20:02
039 Aiguelongue,2,6,8,2022,01-19,20:02
040 Jeu de Mail des Abb�s,6,2,8,2022,01-19,20:02
041 Eurom�decine,0,8,8,2022,01-19,20:02
042 Marie Caizergues,5,3,8,2022,01-19,20:02
043 Sabines,4,4,8,2022,01-19,20:02
044 Celleneuve,1,7,8,2022,01-19,20:02
045 Jardin de la Lironde,2,6,8,2022,01-19,20:02
046 P�re Soulas,3,5,8,2022,01-19,20:02
047 Place Viala,1,7,8,2022,01-19,20:02
048 H�tel du D�partement,0,8,8,2022,01-19,20:02
049 Tonnelles,3,5,8,2022,01-19,20:02
050 Parvis Jules Ferry - Gare Saint-Roch,4,4,8,2022,01-19,20:02
051 Pont de Lattes - Gare Saint-Roch,1,11,12,2022,01-19,20:02
053 Deux Ponts - Gare Saint-Roch,1,7,8,2022,01-19,20:02
054 Providence - Ovalie,4,4,8,2022,01-19,20:02
055 P�rols Etang de l'Or,25,43,68,2022,01-19,20:02
056 Albert 1er - Cath�drale,5,7,12,2022,01-19,20:02
057 Saint-Guilhem - Courreau,1,7,8,2022,01-19,20:02
059 Sud De France,0,8,8,2022,01-19,20:02
001 Rue Jules Ferry - Gare Saint-Roch,8,4,12,2022,01-19,20:12
002 Com�die,10,14,24,2022,01-19,20:12
003 Esplanade,13,19,32,2022,01-19,20:12
004 H�tel de Ville,5,11,16,2022,01-19,20:12
005 Corum,5,7,12,2022,01-19,20:12
006 Place Albert 1er - St Charles,25,6,31,2022,01-19,20:12
007 Foch,7,1,8,2022,01-19,20:12
008 Halles Castellane,4,8,12,2022,01-19,20:12
009 Observatoire,7,1,8,2022,01-19,20:12
010 Rondelet,3,13,16,2022,01-19,20:12
011 Plan Cabanes,6,6,12,2022,01-19,20:12
012 Boutonnet,9,3,12,2022,01-19,20:12
013 Emile Combes,3,5,8,2022,01-19,20:12
014 Beaux-Arts,3,5,8,2022,01-19,20:12
015 Les Aubes,5,3,8,2022,01-19,20:12
016 Antigone centre,16,0,16,2022,01-19,20:12
017 M�diath�que Emile Zola,16,0,16,2022,01-19,20:12
018 Nombre d'Or,7,9,16,2022,01-19,20:12
019 Louis Blanc,16,0,16,2022,01-19,20:12
020 Gambetta,4,4,8,2022,01-19,20:12
021 Port Marianne,6,10,16,2022,01-19,20:12
022 Clemenceau,2,10,12,2022,01-19,20:12
023 Les Arceaux,1,15,16,2022,01-19,20:12
024 Cit� Mion,4,4,8,2022,01-19,20:12
025 Nouveau Saint-Roch,3,5,8,2022,01-19,20:12
026 Renouvier,2,6,8,2022,01-19,20:12
027 Odysseum,3,5,8,2022,01-19,20:12
028 Saint-Denis,3,5,8,2022,01-19,20:12
029 Richter,10,6,16,2022,01-19,20:12
030 Charles Flahault,2,6,8,2022,01-19,20:12
031 Voltaire,0,8,8,2022,01-19,20:12
032 Pr�s d'Ar�nes,7,1,8,2022,01-19,20:12
033 Garcia Lorca,7,1,8,2022,01-19,20:12
034 Vert Bois,0,16,16,2022,01-19,20:12
035 Malbosc,1,7,8,2022,01-19,20:12
036 Occitanie,4,28,32,2022,01-19,20:12
037 FacdesSciences,0,24,24,2022,01-19,20:12
038 Fac de Lettres,1,15,16,2022,01-19,20:12
039 Aiguelongue,2,6,8,2022,01-19,20:12
040 Jeu de Mail des Abb�s,6,2,8,2022,01-19,20:12
041 Eurom�decine,0,8,8,2022,01-19,20:12
042 Marie Caizergues,5,3,8,2022,01-19,20:12
043 Sabines,4,4,8,2022,01-19,20:12
044 Celleneuve,1,7,8,2022,01-19,20:12
045 Jardin de la Lironde,2,6,8,2022,01-19,20:12
046 P�re Soulas,3,5,8,2022,01-19,20:12
047 Place Viala,1,7,8,2022,01-19,20:12
048 H�tel du D�partement,0,8,8,2022,01-19,20:12
049 Tonnelles,3,5,8,2022,01-19,20:12
050 Parvis Jules Ferry - Gare Saint-Roch,4,4,8,2022,01-19,20:12
051 Pont de Lattes - Gare Saint-Roch,1,11,12,2022,01-19,20:12
053 Deux Ponts - Gare Saint-Roch,1,7,8,2022,01-19,20:12
054 Providence - Ovalie,4,4,8,2022,01-19,20:12
055 P�rols Etang de l'Or,25,43,68,2022,01-19,20:12
056 Albert 1er - Cath�drale,5,7,12,2022,01-19,20:12
057 Saint-Guilhem - Courreau,1,7,8,2022,01-19,20:12
059 Sud De France,0,8,8,2022,01-19,20:12
001 Rue Jules Ferry - Gare Saint-Roch,8,4,12,2022,01-19,20:22
002 Com�die,10,14,24,2022,01-19,20:22
003 Esplanade,13,19,32,2022,01-19,20:22
004 H�tel de Ville,5,11,16,2022,01-19,20:22
005 Corum,5,7,12,2022,01-19,20:22
006 Place Albert 1er - St Charles,25,6,31,2022,01-19,20:22
007 Foch,7,1,8,2022,01-19,20:22
008 Halles Castellane,4,8,12,2022,01-19,20:22
009 Observatoire,7,1,8,2022,01-19,20:22
010 Rondelet,3,13,16,2022,01-19,20:22
011 Plan Cabanes,6,6,12,2022,01-19,20:22
012 Boutonnet,9,3,12,2022,01-19,20:22
013 Emile Combes,3,5,8,2022,01-19,20:22
014 Beaux-Arts,3,5,8,2022,01-19,20:22
015 Les Aubes,5,3,8,2022,01-19,20:22
016 Antigone centre,16,0,16,2022,01-19,20:22
017 M�diath�que Emile Zola,16,0,16,2022,01-19,20:22
018 Nombre d'Or,7,9,16,2022,01-19,20:22
019 Louis Blanc,16,0,16,2022,01-19,20:22
020 Gambetta,4,4,8,2022,01-19,20:22
021 Port Marianne,5,11,16,2022,01-19,20:22
022 Clemenceau,2,10,12,2022,01-19,20:22
023 Les Arceaux,1,15,16,2022,01-19,20:22
024 Cit� Mion,4,4,8,2022,01-19,20:22
025 Nouveau Saint-Roch,3,5,8,2022,01-19,20:22
026 Renouvier,2,6,8,2022,01-19,20:22
027 Odysseum,2,6,8,2022,01-19,20:22
028 Saint-Denis,3,5,8,2022,01-19,20:22
029 Richter,10,6,16,2022,01-19,20:22
030 Charles Flahault,2,6,8,2022,01-19,20:22
031 Voltaire,0,8,8,2022,01-19,20:22
032 Pr�s d'Ar�nes,7,1,8,2022,01-19,20:22
033 Garcia Lorca,7,1,8,2022,01-19,20:22
034 Vert Bois,0,16,16,2022,01-19,20:22
035 Malbosc,1,7,8,2022,01-19,20:22
036 Occitanie,4,28,32,2022,01-19,20:22
037 FacdesSciences,0,24,24,2022,01-19,20:22
038 Fac de Lettres,2,14,16,2022,01-19,20:22
039 Aiguelongue,2,6,8,2022,01-19,20:22
040 Jeu de Mail des Abb�s,6,2,8,2022,01-19,20:22
041 Eurom�decine,0,8,8,2022,01-19,20:22
042 Marie Caizergues,5,3,8,2022,01-19,20:22
043 Sabines,4,4,8,2022,01-19,20:22
044 Celleneuve,1,7,8,2022,01-19,20:22
045 Jardin de la Lironde,2,6,8,2022,01-19,20:22
046 P�re Soulas,3,5,8,2022,01-19,20:22
047 Place Viala,1,7,8,2022,01-19,20:22
048 H�tel du D�partement,0,8,8,2022,01-19,20:22
049 Tonnelles,3,5,8,2022,01-19,20:22
050 Parvis Jules Ferry - Gare Saint-Roch,4,4,8,2022,01-19,20:22
051 Pont de Lattes - Gare Saint-Roch,1,11,12,2022,01-19,20:22
053 Deux Ponts - Gare Saint-Roch,1,7,8,2022,01-19,20:22
054 Providence - Ovalie,4,4,8,2022,01-19,20:22
055 P�rols Etang de l'Or,25,43,68,2022,01-19,20:22
056 Albert 1er - Cath�drale,5,7,12,2022,01-19,20:22
057 Saint-Guilhem - Courreau,1,7,8,2022,01-19,20:22
059 Sud De France,0,8,8,2022,01-19,20:22
001 Rue Jules Ferry - Gare Saint-Roch,8,4,12,2022,01-19,20:32
002 Com�die,10,14,24,2022,01-19,20:32
003 Esplanade,13,19,32,2022,01-19,20:32
004 H�tel de Ville,5,11,16,2022,01-19,20:32
005 Corum,5,7,12,2022,01-19,20:32
006 Place Albert 1er - St Charles,25,6,31,2022,01-19,20:32
007 Foch,7,1,8,2022,01-19,20:32
008 Halles Castellane,4,8,12,2022,01-19,20:32
009 Observatoire,7,1,8,2022,01-19,20:32
010 Rondelet,3,13,16,2022,01-19,20:32
011 Plan Cabanes,6,6,12,2022,01-19,20:32
012 Boutonnet,9,3,12,2022,01-19,20:32
013 Emile Combes,3,5,8,2022,01-19,20:32
014 Beaux-Arts,3,5,8,2022,01-19,20:32
015 Les Aubes,5,3,8,2022,01-19,20:32
016 Antigone centre,16,0,16,2022,01-19,20:32
017 M�diath�que Emile Zola,16,0,16,2022,01-19,20:32
018 Nombre d'Or,7,9,16,2022,01-19,20:32
019 Louis Blanc,16,0,16,2022,01-19,20:32
020 Gambetta,4,4,8,2022,01-19,20:32
021 Port Marianne,5,11,16,2022,01-19,20:32
022 Clemenceau,2,10,12,2022,01-19,20:32
023 Les Arceaux,1,15,16,2022,01-19,20:32
024 Cit� Mion,4,4,8,2022,01-19,20:32
025 Nouveau Saint-Roch,3,5,8,2022,01-19,20:32
026 Renouvier,2,6,8,2022,01-19,20:32
027 Odysseum,2,6,8,2022,01-19,20:32
028 Saint-Denis,2,6,8,2022,01-19,20:32
029 Richter,10,6,16,2022,01-19,20:32
030 Charles Flahault,2,6,8,2022,01-19,20:32
031 Voltaire,0,8,8,2022,01-19,20:32
032 Pr�s d'Ar�nes,7,1,8,2022,01-19,20:32
033 Garcia Lorca,7,1,8,2022,01-19,20:32
034 Vert Bois,0,16,16,2022,01-19,20:32
035 Malbosc,1,7,8,2022,01-19,20:32
036 Occitanie,4,28,32,2022,01-19,20:32
037 FacdesSciences,0,24,24,2022,01-19,20:32
038 Fac de Lettres,2,14,16,2022,01-19,20:32
039 Aiguelongue,2,6,8,2022,01-19,20:32
040 Jeu de Mail des Abb�s,6,2,8,2022,01-19,20:32
041 Eurom�decine,0,8,8,2022,01-19,20:32
042 Marie Caizergues,5,3,8,2022,01-19,20:32
043 Sabines,4,4,8,2022,01-19,20:32
044 Celleneuve,1,7,8,2022,01-19,20:32
045 Jardin de la Lironde,2,6,8,2022,01-19,20:32
046 P�re Soulas,3,5,8,2022,01-19,20:32
047 Place Viala,1,7,8,2022,01-19,20:32
048 H�tel du D�partement,0,8,8,2022,01-19,20:32
049 Tonnelles,3,5,8,2022,01-19,20:32
050 Parvis Jules Ferry - Gare Saint-Roch,4,4,8,2022,01-19,20:32
051 Pont de Lattes - Gare Saint-Roch,1,11,12,2022,01-19,20:32
053 Deux Ponts - Gare Saint-Roch,1,7,8,2022,01-19,20:32
054 Providence - Ovalie,4,4,8,2022,01-19,20:32
055 P�rols Etang de l'Or,25,43,68,2022,01-19,20:32
056 Albert 1er - Cath�drale,5,7,12,2022,01-19,20:32
057 Saint-Guilhem - Courreau,1,7,8,2022,01-19,20:32
059 Sud De France,0,8,8,2022,01-19,20:32
001 Rue Jules Ferry - Gare Saint-Roch,8,4,12,2022,01-19,20:43
002 Com�die,10,14,24,2022,01-19,20:43
003 Esplanade,13,19,32,2022,01-19,20:43
004 H�tel de Ville,5,11,16,2022,01-19,20:43
005 Corum,5,7,12,2022,01-19,20:43
006 Place Albert 1er - St Charles,29,2,31,2022,01-19,20:43
007 Foch,5,3,8,2022,01-19,20:43
008 Halles Castellane,4,8,12,2022,01-19,20:43
009 Observatoire,7,1,8,2022,01-19,20:43
010 Rondelet,3,13,16,2022,01-19,20:43
011 Plan Cabanes,6,6,12,2022,01-19,20:43
012 Boutonnet,9,3,12,2022,01-19,20:43
013 Emile Combes,3,5,8,2022,01-19,20:43
014 Beaux-Arts,3,5,8,2022,01-19,20:43
015 Les Aubes,5,3,8,2022,01-19,20:43
016 Antigone centre,16,0,16,2022,01-19,20:43
017 M�diath�que Emile Zola,16,0,16,2022,01-19,20:43
018 Nombre d'Or,7,9,16,2022,01-19,20:43
019 Louis Blanc,16,0,16,2022,01-19,20:43
020 Gambetta,4,4,8,2022,01-19,20:43
021 Port Marianne,5,11,16,2022,01-19,20:43
022 Clemenceau,2,10,12,2022,01-19,20:43
023 Les Arceaux,1,15,16,2022,01-19,20:43
024 Cit� Mion,4,4,8,2022,01-19,20:43
025 Nouveau Saint-Roch,3,5,8,2022,01-19,20:43
026 Renouvier,1,7,8,2022,01-19,20:43
027 Odysseum,2,6,8,2022,01-19,20:43
028 Saint-Denis,2,6,8,2022,01-19,20:43
029 Richter,11,5,16,2022,01-19,20:43
030 Charles Flahault,2,6,8,2022,01-19,20:43
031 Voltaire,0,8,8,2022,01-19,20:43
032 Pr�s d'Ar�nes,7,1,8,2022,01-19,20:43
033 Garcia Lorca,7,1,8,2022,01-19,20:43
034 Vert Bois,0,16,16,2022,01-19,20:43
035 Malbosc,1,7,8,2022,01-19,20:43
036 Occitanie,4,28,32,2022,01-19,20:43
037 FacdesSciences,0,24,24,2022,01-19,20:43
038 Fac de Lettres,2,14,16,2022,01-19,20:43
039 Aiguelongue,2,6,8,2022,01-19,20:43
040 Jeu de Mail des Abb�s,6,2,8,2022,01-19,20:43
041 Eurom�decine,0,8,8,2022,01-19,20:43
042 Marie Caizergues,2,6,8,2022,01-19,20:43
043 Sabines,4,4,8,2022,01-19,20:43
044 Celleneuve,1,7,8,2022,01-19,20:43
045 Jardin de la Lironde,2,6,8,2022,01-19,20:43
046 P�re Soulas,3,5,8,2022,01-19,20:43
047 Place Viala,1,7,8,2022,01-19,20:43
048 H�tel du D�partement,0,8,8,2022,01-19,20:43
049 Tonnelles,3,5,8,2022,01-19,20:43
050 Parvis Jules Ferry - Gare Saint-Roch,4,4,8,2022,01-19,20:43
051 Pont de Lattes - Gare Saint-Roch,1,11,12,2022,01-19,20:43
053 Deux Ponts - Gare Saint-Roch,1,7,8,2022,01-19,20:43
054 Providence - Ovalie,4,4,8,2022,01-19,20:43
055 P�rols Etang de l'Or,25,43,68,2022,01-19,20:43
056 Albert 1er - Cath�drale,5,7,12,2022,01-19,20:43
057 Saint-Guilhem - Courreau,1,7,8,2022,01-19,20:43
059 Sud De France,0,8,8,2022,01-19,20:43
001 Rue Jules Ferry - Gare Saint-Roch,8,4,12,2022,01-19,20:53
002 Com�die,11,13,24,2022,01-19,20:53
003 Esplanade,13,19,32,2022,01-19,20:53
004 H�tel de Ville,5,11,16,2022,01-19,20:53
005 Corum,5,7,12,2022,01-19,20:53
006 Place Albert 1er - St Charles,30,1,31,2022,01-19,20:53
007 Foch,5,3,8,2022,01-19,20:53
008 Halles Castellane,4,8,12,2022,01-19,20:53
009 Observatoire,7,1,8,2022,01-19,20:53
010 Rondelet,3,13,16,2022,01-19,20:53
011 Plan Cabanes,7,5,12,2022,01-19,20:53
012 Boutonnet,9,3,12,2022,01-19,20:53
013 Emile Combes,3,5,8,2022,01-19,20:53
014 Beaux-Arts,3,5,8,2022,01-19,20:53
015 Les Aubes,5,3,8,2022,01-19,20:53
016 Antigone centre,16,0,16,2022,01-19,20:53
017 M�diath�que Emile Zola,16,0,16,2022,01-19,20:53
018 Nombre d'Or,7,9,16,2022,01-19,20:53
019 Louis Blanc,16,0,16,2022,01-19,20:53
020 Gambetta,4,4,8,2022,01-19,20:53
021 Port Marianne,5,11,16,2022,01-19,20:53
022 Clemenceau,2,10,12,2022,01-19,20:53
023 Les Arceaux,2,14,16,2022,01-19,20:53
024 Cit� Mion,4,4,8,2022,01-19,20:53
025 Nouveau Saint-Roch,3,5,8,2022,01-19,20:53
026 Renouvier,1,7,8,2022,01-19,20:53
027 Odysseum,2,6,8,2022,01-19,20:53
028 Saint-Denis,2,6,8,2022,01-19,20:53
029 Richter,11,5,16,2022,01-19,20:53
030 Charles Flahault,2,6,8,2022,01-19,20:53
031 Voltaire,0,8,8,2022,01-19,20:53
032 Pr�s d'Ar�nes,7,1,8,2022,01-19,20:53
033 Garcia Lorca,7,1,8,2022,01-19,20:53
034 Vert Bois,0,16,16,2022,01-19,20:53
035 Malbosc,1,7,8,2022,01-19,20:53
036 Occitanie,4,28,32,2022,01-19,20:53
037 FacdesSciences,0,24,24,2022,01-19,20:53
038 Fac de Lettres,2,14,16,2022,01-19,20:53
039 Aiguelongue,2,6,8,2022,01-19,20:53
040 Jeu de Mail des Abb�s,6,2,8,2022,01-19,20:53
041 Eurom�decine,0,8,8,2022,01-19,20:53
042 Marie Caizergues,2,6,8,2022,01-19,20:53
043 Sabines,4,4,8,2022,01-19,20:53
044 Celleneuve,0,8,8,2022,01-19,20:53
045 Jardin de la Lironde,2,6,8,2022,01-19,20:53
046 P�re Soulas,3,5,8,2022,01-19,20:53
047 Place Viala,1,7,8,2022,01-19,20:53
048 H�tel du D�partement,0,8,8,2022,01-19,20:53
049 Tonnelles,3,5,8,2022,01-19,20:53
050 Parvis Jules Ferry - Gare Saint-Roch,4,4,8,2022,01-19,20:53
051 Pont de Lattes - Gare Saint-Roch,1,11,12,2022,01-19,20:53
053 Deux Ponts - Gare Saint-Roch,1,7,8,2022,01-19,20:53
054 Providence - Ovalie,4,4,8,2022,01-19,20:53
055 P�rols Etang de l'Or,25,43,68,2022,01-19,20:53
056 Albert 1er - Cath�drale,5,7,12,2022,01-19,20:53
057 Saint-Guilhem - Courreau,1,7,8,2022,01-19,20:53
059 Sud De France,0,8,8,2022,01-19,20:53
001 Rue Jules Ferry - Gare Saint-Roch,8,4,12,2022,01-19,21:03
002 Com�die,11,13,24,2022,01-19,21:03
003 Esplanade,12,20,32,2022,01-19,21:03
004 H�tel de Ville,5,11,16,2022,01-19,21:03
005 Corum,5,7,12,2022,01-19,21:03
006 Place Albert 1er - St Charles,30,1,31,2022,01-19,21:03
007 Foch,7,1,8,2022,01-19,21:03
008 Halles Castellane,4,8,12,2022,01-19,21:03
009 Observatoire,7,1,8,2022,01-19,21:03
010 Rondelet,3,13,16,2022,01-19,21:03
011 Plan Cabanes,7,5,12,2022,01-19,21:03
012 Boutonnet,8,4,12,2022,01-19,21:03
013 Emile Combes,3,5,8,2022,01-19,21:03
014 Beaux-Arts,3,5,8,2022,01-19,21:03
015 Les Aubes,5,3,8,2022,01-19,21:03
016 Antigone centre,16,0,16,2022,01-19,21:03
017 M�diath�que Emile Zola,16,0,16,2022,01-19,21:03
018 Nombre d'Or,7,9,16,2022,01-19,21:03
019 Louis Blanc,16,0,16,2022,01-19,21:03
020 Gambetta,4,4,8,2022,01-19,21:03
021 Port Marianne,5,11,16,2022,01-19,21:03
022 Clemenceau,2,10,12,2022,01-19,21:03
023 Les Arceaux,2,14,16,2022,01-19,21:03
024 Cit� Mion,4,4,8,2022,01-19,21:03
025 Nouveau Saint-Roch,3,5,8,2022,01-19,21:03
026 Renouvier,1,7,8,2022,01-19,21:03
027 Odysseum,2,6,8,2022,01-19,21:03
028 Saint-Denis,2,6,8,2022,01-19,21:03
029 Richter,11,5,16,2022,01-19,21:03
030 Charles Flahault,2,6,8,2022,01-19,21:03
031 Voltaire,0,8,8,2022,01-19,21:03
032 Pr�s d'Ar�nes,7,1,8,2022,01-19,21:03
033 Garcia Lorca,7,1,8,2022,01-19,21:03
034 Vert Bois,0,16,16,2022,01-19,21:03
035 Malbosc,1,7,8,2022,01-19,21:03
036 Occitanie,3,29,32,2022,01-19,21:03
037 FacdesSciences,0,24,24,2022,01-19,21:03
038 Fac de Lettres,2,14,16,2022,01-19,21:03
039 Aiguelongue,2,6,8,2022,01-19,21:03
040 Jeu de Mail des Abb�s,6,2,8,2022,01-19,21:03
041 Eurom�decine,0,8,8,2022,01-19,21:03
042 Marie Caizergues,2,6,8,2022,01-19,21:03
043 Sabines,4,4,8,2022,01-19,21:03
044 Celleneuve,0,8,8,2022,01-19,21:03
045 Jardin de la Lironde,2,6,8,2022,01-19,21:03
046 P�re Soulas,3,5,8,2022,01-19,21:03
047 Place Viala,1,7,8,2022,01-19,21:03
048 H�tel du D�partement,0,8,8,2022,01-19,21:03
049 Tonnelles,3,5,8,2022,01-19,21:03
050 Parvis Jules Ferry - Gare Saint-Roch,4,4,8,2022,01-19,21:03
051 Pont de Lattes - Gare Saint-Roch,1,11,12,2022,01-19,21:03
053 Deux Ponts - Gare Saint-Roch,1,7,8,2022,01-19,21:03
054 Providence - Ovalie,4,4,8,2022,01-19,21:03
055 P�rols Etang de l'Or,25,43,68,2022,01-19,21:03
056 Albert 1er - Cath�drale,5,7,12,2022,01-19,21:03
057 Saint-Guilhem - Courreau,1,7,8,2022,01-19,21:03
059 Sud De France,0,8,8,2022,01-19,21:03
001 Rue Jules Ferry - Gare Saint-Roch,8,4,12,2022,01-19,21:13
002 Com�die,11,13,24,2022,01-19,21:13
003 Esplanade,12,20,32,2022,01-19,21:13
004 H�tel de Ville,5,11,16,2022,01-19,21:13
005 Corum,5,7,12,2022,01-19,21:13
006 Place Albert 1er - St Charles,30,1,31,2022,01-19,21:13
007 Foch,6,2,8,2022,01-19,21:13
008 Halles Castellane,3,9,12,2022,01-19,21:13
009 Observatoire,7,1,8,2022,01-19,21:13
010 Rondelet,3,13,16,2022,01-19,21:13
011 Plan Cabanes,7,5,12,2022,01-19,21:13
012 Boutonnet,4,8,12,2022,01-19,21:13
013 Emile Combes,3,5,8,2022,01-19,21:13
014 Beaux-Arts,3,5,8,2022,01-19,21:13
015 Les Aubes,5,3,8,2022,01-19,21:13
016 Antigone centre,16,0,16,2022,01-19,21:13
017 M�diath�que Emile Zola,16,0,16,2022,01-19,21:13
018 Nombre d'Or,7,9,16,2022,01-19,21:13
019 Louis Blanc,16,0,16,2022,01-19,21:13
020 Gambetta,4,4,8,2022,01-19,21:13
021 Port Marianne,5,11,16,2022,01-19,21:13
022 Clemenceau,2,10,12,2022,01-19,21:13
023 Les Arceaux,3,13,16,2022,01-19,21:13
024 Cit� Mion,4,4,8,2022,01-19,21:13
025 Nouveau Saint-Roch,3,5,8,2022,01-19,21:13
026 Renouvier,1,7,8,2022,01-19,21:13
027 Odysseum,2,6,8,2022,01-19,21:13
028 Saint-Denis,2,6,8,2022,01-19,21:13
029 Richter,11,5,16,2022,01-19,21:13
030 Charles Flahault,2,6,8,2022,01-19,21:13
031 Voltaire,0,8,8,2022,01-19,21:13
032 Pr�s d'Ar�nes,7,1,8,2022,01-19,21:13
033 Garcia Lorca,7,1,8,2022,01-19,21:13
034 Vert Bois,0,16,16,2022,01-19,21:13
035 Malbosc,1,7,8,2022,01-19,21:13
036 Occitanie,3,29,32,2022,01-19,21:13
037 FacdesSciences,0,24,24,2022,01-19,21:13
038 Fac de Lettres,2,14,16,2022,01-19,21:13
039 Aiguelongue,2,6,8,2022,01-19,21:13
040 Jeu de Mail des Abb�s,6,2,8,2022,01-19,21:13
041 Eurom�decine,0,8,8,2022,01-19,21:13
042 Marie Caizergues,1,7,8,2022,01-19,21:13
043 Sabines,4,4,8,2022,01-19,21:13
044 Celleneuve,0,8,8,2022,01-19,21:13
045 Jardin de la Lironde,2,6,8,2022,01-19,21:13
046 P�re Soulas,3,5,8,2022,01-19,21:13
047 Place Viala,1,7,8,2022,01-19,21:13
048 H�tel du D�partement,0,8,8,2022,01-19,21:13
049 Tonnelles,4,4,8,2022,01-19,21:13
050 Parvis Jules Ferry - Gare Saint-Roch,4,4,8,2022,01-19,21:13
051 Pont de Lattes - Gare Saint-Roch,1,11,12,2022,01-19,21:13
053 Deux Ponts - Gare Saint-Roch,1,7,8,2022,01-19,21:13
054 Providence - Ovalie,4,4,8,2022,01-19,21:13
055 P�rols Etang de l'Or,25,43,68,2022,01-19,21:13
056 Albert 1er - Cath�drale,5,7,12,2022,01-19,21:13
057 Saint-Guilhem - Courreau,1,7,8,2022,01-19,21:13
059 Sud De France,0,8,8,2022,01-19,21:13
001 Rue Jules Ferry - Gare Saint-Roch,8,4,12,2022,01-19,21:23
002 Com�die,12,12,24,2022,01-19,21:23
003 Esplanade,12,20,32,2022,01-19,21:23
004 H�tel de Ville,5,11,16,2022,01-19,21:23
005 Corum,5,7,12,2022,01-19,21:23
006 Place Albert 1er - St Charles,31,0,31,2022,01-19,21:23
007 Foch,6,2,8,2022,01-19,21:23
008 Halles Castellane,3,9,12,2022,01-19,21:23
009 Observatoire,7,1,8,2022,01-19,21:23
010 Rondelet,3,13,16,2022,01-19,21:23
011 Plan Cabanes,7,5,12,2022,01-19,21:23
012 Boutonnet,4,8,12,2022,01-19,21:23
013 Emile Combes,3,5,8,2022,01-19,21:23
014 Beaux-Arts,3,5,8,2022,01-19,21:23
015 Les Aubes,5,3,8,2022,01-19,21:23
016 Antigone centre,16,0,16,2022,01-19,21:23
017 M�diath�que Emile Zola,16,0,16,2022,01-19,21:23
018 Nombre d'Or,7,9,16,2022,01-19,21:23
019 Louis Blanc,16,0,16,2022,01-19,21:23
020 Gambetta,4,4,8,2022,01-19,21:23
021 Port Marianne,5,11,16,2022,01-19,21:23
022 Clemenceau,2,10,12,2022,01-19,21:23
023 Les Arceaux,5,11,16,2022,01-19,21:23
024 Cit� Mion,4,4,8,2022,01-19,21:23
025 Nouveau Saint-Roch,3,5,8,2022,01-19,21:23
026 Renouvier,1,7,8,2022,01-19,21:23
027 Odysseum,2,6,8,2022,01-19,21:23
028 Saint-Denis,2,6,8,2022,01-19,21:23
029 Richter,11,5,16,2022,01-19,21:23
030 Charles Flahault,2,6,8,2022,01-19,21:23
031 Voltaire,0,8,8,2022,01-19,21:23
032 Pr�s d'Ar�nes,7,1,8,2022,01-19,21:23
033 Garcia Lorca,7,1,8,2022,01-19,21:23
034 Vert Bois,0,16,16,2022,01-19,21:23
035 Malbosc,1,7,8,2022,01-19,21:23
036 Occitanie,3,29,32,2022,01-19,21:23
037 FacdesSciences,0,24,24,2022,01-19,21:23
038 Fac de Lettres,2,14,16,2022,01-19,21:23
039 Aiguelongue,3,5,8,2022,01-19,21:23
040 Jeu de Mail des Abb�s,6,2,8,2022,01-19,21:23
041 Eurom�decine,0,8,8,2022,01-19,21:23
042 Marie Caizergues,1,7,8,2022,01-19,21:23
043 Sabines,4,4,8,2022,01-19,21:23
044 Celleneuve,1,7,8,2022,01-19,21:23
045 Jardin de la Lironde,2,6,8,2022,01-19,21:23
046 P�re Soulas,4,4,8,2022,01-19,21:23
047 Place Viala,1,7,8,2022,01-19,21:23
048 H�tel du D�partement,0,8,8,2022,01-19,21:23
049 Tonnelles,4,4,8,2022,01-19,21:23
050 Parvis Jules Ferry - Gare Saint-Roch,4,4,8,2022,01-19,21:23
051 Pont de Lattes - Gare Saint-Roch,1,11,12,2022,01-19,21:23
053 Deux Ponts - Gare Saint-Roch,1,7,8,2022,01-19,21:23
054 Providence - Ovalie,4,4,8,2022,01-19,21:23
055 P�rols Etang de l'Or,25,43,68,2022,01-19,21:23
056 Albert 1er - Cath�drale,5,7,12,2022,01-19,21:23
057 Saint-Guilhem - Courreau,2,6,8,2022,01-19,21:23
059 Sud De France,0,8,8,2022,01-19,21:23
001 Rue Jules Ferry - Gare Saint-Roch,8,4,12,2022,01-19,21:33
002 Com�die,11,13,24,2022,01-19,21:33
003 Esplanade,15,17,32,2022,01-19,21:33
004 H�tel de Ville,5,11,16,2022,01-19,21:33
005 Corum,5,7,12,2022,01-19,21:33
006 Place Albert 1er - St Charles,31,0,31,2022,01-19,21:33
007 Foch,6,2,8,2022,01-19,21:33
008 Halles Castellane,3,9,12,2022,01-19,21:33
009 Observatoire,7,1,8,2022,01-19,21:33
010 Rondelet,3,13,16,2022,01-19,21:33
011 Plan Cabanes,7,5,12,2022,01-19,21:33
012 Boutonnet,4,8,12,2022,01-19,21:33
013 Emile Combes,3,5,8,2022,01-19,21:33
014 Beaux-Arts,3,5,8,2022,01-19,21:33
015 Les Aubes,4,4,8,2022,01-19,21:33
016 Antigone centre,16,0,16,2022,01-19,21:33
017 M�diath�que Emile Zola,16,0,16,2022,01-19,21:33
018 Nombre d'Or,7,9,16,2022,01-19,21:33
019 Louis Blanc,16,0,16,2022,01-19,21:33
020 Gambetta,4,4,8,2022,01-19,21:33
021 Port Marianne,5,11,16,2022,01-19,21:33
022 Clemenceau,2,10,12,2022,01-19,21:33
023 Les Arceaux,5,11,16,2022,01-19,21:33
024 Cit� Mion,4,4,8,2022,01-19,21:33
025 Nouveau Saint-Roch,3,5,8,2022,01-19,21:33
026 Renouvier,1,7,8,2022,01-19,21:33
027 Odysseum,2,6,8,2022,01-19,21:33
028 Saint-Denis,2,6,8,2022,01-19,21:33
029 Richter,11,5,16,2022,01-19,21:33
030 Charles Flahault,2,6,8,2022,01-19,21:33
031 Voltaire,0,8,8,2022,01-19,21:33
032 Pr�s d'Ar�nes,7,1,8,2022,01-19,21:33
033 Garcia Lorca,7,1,8,2022,01-19,21:33
034 Vert Bois,0,16,16,2022,01-19,21:33
035 Malbosc,1,7,8,2022,01-19,21:33
036 Occitanie,3,29,32,2022,01-19,21:33
037 FacdesSciences,0,24,24,2022,01-19,21:33
038 Fac de Lettres,2,14,16,2022,01-19,21:33
039 Aiguelongue,3,5,8,2022,01-19,21:33
040 Jeu de Mail des Abb�s,7,1,8,2022,01-19,21:33
041 Eurom�decine,0,8,8,2022,01-19,21:33
042 Marie Caizergues,1,7,8,2022,01-19,21:33
043 Sabines,4,4,8,2022,01-19,21:33
044 Celleneuve,1,7,8,2022,01-19,21:33
045 Jardin de la Lironde,2,6,8,2022,01-19,21:33
046 P�re Soulas,4,4,8,2022,01-19,21:33
047 Place Viala,1,7,8,2022,01-19,21:33
048 H�tel du D�partement,0,8,8,2022,01-19,21:33
049 Tonnelles,4,4,8,2022,01-19,21:33
050 Parvis Jules Ferry - Gare Saint-Roch,4,4,8,2022,01-19,21:33
051 Pont de Lattes - Gare Saint-Roch,1,11,12,2022,01-19,21:33
053 Deux Ponts - Gare Saint-Roch,1,7,8,2022,01-19,21:33
054 Providence - Ovalie,4,4,8,2022,01-19,21:33
055 P�rols Etang de l'Or,25,43,68,2022,01-19,21:33
056 Albert 1er - Cath�drale,5,7,12,2022,01-19,21:33
057 Saint-Guilhem - Courreau,2,6,8,2022,01-19,21:33
059 Sud De France,0,8,8,2022,01-19,21:33
001 Rue Jules Ferry - Gare Saint-Roch,8,4,12,2022,01-19,21:43
002 Com�die,11,13,24,2022,01-19,21:43
003 Esplanade,15,17,32,2022,01-19,21:43
004 H�tel de Ville,5,11,16,2022,01-19,21:43
005 Corum,6,6,12,2022,01-19,21:43
006 Place Albert 1er - St Charles,31,0,31,2022,01-19,21:43
007 Foch,6,2,8,2022,01-19,21:43
008 Halles Castellane,3,9,12,2022,01-19,21:43
009 Observatoire,7,1,8,2022,01-19,21:43
010 Rondelet,3,13,16,2022,01-19,21:43
011 Plan Cabanes,5,7,12,2022,01-19,21:43
012 Boutonnet,3,9,12,2022,01-19,21:43
013 Emile Combes,3,5,8,2022,01-19,21:43
014 Beaux-Arts,3,5,8,2022,01-19,21:43
015 Les Aubes,4,4,8,2022,01-19,21:43
016 Antigone centre,16,0,16,2022,01-19,21:43
017 M�diath�que Emile Zola,16,0,16,2022,01-19,21:43
018 Nombre d'Or,7,9,16,2022,01-19,21:43
019 Louis Blanc,16,0,16,2022,01-19,21:43
020 Gambetta,4,4,8,2022,01-19,21:43
021 Port Marianne,5,11,16,2022,01-19,21:43
022 Clemenceau,2,10,12,2022,01-19,21:43
023 Les Arceaux,3,13,16,2022,01-19,21:43
024 Cit� Mion,4,4,8,2022,01-19,21:43
025 Nouveau Saint-Roch,3,5,8,2022,01-19,21:43
026 Renouvier,1,7,8,2022,01-19,21:43
027 Odysseum,2,6,8,2022,01-19,21:43
028 Saint-Denis,2,6,8,2022,01-19,21:43
029 Richter,11,5,16,2022,01-19,21:43
030 Charles Flahault,2,6,8,2022,01-19,21:43
031 Voltaire,0,8,8,2022,01-19,21:43
032 Pr�s d'Ar�nes,7,1,8,2022,01-19,21:43
033 Garcia Lorca,7,1,8,2022,01-19,21:43
034 Vert Bois,0,16,16,2022,01-19,21:43
035 Malbosc,1,7,8,2022,01-19,21:43
036 Occitanie,3,29,32,2022,01-19,21:43
037 FacdesSciences,0,24,24,2022,01-19,21:43
038 Fac de Lettres,2,14,16,2022,01-19,21:43
039 Aiguelongue,3,5,8,2022,01-19,21:43
040 Jeu de Mail des Abb�s,7,1,8,2022,01-19,21:43
041 Eurom�decine,0,8,8,2022,01-19,21:43
042 Marie Caizergues,1,7,8,2022,01-19,21:43
043 Sabines,4,4,8,2022,01-19,21:43
044 Celleneuve,1,7,8,2022,01-19,21:43
045 Jardin de la Lironde,2,6,8,2022,01-19,21:43
046 P�re Soulas,4,4,8,2022,01-19,21:43
047 Place Viala,1,7,8,2022,01-19,21:43
048 H�tel du D�partement,0,8,8,2022,01-19,21:43
049 Tonnelles,4,4,8,2022,01-19,21:43
050 Parvis Jules Ferry - Gare Saint-Roch,4,4,8,2022,01-19,21:43
051 Pont de Lattes - Gare Saint-Roch,1,11,12,2022,01-19,21:43
053 Deux Ponts - Gare Saint-Roch,1,7,8,2022,01-19,21:43
054 Providence - Ovalie,4,4,8,2022,01-19,21:43
055 P�rols Etang de l'Or,25,43,68,2022,01-19,21:43
056 Albert 1er - Cath�drale,5,7,12,2022,01-19,21:43
057 Saint-Guilhem - Courreau,2,6,8,2022,01-19,21:43
059 Sud De France,0,8,8,2022,01-19,21:43
001 Rue Jules Ferry - Gare Saint-Roch,8,4,12,2022,01-19,21:54
002 Com�die,11,13,24,2022,01-19,21:54
003 Esplanade,15,17,32,2022,01-19,21:54
004 H�tel de Ville,5,11,16,2022,01-19,21:54
005 Corum,8,4,12,2022,01-19,21:54
006 Place Albert 1er - St Charles,31,0,31,2022,01-19,21:54
007 Foch,6,2,8,2022,01-19,21:54
008 Halles Castellane,4,8,12,2022,01-19,21:54
009 Observatoire,7,1,8,2022,01-19,21:54
010 Rondelet,3,13,16,2022,01-19,21:54
011 Plan Cabanes,5,7,12,2022,01-19,21:54
012 Boutonnet,3,9,12,2022,01-19,21:54
013 Emile Combes,3,5,8,2022,01-19,21:54
014 Beaux-Arts,3,5,8,2022,01-19,21:54
015 Les Aubes,4,4,8,2022,01-19,21:54
016 Antigone centre,16,0,16,2022,01-19,21:54
017 M�diath�que Emile Zola,16,0,16,2022,01-19,21:54
018 Nombre d'Or,7,9,16,2022,01-19,21:54
019 Louis Blanc,16,0,16,2022,01-19,21:54
020 Gambetta,4,4,8,2022,01-19,21:54
021 Port Marianne,5,11,16,2022,01-19,21:54
022 Clemenceau,2,10,12,2022,01-19,21:54
023 Les Arceaux,3,13,16,2022,01-19,21:54
024 Cit� Mion,4,4,8,2022,01-19,21:54
025 Nouveau Saint-Roch,4,4,8,2022,01-19,21:54
026 Renouvier,1,7,8,2022,01-19,21:54
027 Odysseum,2,6,8,2022,01-19,21:54
028 Saint-Denis,4,4,8,2022,01-19,21:54
029 Richter,11,5,16,2022,01-19,21:54
030 Charles Flahault,2,6,8,2022,01-19,21:54
031 Voltaire,0,8,8,2022,01-19,21:54
032 Pr�s d'Ar�nes,7,1,8,2022,01-19,21:54
033 Garcia Lorca,7,1,8,2022,01-19,21:54
034 Vert Bois,0,16,16,2022,01-19,21:54
035 Malbosc,1,7,8,2022,01-19,21:54
036 Occitanie,3,29,32,2022,01-19,21:54
037 FacdesSciences,0,24,24,2022,01-19,21:54
038 Fac de Lettres,2,14,16,2022,01-19,21:54
039 Aiguelongue,3,5,8,2022,01-19,21:54
040 Jeu de Mail des Abb�s,7,1,8,2022,01-19,21:54
041 Eurom�decine,0,8,8,2022,01-19,21:54
042 Marie Caizergues,1,7,8,2022,01-19,21:54
043 Sabines,4,4,8,2022,01-19,21:54
044 Celleneuve,1,7,8,2022,01-19,21:54
045 Jardin de la Lironde,2,6,8,2022,01-19,21:54
046 P�re Soulas,3,5,8,2022,01-19,21:54
047 Place Viala,1,7,8,2022,01-19,21:54
048 H�tel du D�partement,0,8,8,2022,01-19,21:54
049 Tonnelles,4,4,8,2022,01-19,21:54
050 Parvis Jules Ferry - Gare Saint-Roch,4,4,8,2022,01-19,21:54
051 Pont de Lattes - Gare Saint-Roch,1,11,12,2022,01-19,21:54
053 Deux Ponts - Gare Saint-Roch,1,7,8,2022,01-19,21:54
054 Providence - Ovalie,4,4,8,2022,01-19,21:54
055 P�rols Etang de l'Or,25,43,68,2022,01-19,21:54
056 Albert 1er - Cath�drale,5,7,12,2022,01-19,21:54
057 Saint-Guilhem - Courreau,2,6,8,2022,01-19,21:54
059 Sud De France,0,8,8,2022,01-19,21:54
001 Rue Jules Ferry - Gare Saint-Roch,8,4,12,2022,01-19,22:04
002 Com�die,11,13,24,2022,01-19,22:04
003 Esplanade,15,17,32,2022,01-19,22:04
004 H�tel de Ville,5,11,16,2022,01-19,22:04
005 Corum,8,4,12,2022,01-19,22:04
006 Place Albert 1er - St Charles,31,0,31,2022,01-19,22:04
007 Foch,6,2,8,2022,01-19,22:04
008 Halles Castellane,4,8,12,2022,01-19,22:04
009 Observatoire,7,1,8,2022,01-19,22:04
010 Rondelet,3,13,16,2022,01-19,22:04
011 Plan Cabanes,5,7,12,2022,01-19,22:04
012 Boutonnet,2,10,12,2022,01-19,22:04
013 Emile Combes,3,5,8,2022,01-19,22:04
014 Beaux-Arts,3,5,8,2022,01-19,22:04
015 Les Aubes,4,4,8,2022,01-19,22:04
016 Antigone centre,16,0,16,2022,01-19,22:04
017 M�diath�que Emile Zola,16,0,16,2022,01-19,22:04
018 Nombre d'Or,7,9,16,2022,01-19,22:04
019 Louis Blanc,16,0,16,2022,01-19,22:04
020 Gambetta,4,4,8,2022,01-19,22:04
021 Port Marianne,5,11,16,2022,01-19,22:04
022 Clemenceau,1,11,12,2022,01-19,22:04
023 Les Arceaux,3,13,16,2022,01-19,22:04
024 Cit� Mion,4,4,8,2022,01-19,22:04
025 Nouveau Saint-Roch,4,4,8,2022,01-19,22:04
026 Renouvier,1,7,8,2022,01-19,22:04
027 Odysseum,2,6,8,2022,01-19,22:04
028 Saint-Denis,4,4,8,2022,01-19,22:04
029 Richter,11,5,16,2022,01-19,22:04
030 Charles Flahault,2,6,8,2022,01-19,22:04
031 Voltaire,0,8,8,2022,01-19,22:04
032 Pr�s d'Ar�nes,7,1,8,2022,01-19,22:04
033 Garcia Lorca,7,1,8,2022,01-19,22:04
034 Vert Bois,0,16,16,2022,01-19,22:04
035 Malbosc,1,7,8,2022,01-19,22:04
036 Occitanie,3,29,32,2022,01-19,22:04
037 FacdesSciences,1,23,24,2022,01-19,22:04
038 Fac de Lettres,2,14,16,2022,01-19,22:04
039 Aiguelongue,3,5,8,2022,01-19,22:04
040 Jeu de Mail des Abb�s,7,1,8,2022,01-19,22:04
041 Eurom�decine,0,8,8,2022,01-19,22:04
042 Marie Caizergues,1,7,8,2022,01-19,22:04
043 Sabines,4,4,8,2022,01-19,22:04
044 Celleneuve,1,7,8,2022,01-19,22:04
045 Jardin de la Lironde,2,6,8,2022,01-19,22:04
046 P�re Soulas,3,5,8,2022,01-19,22:04
047 Place Viala,1,7,8,2022,01-19,22:04
048 H�tel du D�partement,0,8,8,2022,01-19,22:04
049 Tonnelles,4,4,8,2022,01-19,22:04
050 Parvis Jules Ferry - Gare Saint-Roch,4,4,8,2022,01-19,22:04
051 Pont de Lattes - Gare Saint-Roch,1,11,12,2022,01-19,22:04
053 Deux Ponts - Gare Saint-Roch,1,7,8,2022,01-19,22:04
054 Providence - Ovalie,4,4,8,2022,01-19,22:04
055 P�rols Etang de l'Or,25,43,68,2022,01-19,22:04
056 Albert 1er - Cath�drale,5,7,12,2022,01-19,22:04
057 Saint-Guilhem - Courreau,1,7,8,2022,01-19,22:04
059 Sud De France,0,8,8,2022,01-19,22:04
001 Rue Jules Ferry - Gare Saint-Roch,8,4,12,2022,01-19,22:14
002 Com�die,9,15,24,2022,01-19,22:14
003 Esplanade,12,20,32,2022,01-19,22:14
004 H�tel de Ville,6,10,16,2022,01-19,22:14
005 Corum,8,4,12,2022,01-19,22:14
006 Place Albert 1er - St Charles,31,0,31,2022,01-19,22:14
007 Foch,6,2,8,2022,01-19,22:14
008 Halles Castellane,4,8,12,2022,01-19,22:14
009 Observatoire,7,1,8,2022,01-19,22:14
010 Rondelet,3,13,16,2022,01-19,22:14
011 Plan Cabanes,5,7,12,2022,01-19,22:14
012 Boutonnet,2,10,12,2022,01-19,22:14
013 Emile Combes,3,5,8,2022,01-19,22:14
014 Beaux-Arts,3,5,8,2022,01-19,22:14
015 Les Aubes,4,4,8,2022,01-19,22:14
016 Antigone centre,16,0,16,2022,01-19,22:14
017 M�diath�que Emile Zola,16,0,16,2022,01-19,22:14
018 Nombre d'Or,7,9,16,2022,01-19,22:14
019 Louis Blanc,16,0,16,2022,01-19,22:14
020 Gambetta,4,4,8,2022,01-19,22:14
021 Port Marianne,5,11,16,2022,01-19,22:14
022 Clemenceau,1,11,12,2022,01-19,22:14
023 Les Arceaux,3,13,16,2022,01-19,22:14
024 Cit� Mion,4,4,8,2022,01-19,22:14
025 Nouveau Saint-Roch,4,4,8,2022,01-19,22:14
026 Renouvier,1,7,8,2022,01-19,22:14
027 Odysseum,0,8,8,2022,01-19,22:14
028 Saint-Denis,4,4,8,2022,01-19,22:14
029 Richter,11,5,16,2022,01-19,22:14
030 Charles Flahault,2,6,8,2022,01-19,22:14
031 Voltaire,0,8,8,2022,01-19,22:14
032 Pr�s d'Ar�nes,7,1,8,2022,01-19,22:14
033 Garcia Lorca,7,1,8,2022,01-19,22:14
034 Vert Bois,0,16,16,2022,01-19,22:14
035 Malbosc,1,7,8,2022,01-19,22:14
036 Occitanie,3,29,32,2022,01-19,22:14
037 FacdesSciences,1,23,24,2022,01-19,22:14
038 Fac de Lettres,2,14,16,2022,01-19,22:14
039 Aiguelongue,3,5,8,2022,01-19,22:14
040 Jeu de Mail des Abb�s,7,1,8,2022,01-19,22:14
041 Eurom�decine,0,8,8,2022,01-19,22:14
042 Marie Caizergues,1,7,8,2022,01-19,22:14
043 Sabines,4,4,8,2022,01-19,22:14
044 Celleneuve,1,7,8,2022,01-19,22:14
045 Jardin de la Lironde,2,6,8,2022,01-19,22:14
046 P�re Soulas,4,4,8,2022,01-19,22:14
047 Place Viala,1,7,8,2022,01-19,22:14
048 H�tel du D�partement,0,8,8,2022,01-19,22:14
049 Tonnelles,4,4,8,2022,01-19,22:14
050 Parvis Jules Ferry - Gare Saint-Roch,5,3,8,2022,01-19,22:14
051 Pont de Lattes - Gare Saint-Roch,1,11,12,2022,01-19,22:14
053 Deux Ponts - Gare Saint-Roch,1,7,8,2022,01-19,22:14
054 Providence - Ovalie,4,4,8,2022,01-19,22:14
055 P�rols Etang de l'Or,25,43,68,2022,01-19,22:14
056 Albert 1er - Cath�drale,5,7,12,2022,01-19,22:14
057 Saint-Guilhem - Courreau,1,7,8,2022,01-19,22:14
059 Sud De France,0,8,8,2022,01-19,22:14
001 Rue Jules Ferry - Gare Saint-Roch,8,4,12,2022,01-19,22:24
002 Com�die,9,15,24,2022,01-19,22:24
003 Esplanade,11,21,32,2022,01-19,22:24
004 H�tel de Ville,6,10,16,2022,01-19,22:24
005 Corum,10,2,12,2022,01-19,22:24
006 Place Albert 1er - St Charles,31,0,31,2022,01-19,22:24
007 Foch,6,2,8,2022,01-19,22:24
008 Halles Castellane,3,9,12,2022,01-19,22:24
009 Observatoire,7,1,8,2022,01-19,22:24
010 Rondelet,3,13,16,2022,01-19,22:24
011 Plan Cabanes,4,8,12,2022,01-19,22:24
012 Boutonnet,2,10,12,2022,01-19,22:24
013 Emile Combes,3,5,8,2022,01-19,22:24
014 Beaux-Arts,3,5,8,2022,01-19,22:24
015 Les Aubes,4,4,8,2022,01-19,22:24
016 Antigone centre,16,0,16,2022,01-19,22:24
017 M�diath�que Emile Zola,16,0,16,2022,01-19,22:24
018 Nombre d'Or,7,9,16,2022,01-19,22:24
019 Louis Blanc,16,0,16,2022,01-19,22:24
020 Gambetta,4,4,8,2022,01-19,22:24
021 Port Marianne,5,11,16,2022,01-19,22:24
022 Clemenceau,1,11,12,2022,01-19,22:24
023 Les Arceaux,3,13,16,2022,01-19,22:24
024 Cit� Mion,4,4,8,2022,01-19,22:24
025 Nouveau Saint-Roch,4,4,8,2022,01-19,22:24
026 Renouvier,1,7,8,2022,01-19,22:24
027 Odysseum,0,8,8,2022,01-19,22:24
028 Saint-Denis,4,4,8,2022,01-19,22:24
029 Richter,11,5,16,2022,01-19,22:24
030 Charles Flahault,2,6,8,2022,01-19,22:24
031 Voltaire,0,8,8,2022,01-19,22:24
032 Pr�s d'Ar�nes,7,1,8,2022,01-19,22:24
033 Garcia Lorca,7,1,8,2022,01-19,22:24
034 Vert Bois,0,16,16,2022,01-19,22:24
035 Malbosc,1,7,8,2022,01-19,22:24
036 Occitanie,3,29,32,2022,01-19,22:24
037 FacdesSciences,1,23,24,2022,01-19,22:24
038 Fac de Lettres,2,14,16,2022,01-19,22:24
039 Aiguelongue,3,5,8,2022,01-19,22:24
040 Jeu de Mail des Abb�s,7,1,8,2022,01-19,22:24
041 Eurom�decine,0,8,8,2022,01-19,22:24
042 Marie Caizergues,1,7,8,2022,01-19,22:24
043 Sabines,4,4,8,2022,01-19,22:24
044 Celleneuve,1,7,8,2022,01-19,22:24
045 Jardin de la Lironde,2,6,8,2022,01-19,22:24
046 P�re Soulas,4,4,8,2022,01-19,22:24
047 Place Viala,1,7,8,2022,01-19,22:24
048 H�tel du D�partement,0,8,8,2022,01-19,22:24
049 Tonnelles,4,4,8,2022,01-19,22:24
050 Parvis Jules Ferry - Gare Saint-Roch,5,3,8,2022,01-19,22:24
051 Pont de Lattes - Gare Saint-Roch,1,11,12,2022,01-19,22:24
053 Deux Ponts - Gare Saint-Roch,1,7,8,2022,01-19,22:24
054 Providence - Ovalie,4,4,8,2022,01-19,22:24
055 P�rols Etang de l'Or,25,43,68,2022,01-19,22:24
056 Albert 1er - Cath�drale,5,7,12,2022,01-19,22:24
057 Saint-Guilhem - Courreau,0,8,8,2022,01-19,22:24
059 Sud De France,0,8,8,2022,01-19,22:24
001 Rue Jules Ferry - Gare Saint-Roch,8,4,12,2022,01-19,22:34
002 Com�die,8,16,24,2022,01-19,22:34
003 Esplanade,11,21,32,2022,01-19,22:34
004 H�tel de Ville,8,8,16,2022,01-19,22:34
005 Corum,10,2,12,2022,01-19,22:34
006 Place Albert 1er - St Charles,31,0,31,2022,01-19,22:34
007 Foch,6,2,8,2022,01-19,22:34
008 Halles Castellane,3,9,12,2022,01-19,22:34
009 Observatoire,7,1,8,2022,01-19,22:34
010 Rondelet,3,13,16,2022,01-19,22:34
011 Plan Cabanes,5,7,12,2022,01-19,22:34
012 Boutonnet,2,10,12,2022,01-19,22:34
013 Emile Combes,3,5,8,2022,01-19,22:34
014 Beaux-Arts,3,5,8,2022,01-19,22:34
015 Les Aubes,4,4,8,2022,01-19,22:34
016 Antigone centre,16,0,16,2022,01-19,22:34
017 M�diath�que Emile Zola,16,0,16,2022,01-19,22:34
018 Nombre d'Or,7,9,16,2022,01-19,22:34
019 Louis Blanc,16,0,16,2022,01-19,22:34
020 Gambetta,4,4,8,2022,01-19,22:34
021 Port Marianne,5,11,16,2022,01-19,22:34
022 Clemenceau,1,11,12,2022,01-19,22:34
023 Les Arceaux,3,13,16,2022,01-19,22:34
024 Cit� Mion,4,4,8,2022,01-19,22:34
025 Nouveau Saint-Roch,5,3,8,2022,01-19,22:34
026 Renouvier,1,7,8,2022,01-19,22:34
027 Odysseum,0,8,8,2022,01-19,22:34
028 Saint-Denis,3,5,8,2022,01-19,22:34
029 Richter,11,5,16,2022,01-19,22:34
030 Charles Flahault,3,5,8,2022,01-19,22:34
031 Voltaire,0,8,8,2022,01-19,22:34
032 Pr�s d'Ar�nes,7,1,8,2022,01-19,22:34
033 Garcia Lorca,7,1,8,2022,01-19,22:34
034 Vert Bois,0,16,16,2022,01-19,22:34
035 Malbosc,1,7,8,2022,01-19,22:34
036 Occitanie,2,30,32,2022,01-19,22:34
037 FacdesSciences,1,23,24,2022,01-19,22:34
038 Fac de Lettres,2,14,16,2022,01-19,22:34
039 Aiguelongue,3,5,8,2022,01-19,22:34
040 Jeu de Mail des Abb�s,7,1,8,2022,01-19,22:34
041 Eurom�decine,0,8,8,2022,01-19,22:34
042 Marie Caizergues,1,7,8,2022,01-19,22:34
043 Sabines,4,4,8,2022,01-19,22:34
044 Celleneuve,1,7,8,2022,01-19,22:34
045 Jardin de la Lironde,2,6,8,2022,01-19,22:34
046 P�re Soulas,4,4,8,2022,01-19,22:34
047 Place Viala,1,7,8,2022,01-19,22:34
048 H�tel du D�partement,0,8,8,2022,01-19,22:34
049 Tonnelles,4,4,8,2022,01-19,22:34
050 Parvis Jules Ferry - Gare Saint-Roch,5,3,8,2022,01-19,22:34
051 Pont de Lattes - Gare Saint-Roch,1,11,12,2022,01-19,22:34
053 Deux Ponts - Gare Saint-Roch,1,7,8,2022,01-19,22:34
054 Providence - Ovalie,4,4,8,2022,01-19,22:34
055 P�rols Etang de l'Or,25,43,68,2022,01-19,22:34
056 Albert 1er - Cath�drale,5,7,12,2022,01-19,22:34
057 Saint-Guilhem - Courreau,0,8,8,2022,01-19,22:34
059 Sud De France,0,8,8,2022,01-19,22:34
001 Rue Jules Ferry - Gare Saint-Roch,8,4,12,2022,01-19,22:45
002 Com�die,8,16,24,2022,01-19,22:45
003 Esplanade,11,21,32,2022,01-19,22:45
004 H�tel de Ville,8,8,16,2022,01-19,22:45
005 Corum,11,1,12,2022,01-19,22:45
006 Place Albert 1er - St Charles,31,0,31,2022,01-19,22:45
007 Foch,6,2,8,2022,01-19,22:45
008 Halles Castellane,3,9,12,2022,01-19,22:45
009 Observatoire,7,1,8,2022,01-19,22:45
010 Rondelet,3,13,16,2022,01-19,22:45
011 Plan Cabanes,6,6,12,2022,01-19,22:45
012 Boutonnet,2,10,12,2022,01-19,22:45
013 Emile Combes,3,5,8,2022,01-19,22:45
014 Beaux-Arts,3,5,8,2022,01-19,22:45
015 Les Aubes,4,4,8,2022,01-19,22:45
016 Antigone centre,16,0,16,2022,01-19,22:45
017 M�diath�que Emile Zola,16,0,16,2022,01-19,22:45
018 Nombre d'Or,7,9,16,2022,01-19,22:45
019 Louis Blanc,16,0,16,2022,01-19,22:45
020 Gambetta,4,4,8,2022,01-19,22:45
021 Port Marianne,5,11,16,2022,01-19,22:45
022 Clemenceau,1,11,12,2022,01-19,22:45
023 Les Arceaux,3,13,16,2022,01-19,22:45
024 Cit� Mion,4,4,8,2022,01-19,22:45
025 Nouveau Saint-Roch,5,3,8,2022,01-19,22:45
026 Renouvier,1,7,8,2022,01-19,22:45
027 Odysseum,0,8,8,2022,01-19,22:45
028 Saint-Denis,3,5,8,2022,01-19,22:45
029 Richter,12,4,16,2022,01-19,22:45
030 Charles Flahault,3,5,8,2022,01-19,22:45
031 Voltaire,0,8,8,2022,01-19,22:45
032 Pr�s d'Ar�nes,7,1,8,2022,01-19,22:45
033 Garcia Lorca,7,1,8,2022,01-19,22:45
034 Vert Bois,0,16,16,2022,01-19,22:45
035 Malbosc,1,7,8,2022,01-19,22:45
036 Occitanie,2,30,32,2022,01-19,22:45
037 FacdesSciences,1,23,24,2022,01-19,22:45
038 Fac de Lettres,2,14,16,2022,01-19,22:45
039 Aiguelongue,3,5,8,2022,01-19,22:45
040 Jeu de Mail des Abb�s,7,1,8,2022,01-19,22:45
041 Eurom�decine,0,8,8,2022,01-19,22:45
042 Marie Caizergues,1,7,8,2022,01-19,22:45
043 Sabines,4,4,8,2022,01-19,22:45
044 Celleneuve,1,7,8,2022,01-19,22:45
045 Jardin de la Lironde,2,6,8,2022,01-19,22:45
046 P�re Soulas,4,4,8,2022,01-19,22:45
047 Place Viala,1,7,8,2022,01-19,22:45
048 H�tel du D�partement,0,8,8,2022,01-19,22:45
049 Tonnelles,4,4,8,2022,01-19,22:45
050 Parvis Jules Ferry - Gare Saint-Roch,5,3,8,2022,01-19,22:45
051 Pont de Lattes - Gare Saint-Roch,1,11,12,2022,01-19,22:45
053 Deux Ponts - Gare Saint-Roch,1,7,8,2022,01-19,22:45
054 Providence - Ovalie,4,4,8,2022,01-19,22:45
055 P�rols Etang de l'Or,25,43,68,2022,01-19,22:45
056 Albert 1er - Cath�drale,5,7,12,2022,01-19,22:45
057 Saint-Guilhem - Courreau,0,8,8,2022,01-19,22:45
059 Sud De France,0,8,8,2022,01-19,22:45
001 Rue Jules Ferry - Gare Saint-Roch,8,4,12,2022,01-19,22:55
002 Com�die,7,17,24,2022,01-19,22:55
003 Esplanade,11,21,32,2022,01-19,22:55
004 H�tel de Ville,8,8,16,2022,01-19,22:55
005 Corum,12,0,12,2022,01-19,22:55
006 Place Albert 1er - St Charles,31,0,31,2022,01-19,22:55
007 Foch,6,2,8,2022,01-19,22:55
008 Halles Castellane,3,9,12,2022,01-19,22:55
009 Observatoire,7,1,8,2022,01-19,22:55
010 Rondelet,3,13,16,2022,01-19,22:55
011 Plan Cabanes,6,6,12,2022,01-19,22:55
012 Boutonnet,2,10,12,2022,01-19,22:55
013 Emile Combes,3,5,8,2022,01-19,22:55
014 Beaux-Arts,3,5,8,2022,01-19,22:55
015 Les Aubes,4,4,8,2022,01-19,22:55
016 Antigone centre,16,0,16,2022,01-19,22:55
017 M�diath�que Emile Zola,16,0,16,2022,01-19,22:55
018 Nombre d'Or,7,9,16,2022,01-19,22:55
019 Louis Blanc,15,1,16,2022,01-19,22:55
020 Gambetta,4,4,8,2022,01-19,22:55
021 Port Marianne,5,11,16,2022,01-19,22:55
022 Clemenceau,1,11,12,2022,01-19,22:55
023 Les Arceaux,2,14,16,2022,01-19,22:55
024 Cit� Mion,4,4,8,2022,01-19,22:55
025 Nouveau Saint-Roch,5,3,8,2022,01-19,22:55
026 Renouvier,1,7,8,2022,01-19,22:55
027 Odysseum,0,8,8,2022,01-19,22:55
028 Saint-Denis,3,5,8,2022,01-19,22:55
029 Richter,12,4,16,2022,01-19,22:55
030 Charles Flahault,3,5,8,2022,01-19,22:55
031 Voltaire,0,8,8,2022,01-19,22:55
032 Pr�s d'Ar�nes,7,1,8,2022,01-19,22:55
033 Garcia Lorca,7,1,8,2022,01-19,22:55
034 Vert Bois,0,16,16,2022,01-19,22:55
035 Malbosc,1,7,8,2022,01-19,22:55
036 Occitanie,2,30,32,2022,01-19,22:55
037 FacdesSciences,1,23,24,2022,01-19,22:55
038 Fac de Lettres,2,14,16,2022,01-19,22:55
039 Aiguelongue,3,5,8,2022,01-19,22:55
040 Jeu de Mail des Abb�s,7,1,8,2022,01-19,22:55
041 Eurom�decine,0,8,8,2022,01-19,22:55
042 Marie Caizergues,1,7,8,2022,01-19,22:55
043 Sabines,4,4,8,2022,01-19,22:55
044 Celleneuve,2,6,8,2022,01-19,22:55
045 Jardin de la Lironde,2,6,8,2022,01-19,22:55
046 P�re Soulas,4,4,8,2022,01-19,22:55
047 Place Viala,1,7,8,2022,01-19,22:55
048 H�tel du D�partement,0,8,8,2022,01-19,22:55
049 Tonnelles,4,4,8,2022,01-19,22:55
050 Parvis Jules Ferry - Gare Saint-Roch,5,3,8,2022,01-19,22:55
051 Pont de Lattes - Gare Saint-Roch,1,11,12,2022,01-19,22:55
053 Deux Ponts - Gare Saint-Roch,1,7,8,2022,01-19,22:55
054 Providence - Ovalie,4,4,8,2022,01-19,22:55
055 P�rols Etang de l'Or,25,43,68,2022,01-19,22:55
056 Albert 1er - Cath�drale,5,7,12,2022,01-19,22:55
057 Saint-Guilhem - Courreau,0,8,8,2022,01-19,22:55
059 Sud De France,0,8,8,2022,01-19,22:55
001 Rue Jules Ferry - Gare Saint-Roch,8,4,12,2022,01-19,23:05
002 Com�die,7,17,24,2022,01-19,23:05
003 Esplanade,11,21,32,2022,01-19,23:05
004 H�tel de Ville,8,8,16,2022,01-19,23:05
005 Corum,12,0,12,2022,01-19,23:05
006 Place Albert 1er - St Charles,31,0,31,2022,01-19,23:05
007 Foch,6,2,8,2022,01-19,23:05
008 Halles Castellane,3,9,12,2022,01-19,23:05
009 Observatoire,7,1,8,2022,01-19,23:05
010 Rondelet,3,13,16,2022,01-19,23:05
011 Plan Cabanes,6,6,12,2022,01-19,23:05
012 Boutonnet,2,10,12,2022,01-19,23:05
013 Emile Combes,3,5,8,2022,01-19,23:05
014 Beaux-Arts,3,5,8,2022,01-19,23:05
015 Les Aubes,4,4,8,2022,01-19,23:05
016 Antigone centre,16,0,16,2022,01-19,23:05
017 M�diath�que Emile Zola,16,0,16,2022,01-19,23:05
018 Nombre d'Or,7,9,16,2022,01-19,23:05
019 Louis Blanc,15,1,16,2022,01-19,23:05
020 Gambetta,4,4,8,2022,01-19,23:05
021 Port Marianne,5,11,16,2022,01-19,23:05
022 Clemenceau,1,11,12,2022,01-19,23:05
023 Les Arceaux,2,14,16,2022,01-19,23:05
024 Cit� Mion,4,4,8,2022,01-19,23:05
025 Nouveau Saint-Roch,5,3,8,2022,01-19,23:05
026 Renouvier,1,7,8,2022,01-19,23:05
027 Odysseum,0,8,8,2022,01-19,23:05
028 Saint-Denis,3,5,8,2022,01-19,23:05
029 Richter,12,4,16,2022,01-19,23:05
030 Charles Flahault,3,5,8,2022,01-19,23:05
031 Voltaire,0,8,8,2022,01-19,23:05
032 Pr�s d'Ar�nes,7,1,8,2022,01-19,23:05
033 Garcia Lorca,7,1,8,2022,01-19,23:05
034 Vert Bois,0,16,16,2022,01-19,23:05
035 Malbosc,1,7,8,2022,01-19,23:05
036 Occitanie,2,30,32,2022,01-19,23:05
037 FacdesSciences,4,20,24,2022,01-19,23:05
038 Fac de Lettres,2,14,16,2022,01-19,23:05
039 Aiguelongue,3,5,8,2022,01-19,23:05
040 Jeu de Mail des Abb�s,7,1,8,2022,01-19,23:05
041 Eurom�decine,0,8,8,2022,01-19,23:05
042 Marie Caizergues,1,7,8,2022,01-19,23:05
043 Sabines,4,4,8,2022,01-19,23:05
044 Celleneuve,2,6,8,2022,01-19,23:05
045 Jardin de la Lironde,2,6,8,2022,01-19,23:05
046 P�re Soulas,5,3,8,2022,01-19,23:05
047 Place Viala,1,7,8,2022,01-19,23:05
048 H�tel du D�partement,0,8,8,2022,01-19,23:05
049 Tonnelles,4,4,8,2022,01-19,23:05
050 Parvis Jules Ferry - Gare Saint-Roch,5,3,8,2022,01-19,23:05
051 Pont de Lattes - Gare Saint-Roch,1,11,12,2022,01-19,23:05
053 Deux Ponts - Gare Saint-Roch,1,7,8,2022,01-19,23:05
054 Providence - Ovalie,4,4,8,2022,01-19,23:05
055 P�rols Etang de l'Or,25,43,68,2022,01-19,23:05
056 Albert 1er - Cath�drale,5,7,12,2022,01-19,23:05
057 Saint-Guilhem - Courreau,0,8,8,2022,01-19,23:05
059 Sud De France,0,8,8,2022,01-19,23:05
001 Rue Jules Ferry - Gare Saint-Roch,8,4,12,2022,01-19,23:15
002 Com�die,7,17,24,2022,01-19,23:15
003 Esplanade,11,21,32,2022,01-19,23:15
004 H�tel de Ville,8,8,16,2022,01-19,23:15
005 Corum,11,1,12,2022,01-19,23:15
006 Place Albert 1er - St Charles,31,0,31,2022,01-19,23:15
007 Foch,6,2,8,2022,01-19,23:15
008 Halles Castellane,3,9,12,2022,01-19,23:15
009 Observatoire,7,1,8,2022,01-19,23:15
010 Rondelet,3,13,16,2022,01-19,23:15
011 Plan Cabanes,7,5,12,2022,01-19,23:15
012 Boutonnet,2,10,12,2022,01-19,23:15
013 Emile Combes,3,5,8,2022,01-19,23:15
014 Beaux-Arts,3,5,8,2022,01-19,23:15
015 Les Aubes,4,4,8,2022,01-19,23:15
016 Antigone centre,16,0,16,2022,01-19,23:15
017 M�diath�que Emile Zola,16,0,16,2022,01-19,23:15
018 Nombre d'Or,7,9,16,2022,01-19,23:15
019 Louis Blanc,15,1,16,2022,01-19,23:15
020 Gambetta,4,4,8,2022,01-19,23:15
021 Port Marianne,5,11,16,2022,01-19,23:15
022 Clemenceau,1,11,12,2022,01-19,23:15
023 Les Arceaux,2,14,16,2022,01-19,23:15
024 Cit� Mion,4,4,8,2022,01-19,23:15
025 Nouveau Saint-Roch,4,4,8,2022,01-19,23:15
026 Renouvier,1,7,8,2022,01-19,23:15
027 Odysseum,0,8,8,2022,01-19,23:15
028 Saint-Denis,3,5,8,2022,01-19,23:15
029 Richter,12,4,16,2022,01-19,23:15
030 Charles Flahault,3,5,8,2022,01-19,23:15
031 Voltaire,0,8,8,2022,01-19,23:15
032 Pr�s d'Ar�nes,7,1,8,2022,01-19,23:15
033 Garcia Lorca,7,1,8,2022,01-19,23:15
034 Vert Bois,0,16,16,2022,01-19,23:15
035 Malbosc,1,7,8,2022,01-19,23:15
036 Occitanie,2,30,32,2022,01-19,23:15
037 FacdesSciences,4,20,24,2022,01-19,23:15
038 Fac de Lettres,2,14,16,2022,01-19,23:15
039 Aiguelongue,3,5,8,2022,01-19,23:15
040 Jeu de Mail des Abb�s,8,0,8,2022,01-19,23:15
041 Eurom�decine,0,8,8,2022,01-19,23:15
042 Marie Caizergues,1,7,8,2022,01-19,23:15
043 Sabines,4,4,8,2022,01-19,23:15
044 Celleneuve,2,6,8,2022,01-19,23:15
045 Jardin de la Lironde,2,6,8,2022,01-19,23:15
046 P�re Soulas,5,3,8,2022,01-19,23:15
047 Place Viala,1,7,8,2022,01-19,23:15
048 H�tel du D�partement,0,8,8,2022,01-19,23:15
049 Tonnelles,4,4,8,2022,01-19,23:15
050 Parvis Jules Ferry - Gare Saint-Roch,5,3,8,2022,01-19,23:15
051 Pont de Lattes - Gare Saint-Roch,1,11,12,2022,01-19,23:15
053 Deux Ponts - Gare Saint-Roch,1,7,8,2022,01-19,23:15
054 Providence - Ovalie,4,4,8,2022,01-19,23:15
055 P�rols Etang de l'Or,25,43,68,2022,01-19,23:15
056 Albert 1er - Cath�drale,5,7,12,2022,01-19,23:15
057 Saint-Guilhem - Courreau,0,8,8,2022,01-19,23:15
059 Sud De France,0,8,8,2022,01-19,23:15
001 Rue Jules Ferry - Gare Saint-Roch,8,4,12,2022,01-19,23:25
002 Com�die,7,17,24,2022,01-19,23:25
003 Esplanade,11,21,32,2022,01-19,23:25
004 H�tel de Ville,8,8,16,2022,01-19,23:25
005 Corum,11,1,12,2022,01-19,23:25
006 Place Albert 1er - St Charles,31,0,31,2022,01-19,23:25
007 Foch,6,2,8,2022,01-19,23:25
008 Halles Castellane,3,9,12,2022,01-19,23:25
009 Observatoire,7,1,8,2022,01-19,23:25
010 Rondelet,3,13,16,2022,01-19,23:25
011 Plan Cabanes,7,5,12,2022,01-19,23:25
012 Boutonnet,2,10,12,2022,01-19,23:25
013 Emile Combes,3,5,8,2022,01-19,23:25
014 Beaux-Arts,3,5,8,2022,01-19,23:25
015 Les Aubes,4,4,8,2022,01-19,23:25
016 Antigone centre,16,0,16,2022,01-19,23:25
017 M�diath�que Emile Zola,16,0,16,2022,01-19,23:25
018 Nombre d'Or,7,9,16,2022,01-19,23:25
019 Louis Blanc,15,1,16,2022,01-19,23:25
020 Gambetta,4,4,8,2022,01-19,23:25
021 Port Marianne,5,11,16,2022,01-19,23:25
022 Clemenceau,1,11,12,2022,01-19,23:25
023 Les Arceaux,2,14,16,2022,01-19,23:25
024 Cit� Mion,4,4,8,2022,01-19,23:25
025 Nouveau Saint-Roch,4,4,8,2022,01-19,23:25
026 Renouvier,1,7,8,2022,01-19,23:25
027 Odysseum,0,8,8,2022,01-19,23:25
028 Saint-Denis,3,5,8,2022,01-19,23:25
029 Richter,13,3,16,2022,01-19,23:25
030 Charles Flahault,3,5,8,2022,01-19,23:25
031 Voltaire,0,8,8,2022,01-19,23:25
032 Pr�s d'Ar�nes,7,1,8,2022,01-19,23:25
033 Garcia Lorca,6,2,8,2022,01-19,23:25
034 Vert Bois,0,16,16,2022,01-19,23:25
035 Malbosc,1,7,8,2022,01-19,23:25
036 Occitanie,2,30,32,2022,01-19,23:25
037 FacdesSciences,4,20,24,2022,01-19,23:25
038 Fac de Lettres,2,14,16,2022,01-19,23:25
039 Aiguelongue,3,5,8,2022,01-19,23:25
040 Jeu de Mail des Abb�s,8,0,8,2022,01-19,23:25
041 Eurom�decine,0,8,8,2022,01-19,23:25
042 Marie Caizergues,1,7,8,2022,01-19,23:25
043 Sabines,4,4,8,2022,01-19,23:25
044 Celleneuve,2,6,8,2022,01-19,23:25
045 Jardin de la Lironde,2,6,8,2022,01-19,23:25
046 P�re Soulas,5,3,8,2022,01-19,23:25
047 Place Viala,1,7,8,2022,01-19,23:25
048 H�tel du D�partement,0,8,8,2022,01-19,23:25
049 Tonnelles,4,4,8,2022,01-19,23:25
050 Parvis Jules Ferry - Gare Saint-Roch,5,3,8,2022,01-19,23:25
051 Pont de Lattes - Gare Saint-Roch,1,11,12,2022,01-19,23:25
053 Deux Ponts - Gare Saint-Roch,1,7,8,2022,01-19,23:25
054 Providence - Ovalie,4,4,8,2022,01-19,23:25
055 P�rols Etang de l'Or,25,43,68,2022,01-19,23:25
056 Albert 1er - Cath�drale,5,7,12,2022,01-19,23:25
057 Saint-Guilhem - Courreau,0,8,8,2022,01-19,23:25
059 Sud De France,0,8,8,2022,01-19,23:25
001 Rue Jules Ferry - Gare Saint-Roch,8,4,12,2022,01-19,23:35
002 Com�die,5,19,24,2022,01-19,23:35
003 Esplanade,11,21,32,2022,01-19,23:35
004 H�tel de Ville,8,8,16,2022,01-19,23:35
005 Corum,11,1,12,2022,01-19,23:35
006 Place Albert 1er - St Charles,31,0,31,2022,01-19,23:35
007 Foch,6,2,8,2022,01-19,23:35
008 Halles Castellane,3,9,12,2022,01-19,23:35
009 Observatoire,7,1,8,2022,01-19,23:35
010 Rondelet,3,13,16,2022,01-19,23:35
011 Plan Cabanes,7,5,12,2022,01-19,23:35
012 Boutonnet,2,10,12,2022,01-19,23:35
013 Emile Combes,3,5,8,2022,01-19,23:35
014 Beaux-Arts,3,5,8,2022,01-19,23:35
015 Les Aubes,4,4,8,2022,01-19,23:35
016 Antigone centre,16,0,16,2022,01-19,23:35
017 M�diath�que Emile Zola,16,0,16,2022,01-19,23:35
018 Nombre d'Or,7,9,16,2022,01-19,23:35
019 Louis Blanc,14,2,16,2022,01-19,23:35
020 Gambetta,6,2,8,2022,01-19,23:35
021 Port Marianne,5,11,16,2022,01-19,23:35
022 Clemenceau,1,11,12,2022,01-19,23:35
023 Les Arceaux,2,14,16,2022,01-19,23:35
024 Cit� Mion,4,4,8,2022,01-19,23:35
025 Nouveau Saint-Roch,4,4,8,2022,01-19,23:35
026 Renouvier,1,7,8,2022,01-19,23:35
027 Odysseum,0,8,8,2022,01-19,23:35
028 Saint-Denis,3,5,8,2022,01-19,23:35
029 Richter,13,3,16,2022,01-19,23:35
030 Charles Flahault,3,5,8,2022,01-19,23:35
031 Voltaire,0,8,8,2022,01-19,23:35
032 Pr�s d'Ar�nes,7,1,8,2022,01-19,23:35
033 Garcia Lorca,7,1,8,2022,01-19,23:35
034 Vert Bois,0,16,16,2022,01-19,23:35
035 Malbosc,1,7,8,2022,01-19,23:35
036 Occitanie,2,30,32,2022,01-19,23:35
037 FacdesSciences,4,20,24,2022,01-19,23:35
038 Fac de Lettres,2,14,16,2022,01-19,23:35
039 Aiguelongue,3,5,8,2022,01-19,23:35
040 Jeu de Mail des Abb�s,8,0,8,2022,01-19,23:35
041 Eurom�decine,0,8,8,2022,01-19,23:35
042 Marie Caizergues,1,7,8,2022,01-19,23:35
043 Sabines,4,4,8,2022,01-19,23:35
044 Celleneuve,2,6,8,2022,01-19,23:35
045 Jardin de la Lironde,2,6,8,2022,01-19,23:35
046 P�re Soulas,7,1,8,2022,01-19,23:35
047 Place Viala,1,7,8,2022,01-19,23:35
048 H�tel du D�partement,0,8,8,2022,01-19,23:35
049 Tonnelles,4,4,8,2022,01-19,23:35
050 Parvis Jules Ferry - Gare Saint-Roch,5,3,8,2022,01-19,23:35
051 Pont de Lattes - Gare Saint-Roch,1,11,12,2022,01-19,23:35
053 Deux Ponts - Gare Saint-Roch,1,7,8,2022,01-19,23:35
054 Providence - Ovalie,4,4,8,2022,01-19,23:35
055 P�rols Etang de l'Or,25,43,68,2022,01-19,23:35
056 Albert 1er - Cath�drale,5,7,12,2022,01-19,23:35
057 Saint-Guilhem - Courreau,0,8,8,2022,01-19,23:35
059 Sud De France,0,8,8,2022,01-19,23:35
001 Rue Jules Ferry - Gare Saint-Roch,8,4,12,2022,01-19,23:46
002 Com�die,5,19,24,2022,01-19,23:46
003 Esplanade,11,21,32,2022,01-19,23:46
004 H�tel de Ville,8,8,16,2022,01-19,23:46
005 Corum,11,1,12,2022,01-19,23:46
006 Place Albert 1er - St Charles,31,0,31,2022,01-19,23:46
007 Foch,6,2,8,2022,01-19,23:46
008 Halles Castellane,3,9,12,2022,01-19,23:46
009 Observatoire,7,1,8,2022,01-19,23:46
010 Rondelet,3,13,16,2022,01-19,23:46
011 Plan Cabanes,8,4,12,2022,01-19,23:46
012 Boutonnet,2,10,12,2022,01-19,23:46
013 Emile Combes,3,5,8,2022,01-19,23:46
014 Beaux-Arts,3,5,8,2022,01-19,23:46
015 Les Aubes,4,4,8,2022,01-19,23:46
016 Antigone centre,16,0,16,2022,01-19,23:46
017 M�diath�que Emile Zola,16,0,16,2022,01-19,23:46
018 Nombre d'Or,7,9,16,2022,01-19,23:46
019 Louis Blanc,14,2,16,2022,01-19,23:46
020 Gambetta,6,2,8,2022,01-19,23:46
021 Port Marianne,5,11,16,2022,01-19,23:46
022 Clemenceau,1,11,12,2022,01-19,23:46
023 Les Arceaux,2,14,16,2022,01-19,23:46
024 Cit� Mion,4,4,8,2022,01-19,23:46
025 Nouveau Saint-Roch,4,4,8,2022,01-19,23:46
026 Renouvier,1,7,8,2022,01-19,23:46
027 Odysseum,0,8,8,2022,01-19,23:46
028 Saint-Denis,3,5,8,2022,01-19,23:46
029 Richter,13,3,16,2022,01-19,23:46
030 Charles Flahault,3,5,8,2022,01-19,23:46
031 Voltaire,0,8,8,2022,01-19,23:46
032 Pr�s d'Ar�nes,7,1,8,2022,01-19,23:46
033 Garcia Lorca,7,1,8,2022,01-19,23:46
034 Vert Bois,0,16,16,2022,01-19,23:46
035 Malbosc,1,7,8,2022,01-19,23:46
036 Occitanie,2,30,32,2022,01-19,23:46
037 FacdesSciences,4,20,24,2022,01-19,23:46
038 Fac de Lettres,2,14,16,2022,01-19,23:46
039 Aiguelongue,3,5,8,2022,01-19,23:46
040 Jeu de Mail des Abb�s,8,0,8,2022,01-19,23:46
041 Eurom�decine,0,8,8,2022,01-19,23:46
042 Marie Caizergues,1,7,8,2022,01-19,23:46
043 Sabines,4,4,8,2022,01-19,23:46
044 Celleneuve,2,6,8,2022,01-19,23:46
045 Jardin de la Lironde,2,6,8,2022,01-19,23:46
046 P�re Soulas,7,1,8,2022,01-19,23:46
047 Place Viala,1,7,8,2022,01-19,23:46
048 H�tel du D�partement,0,8,8,2022,01-19,23:46
049 Tonnelles,4,4,8,2022,01-19,23:46
050 Parvis Jules Ferry - Gare Saint-Roch,4,4,8,2022,01-19,23:46
051 Pont de Lattes - Gare Saint-Roch,1,11,12,2022,01-19,23:46
053 Deux Ponts - Gare Saint-Roch,1,7,8,2022,01-19,23:46
054 Providence - Ovalie,4,4,8,2022,01-19,23:46
055 P�rols Etang de l'Or,25,43,68,2022,01-19,23:46
056 Albert 1er - Cath�drale,5,7,12,2022,01-19,23:46
057 Saint-Guilhem - Courreau,0,8,8,2022,01-19,23:46
059 Sud De France,0,8,8,2022,01-19,23:46
001 Rue Jules Ferry - Gare Saint-Roch,8,4,12,2022,01-19,23:56
002 Com�die,5,19,24,2022,01-19,23:56
003 Esplanade,11,21,32,2022,01-19,23:56
004 H�tel de Ville,8,8,16,2022,01-19,23:56
005 Corum,11,1,12,2022,01-19,23:56
006 Place Albert 1er - St Charles,31,0,31,2022,01-19,23:56
007 Foch,6,2,8,2022,01-19,23:56
008 Halles Castellane,3,9,12,2022,01-19,23:56
009 Observatoire,7,1,8,2022,01-19,23:56
010 Rondelet,3,13,16,2022,01-19,23:56
011 Plan Cabanes,8,4,12,2022,01-19,23:56
012 Boutonnet,2,10,12,2022,01-19,23:56
013 Emile Combes,3,5,8,2022,01-19,23:56
014 Beaux-Arts,3,5,8,2022,01-19,23:56
015 Les Aubes,4,4,8,2022,01-19,23:56
016 Antigone centre,16,0,16,2022,01-19,23:56
017 M�diath�que Emile Zola,16,0,16,2022,01-19,23:56
018 Nombre d'Or,7,9,16,2022,01-19,23:56
019 Louis Blanc,14,2,16,2022,01-19,23:56
020 Gambetta,6,2,8,2022,01-19,23:56
021 Port Marianne,5,11,16,2022,01-19,23:56
022 Clemenceau,1,11,12,2022,01-19,23:56
023 Les Arceaux,2,14,16,2022,01-19,23:56
024 Cit� Mion,4,4,8,2022,01-19,23:56
025 Nouveau Saint-Roch,4,4,8,2022,01-19,23:56
026 Renouvier,1,7,8,2022,01-19,23:56
027 Odysseum,0,8,8,2022,01-19,23:56
028 Saint-Denis,2,6,8,2022,01-19,23:56
029 Richter,13,3,16,2022,01-19,23:56
030 Charles Flahault,3,5,8,2022,01-19,23:56
031 Voltaire,0,8,8,2022,01-19,23:56
032 Pr�s d'Ar�nes,7,1,8,2022,01-19,23:56
033 Garcia Lorca,7,1,8,2022,01-19,23:56
034 Vert Bois,0,16,16,2022,01-19,23:56
035 Malbosc,1,7,8,2022,01-19,23:56
036 Occitanie,2,30,32,2022,01-19,23:56
037 FacdesSciences,4,20,24,2022,01-19,23:56
038 Fac de Lettres,1,15,16,2022,01-19,23:56
039 Aiguelongue,3,5,8,2022,01-19,23:56
040 Jeu de Mail des Abb�s,8,0,8,2022,01-19,23:56
041 Eurom�decine,0,8,8,2022,01-19,23:56
042 Marie Caizergues,1,7,8,2022,01-19,23:56
043 Sabines,4,4,8,2022,01-19,23:56
044 Celleneuve,2,6,8,2022,01-19,23:56
045 Jardin de la Lironde,2,6,8,2022,01-19,23:56
046 P�re Soulas,7,1,8,2022,01-19,23:56
047 Place Viala,1,7,8,2022,01-19,23:56
048 H�tel du D�partement,0,8,8,2022,01-19,23:56
049 Tonnelles,4,4,8,2022,01-19,23:56
050 Parvis Jules Ferry - Gare Saint-Roch,4,4,8,2022,01-19,23:56
051 Pont de Lattes - Gare Saint-Roch,1,11,12,2022,01-19,23:56
053 Deux Ponts - Gare Saint-Roch,1,7,8,2022,01-19,23:56
054 Providence - Ovalie,4,4,8,2022,01-19,23:56
055 P�rols Etang de l'Or,25,43,68,2022,01-19,23:56
056 Albert 1er - Cath�drale,4,8,12,2022,01-19,23:56
057 Saint-Guilhem - Courreau,0,8,8,2022,01-19,23:56
059 Sud De France,0,8,8,2022,01-19,23:56
001 Rue Jules Ferry - Gare Saint-Roch,7,5,12,2022,01-20,00:06
002 Com�die,5,19,24,2022,01-20,00:06
003 Esplanade,11,21,32,2022,01-20,00:06
004 H�tel de Ville,8,8,16,2022,01-20,00:06
005 Corum,11,1,12,2022,01-20,00:06
006 Place Albert 1er - St Charles,31,0,31,2022,01-20,00:06
007 Foch,6,2,8,2022,01-20,00:06
008 Halles Castellane,3,9,12,2022,01-20,00:06
009 Observatoire,7,1,8,2022,01-20,00:06
010 Rondelet,3,13,16,2022,01-20,00:06
011 Plan Cabanes,8,4,12,2022,01-20,00:06
012 Boutonnet,2,10,12,2022,01-20,00:06
013 Emile Combes,3,5,8,2022,01-20,00:06
014 Beaux-Arts,3,5,8,2022,01-20,00:06
015 Les Aubes,4,4,8,2022,01-20,00:06
016 Antigone centre,16,0,16,2022,01-20,00:06
017 M�diath�que Emile Zola,16,0,16,2022,01-20,00:06
018 Nombre d'Or,7,9,16,2022,01-20,00:06
019 Louis Blanc,15,1,16,2022,01-20,00:06
020 Gambetta,6,2,8,2022,01-20,00:06
021 Port Marianne,5,11,16,2022,01-20,00:06
022 Clemenceau,1,11,12,2022,01-20,00:06
023 Les Arceaux,2,14,16,2022,01-20,00:06
024 Cit� Mion,4,4,8,2022,01-20,00:06
025 Nouveau Saint-Roch,4,4,8,2022,01-20,00:06
026 Renouvier,1,7,8,2022,01-20,00:06
027 Odysseum,0,8,8,2022,01-20,00:06
028 Saint-Denis,2,6,8,2022,01-20,00:06
029 Richter,13,3,16,2022,01-20,00:06
030 Charles Flahault,3,5,8,2022,01-20,00:06
031 Voltaire,1,7,8,2022,01-20,00:06
032 Pr�s d'Ar�nes,7,1,8,2022,01-20,00:06
033 Garcia Lorca,7,1,8,2022,01-20,00:06
034 Vert Bois,0,16,16,2022,01-20,00:06
035 Malbosc,1,7,8,2022,01-20,00:06
036 Occitanie,2,30,32,2022,01-20,00:06
037 FacdesSciences,4,20,24,2022,01-20,00:06
038 Fac de Lettres,1,15,16,2022,01-20,00:06
039 Aiguelongue,3,5,8,2022,01-20,00:06
040 Jeu de Mail des Abb�s,8,0,8,2022,01-20,00:06
041 Eurom�decine,0,8,8,2022,01-20,00:06
042 Marie Caizergues,1,7,8,2022,01-20,00:06
043 Sabines,4,4,8,2022,01-20,00:06
044 Celleneuve,2,6,8,2022,01-20,00:06
045 Jardin de la Lironde,2,6,8,2022,01-20,00:06
046 P�re Soulas,7,1,8,2022,01-20,00:06
047 Place Viala,2,6,8,2022,01-20,00:06
048 H�tel du D�partement,0,8,8,2022,01-20,00:06
049 Tonnelles,4,4,8,2022,01-20,00:06
050 Parvis Jules Ferry - Gare Saint-Roch,4,4,8,2022,01-20,00:06
051 Pont de Lattes - Gare Saint-Roch,1,11,12,2022,01-20,00:06
053 Deux Ponts - Gare Saint-Roch,1,7,8,2022,01-20,00:06
054 Providence - Ovalie,4,4,8,2022,01-20,00:06
055 P�rols Etang de l'Or,25,43,68,2022,01-20,00:06
056 Albert 1er - Cath�drale,4,8,12,2022,01-20,00:06
057 Saint-Guilhem - Courreau,0,8,8,2022,01-20,00:06
059 Sud De France,0,8,8,2022,01-20,00:06
001 Rue Jules Ferry - Gare Saint-Roch,7,5,12,2022,01-20,00:16
002 Com�die,5,19,24,2022,01-20,00:16
003 Esplanade,11,21,32,2022,01-20,00:16
004 H�tel de Ville,8,8,16,2022,01-20,00:16
005 Corum,11,1,12,2022,01-20,00:16
006 Place Albert 1er - St Charles,30,1,31,2022,01-20,00:16
007 Foch,6,2,8,2022,01-20,00:16
008 Halles Castellane,3,9,12,2022,01-20,00:16
009 Observatoire,7,1,8,2022,01-20,00:16
010 Rondelet,3,13,16,2022,01-20,00:16
011 Plan Cabanes,8,4,12,2022,01-20,00:16
012 Boutonnet,2,10,12,2022,01-20,00:16
013 Emile Combes,3,5,8,2022,01-20,00:16
014 Beaux-Arts,3,5,8,2022,01-20,00:16
015 Les Aubes,4,4,8,2022,01-20,00:16
016 Antigone centre,16,0,16,2022,01-20,00:16
017 M�diath�que Emile Zola,16,0,16,2022,01-20,00:16
018 Nombre d'Or,7,9,16,2022,01-20,00:16
019 Louis Blanc,13,3,16,2022,01-20,00:16
020 Gambetta,6,2,8,2022,01-20,00:16
021 Port Marianne,6,10,16,2022,01-20,00:16
022 Clemenceau,1,11,12,2022,01-20,00:16
023 Les Arceaux,2,14,16,2022,01-20,00:16
024 Cit� Mion,4,4,8,2022,01-20,00:16
025 Nouveau Saint-Roch,4,4,8,2022,01-20,00:16
026 Renouvier,1,7,8,2022,01-20,00:16
027 Odysseum,0,8,8,2022,01-20,00:16
028 Saint-Denis,2,6,8,2022,01-20,00:16
029 Richter,13,3,16,2022,01-20,00:16
030 Charles Flahault,3,5,8,2022,01-20,00:16
031 Voltaire,1,7,8,2022,01-20,00:16
032 Pr�s d'Ar�nes,7,1,8,2022,01-20,00:16
033 Garcia Lorca,7,1,8,2022,01-20,00:16
034 Vert Bois,0,16,16,2022,01-20,00:16
035 Malbosc,1,7,8,2022,01-20,00:16
036 Occitanie,2,30,32,2022,01-20,00:16
037 FacdesSciences,4,20,24,2022,01-20,00:16
038 Fac de Lettres,1,15,16,2022,01-20,00:16
039 Aiguelongue,3,5,8,2022,01-20,00:16
040 Jeu de Mail des Abb�s,8,0,8,2022,01-20,00:16
041 Eurom�decine,0,8,8,2022,01-20,00:16
042 Marie Caizergues,1,7,8,2022,01-20,00:16
043 Sabines,4,4,8,2022,01-20,00:16
044 Celleneuve,2,6,8,2022,01-20,00:16
045 Jardin de la Lironde,2,6,8,2022,01-20,00:16
046 P�re Soulas,7,1,8,2022,01-20,00:16
047 Place Viala,2,6,8,2022,01-20,00:16
048 H�tel du D�partement,0,8,8,2022,01-20,00:16
049 Tonnelles,4,4,8,2022,01-20,00:16
050 Parvis Jules Ferry - Gare Saint-Roch,4,4,8,2022,01-20,00:16
051 Pont de Lattes - Gare Saint-Roch,1,11,12,2022,01-20,00:16
053 Deux Ponts - Gare Saint-Roch,1,7,8,2022,01-20,00:16
054 Providence - Ovalie,4,4,8,2022,01-20,00:16
055 P�rols Etang de l'Or,25,43,68,2022,01-20,00:16
056 Albert 1er - Cath�drale,4,8,12,2022,01-20,00:16
057 Saint-Guilhem - Courreau,0,8,8,2022,01-20,00:16
059 Sud De France,0,8,8,2022,01-20,00:16
001 Rue Jules Ferry - Gare Saint-Roch,7,5,12,2022,01-20,00:26
002 Com�die,5,19,24,2022,01-20,00:26
003 Esplanade,11,21,32,2022,01-20,00:26
004 H�tel de Ville,8,8,16,2022,01-20,00:26
005 Corum,11,1,12,2022,01-20,00:26
006 Place Albert 1er - St Charles,30,1,31,2022,01-20,00:26
007 Foch,6,2,8,2022,01-20,00:26
008 Halles Castellane,1,11,12,2022,01-20,00:26
009 Observatoire,7,1,8,2022,01-20,00:26
010 Rondelet,3,13,16,2022,01-20,00:26
011 Plan Cabanes,8,4,12,2022,01-20,00:26
012 Boutonnet,2,10,12,2022,01-20,00:26
013 Emile Combes,3,5,8,2022,01-20,00:26
014 Beaux-Arts,3,5,8,2022,01-20,00:26
015 Les Aubes,4,4,8,2022,01-20,00:26
016 Antigone centre,16,0,16,2022,01-20,00:26
017 M�diath�que Emile Zola,16,0,16,2022,01-20,00:26
018 Nombre d'Or,7,9,16,2022,01-20,00:26
019 Louis Blanc,13,3,16,2022,01-20,00:26
020 Gambetta,6,2,8,2022,01-20,00:26
021 Port Marianne,6,10,16,2022,01-20,00:26
022 Clemenceau,1,11,12,2022,01-20,00:26
023 Les Arceaux,2,14,16,2022,01-20,00:26
024 Cit� Mion,4,4,8,2022,01-20,00:26
025 Nouveau Saint-Roch,4,4,8,2022,01-20,00:26
026 Renouvier,1,7,8,2022,01-20,00:26
027 Odysseum,0,8,8,2022,01-20,00:26
028 Saint-Denis,2,6,8,2022,01-20,00:26
029 Richter,13,3,16,2022,01-20,00:26
030 Charles Flahault,3,5,8,2022,01-20,00:26
031 Voltaire,1,7,8,2022,01-20,00:26
032 Pr�s d'Ar�nes,7,1,8,2022,01-20,00:26
033 Garcia Lorca,7,1,8,2022,01-20,00:26
034 Vert Bois,0,16,16,2022,01-20,00:26
035 Malbosc,1,7,8,2022,01-20,00:26
036 Occitanie,2,30,32,2022,01-20,00:26
037 FacdesSciences,4,20,24,2022,01-20,00:26
038 Fac de Lettres,2,14,16,2022,01-20,00:26
039 Aiguelongue,3,5,8,2022,01-20,00:26
040 Jeu de Mail des Abb�s,8,0,8,2022,01-20,00:26
041 Eurom�decine,0,8,8,2022,01-20,00:26
042 Marie Caizergues,1,7,8,2022,01-20,00:26
043 Sabines,3,5,8,2022,01-20,00:26
044 Celleneuve,2,6,8,2022,01-20,00:26
045 Jardin de la Lironde,2,6,8,2022,01-20,00:26
046 P�re Soulas,7,1,8,2022,01-20,00:26
047 Place Viala,2,6,8,2022,01-20,00:26
048 H�tel du D�partement,0,8,8,2022,01-20,00:26
049 Tonnelles,4,4,8,2022,01-20,00:26
050 Parvis Jules Ferry - Gare Saint-Roch,4,4,8,2022,01-20,00:26
051 Pont de Lattes - Gare Saint-Roch,1,11,12,2022,01-20,00:26
053 Deux Ponts - Gare Saint-Roch,1,7,8,2022,01-20,00:26
054 Providence - Ovalie,4,4,8,2022,01-20,00:26
055 P�rols Etang de l'Or,25,43,68,2022,01-20,00:26
056 Albert 1er - Cath�drale,4,8,12,2022,01-20,00:26
057 Saint-Guilhem - Courreau,0,8,8,2022,01-20,00:26
059 Sud De France,0,8,8,2022,01-20,00:26
001 Rue Jules Ferry - Gare Saint-Roch,7,5,12,2022,01-20,00:36
002 Com�die,5,19,24,2022,01-20,00:36
003 Esplanade,11,21,32,2022,01-20,00:36
004 H�tel de Ville,8,8,16,2022,01-20,00:36
005 Corum,11,1,12,2022,01-20,00:36
006 Place Albert 1er - St Charles,30,1,31,2022,01-20,00:36
007 Foch,6,2,8,2022,01-20,00:36
008 Halles Castellane,0,12,12,2022,01-20,00:36
009 Observatoire,7,1,8,2022,01-20,00:36
010 Rondelet,3,13,16,2022,01-20,00:36
011 Plan Cabanes,8,4,12,2022,01-20,00:36
012 Boutonnet,2,10,12,2022,01-20,00:36
013 Emile Combes,3,5,8,2022,01-20,00:36
014 Beaux-Arts,3,5,8,2022,01-20,00:36
015 Les Aubes,4,4,8,2022,01-20,00:36
016 Antigone centre,16,0,16,2022,01-20,00:36
017 M�diath�que Emile Zola,16,0,16,2022,01-20,00:36
018 Nombre d'Or,7,9,16,2022,01-20,00:36
019 Louis Blanc,13,3,16,2022,01-20,00:36
020 Gambetta,6,2,8,2022,01-20,00:36
021 Port Marianne,6,10,16,2022,01-20,00:36
022 Clemenceau,1,11,12,2022,01-20,00:36
023 Les Arceaux,2,14,16,2022,01-20,00:36
024 Cit� Mion,4,4,8,2022,01-20,00:36
025 Nouveau Saint-Roch,4,4,8,2022,01-20,00:36
026 Renouvier,1,7,8,2022,01-20,00:36
027 Odysseum,0,8,8,2022,01-20,00:36
028 Saint-Denis,2,6,8,2022,01-20,00:36
029 Richter,13,3,16,2022,01-20,00:36
030 Charles Flahault,4,4,8,2022,01-20,00:36
031 Voltaire,1,7,8,2022,01-20,00:36
032 Pr�s d'Ar�nes,7,1,8,2022,01-20,00:36
033 Garcia Lorca,7,1,8,2022,01-20,00:36
034 Vert Bois,0,16,16,2022,01-20,00:36
035 Malbosc,1,7,8,2022,01-20,00:36
036 Occitanie,4,28,32,2022,01-20,00:36
037 FacdesSciences,4,20,24,2022,01-20,00:36
038 Fac de Lettres,1,15,16,2022,01-20,00:36
039 Aiguelongue,3,5,8,2022,01-20,00:36
040 Jeu de Mail des Abb�s,8,0,8,2022,01-20,00:36
041 Eurom�decine,0,8,8,2022,01-20,00:36
042 Marie Caizergues,1,7,8,2022,01-20,00:36
043 Sabines,4,4,8,2022,01-20,00:36
044 Celleneuve,2,6,8,2022,01-20,00:36
045 Jardin de la Lironde,2,6,8,2022,01-20,00:36
046 P�re Soulas,7,1,8,2022,01-20,00:36
047 Place Viala,2,6,8,2022,01-20,00:36
048 H�tel du D�partement,0,8,8,2022,01-20,00:36
049 Tonnelles,4,4,8,2022,01-20,00:36
050 Parvis Jules Ferry - Gare Saint-Roch,4,4,8,2022,01-20,00:36
051 Pont de Lattes - Gare Saint-Roch,1,11,12,2022,01-20,00:36
053 Deux Ponts - Gare Saint-Roch,1,7,8,2022,01-20,00:36
054 Providence - Ovalie,4,4,8,2022,01-20,00:36
055 P�rols Etang de l'Or,25,43,68,2022,01-20,00:36
056 Albert 1er - Cath�drale,4,8,12,2022,01-20,00:36
057 Saint-Guilhem - Courreau,0,8,8,2022,01-20,00:36
059 Sud De France,0,8,8,2022,01-20,00:36
001 Rue Jules Ferry - Gare Saint-Roch,7,5,12,2022,01-20,00:47
002 Com�die,5,19,24,2022,01-20,00:47
003 Esplanade,11,21,32,2022,01-20,00:47
004 H�tel de Ville,8,8,16,2022,01-20,00:47
005 Corum,11,1,12,2022,01-20,00:47
006 Place Albert 1er - St Charles,29,2,31,2022,01-20,00:47
007 Foch,5,3,8,2022,01-20,00:47
008 Halles Castellane,0,12,12,2022,01-20,00:47
009 Observatoire,7,1,8,2022,01-20,00:47
010 Rondelet,3,13,16,2022,01-20,00:47
011 Plan Cabanes,8,4,12,2022,01-20,00:47
012 Boutonnet,2,10,12,2022,01-20,00:47
013 Emile Combes,3,5,8,2022,01-20,00:47
014 Beaux-Arts,3,5,8,2022,01-20,00:47
015 Les Aubes,4,4,8,2022,01-20,00:47
016 Antigone centre,16,0,16,2022,01-20,00:47
017 M�diath�que Emile Zola,16,0,16,2022,01-20,00:47
018 Nombre d'Or,9,7,16,2022,01-20,00:47
019 Louis Blanc,13,3,16,2022,01-20,00:47
020 Gambetta,6,2,8,2022,01-20,00:47
021 Port Marianne,6,10,16,2022,01-20,00:47
022 Clemenceau,1,11,12,2022,01-20,00:47
023 Les Arceaux,2,14,16,2022,01-20,00:47
024 Cit� Mion,4,4,8,2022,01-20,00:47
025 Nouveau Saint-Roch,4,4,8,2022,01-20,00:47
026 Renouvier,1,7,8,2022,01-20,00:47
027 Odysseum,0,8,8,2022,01-20,00:47
028 Saint-Denis,2,6,8,2022,01-20,00:47
029 Richter,13,3,16,2022,01-20,00:47
030 Charles Flahault,4,4,8,2022,01-20,00:47
031 Voltaire,2,6,8,2022,01-20,00:47
032 Pr�s d'Ar�nes,7,1,8,2022,01-20,00:47
033 Garcia Lorca,7,1,8,2022,01-20,00:47
034 Vert Bois,0,16,16,2022,01-20,00:47
035 Malbosc,1,7,8,2022,01-20,00:47
036 Occitanie,4,28,32,2022,01-20,00:47
037 FacdesSciences,4,20,24,2022,01-20,00:47
038 Fac de Lettres,1,15,16,2022,01-20,00:47
039 Aiguelongue,3,5,8,2022,01-20,00:47
040 Jeu de Mail des Abb�s,8,0,8,2022,01-20,00:47
041 Eurom�decine,0,8,8,2022,01-20,00:47
042 Marie Caizergues,1,7,8,2022,01-20,00:47
043 Sabines,4,4,8,2022,01-20,00:47
044 Celleneuve,2,6,8,2022,01-20,00:47
045 Jardin de la Lironde,2,6,8,2022,01-20,00:47
046 P�re Soulas,7,1,8,2022,01-20,00:47
047 Place Viala,2,6,8,2022,01-20,00:47
048 H�tel du D�partement,0,8,8,2022,01-20,00:47
049 Tonnelles,4,4,8,2022,01-20,00:47
050 Parvis Jules Ferry - Gare Saint-Roch,4,4,8,2022,01-20,00:47
051 Pont de Lattes - Gare Saint-Roch,1,11,12,2022,01-20,00:47
053 Deux Ponts - Gare Saint-Roch,1,7,8,2022,01-20,00:47
054 Providence - Ovalie,4,4,8,2022,01-20,00:47
055 P�rols Etang de l'Or,25,43,68,2022,01-20,00:47
056 Albert 1er - Cath�drale,4,8,12,2022,01-20,00:47
057 Saint-Guilhem - Courreau,0,8,8,2022,01-20,00:47
059 Sud De France,0,8,8,2022,01-20,00:47
001 Rue Jules Ferry - Gare Saint-Roch,7,5,12,2022,01-20,00:57
002 Com�die,5,19,24,2022,01-20,00:57
003 Esplanade,10,22,32,2022,01-20,00:57
004 H�tel de Ville,8,8,16,2022,01-20,00:57
005 Corum,11,1,12,2022,01-20,00:57
006 Place Albert 1er - St Charles,29,2,31,2022,01-20,00:57
007 Foch,4,4,8,2022,01-20,00:57
008 Halles Castellane,0,12,12,2022,01-20,00:57
009 Observatoire,7,1,8,2022,01-20,00:57
010 Rondelet,3,13,16,2022,01-20,00:57
011 Plan Cabanes,8,4,12,2022,01-20,00:57
012 Boutonnet,3,9,12,2022,01-20,00:57
013 Emile Combes,3,5,8,2022,01-20,00:57
014 Beaux-Arts,3,5,8,2022,01-20,00:57
015 Les Aubes,4,4,8,2022,01-20,00:57
016 Antigone centre,16,0,16,2022,01-20,00:57
017 M�diath�que Emile Zola,16,0,16,2022,01-20,00:57
018 Nombre d'Or,10,6,16,2022,01-20,00:57
019 Louis Blanc,13,3,16,2022,01-20,00:57
020 Gambetta,6,2,8,2022,01-20,00:57
021 Port Marianne,6,10,16,2022,01-20,00:57
022 Clemenceau,1,11,12,2022,01-20,00:57
023 Les Arceaux,2,14,16,2022,01-20,00:57
024 Cit� Mion,4,4,8,2022,01-20,00:57
025 Nouveau Saint-Roch,4,4,8,2022,01-20,00:57
026 Renouvier,1,7,8,2022,01-20,00:57
027 Odysseum,0,8,8,2022,01-20,00:57
028 Saint-Denis,2,6,8,2022,01-20,00:57
029 Richter,14,2,16,2022,01-20,00:57
030 Charles Flahault,4,4,8,2022,01-20,00:57
031 Voltaire,2,6,8,2022,01-20,00:57
032 Pr�s d'Ar�nes,7,1,8,2022,01-20,00:57
033 Garcia Lorca,7,1,8,2022,01-20,00:57
034 Vert Bois,0,16,16,2022,01-20,00:57
035 Malbosc,1,7,8,2022,01-20,00:57
036 Occitanie,4,28,32,2022,01-20,00:57
037 FacdesSciences,5,19,24,2022,01-20,00:57
038 Fac de Lettres,1,15,16,2022,01-20,00:57
039 Aiguelongue,3,5,8,2022,01-20,00:57
040 Jeu de Mail des Abb�s,8,0,8,2022,01-20,00:57
041 Eurom�decine,0,8,8,2022,01-20,00:57
042 Marie Caizergues,1,7,8,2022,01-20,00:57
043 Sabines,4,4,8,2022,01-20,00:57
044 Celleneuve,2,6,8,2022,01-20,00:57
045 Jardin de la Lironde,2,6,8,2022,01-20,00:57
046 P�re Soulas,8,0,8,2022,01-20,00:57
047 Place Viala,2,6,8,2022,01-20,00:57
048 H�tel du D�partement,0,8,8,2022,01-20,00:57
049 Tonnelles,4,4,8,2022,01-20,00:57
050 Parvis Jules Ferry - Gare Saint-Roch,4,4,8,2022,01-20,00:57
051 Pont de Lattes - Gare Saint-Roch,1,11,12,2022,01-20,00:57
053 Deux Ponts - Gare Saint-Roch,1,7,8,2022,01-20,00:57
054 Providence - Ovalie,4,4,8,2022,01-20,00:57
055 P�rols Etang de l'Or,25,43,68,2022,01-20,00:57
056 Albert 1er - Cath�drale,4,8,12,2022,01-20,00:57
057 Saint-Guilhem - Courreau,0,8,8,2022,01-20,00:57
059 Sud De France,0,8,8,2022,01-20,00:57
001 Rue Jules Ferry - Gare Saint-Roch,7,5,12,2022,01-20,01:07
002 Com�die,5,19,24,2022,01-20,01:07
003 Esplanade,10,22,32,2022,01-20,01:07
004 H�tel de Ville,8,8,16,2022,01-20,01:07
005 Corum,10,2,12,2022,01-20,01:07
006 Place Albert 1er - St Charles,29,2,31,2022,01-20,01:07
007 Foch,4,4,8,2022,01-20,01:07
008 Halles Castellane,0,12,12,2022,01-20,01:07
009 Observatoire,7,1,8,2022,01-20,01:07
010 Rondelet,3,13,16,2022,01-20,01:07
011 Plan Cabanes,8,4,12,2022,01-20,01:07
012 Boutonnet,3,9,12,2022,01-20,01:07
013 Emile Combes,3,5,8,2022,01-20,01:07
014 Beaux-Arts,3,5,8,2022,01-20,01:07
015 Les Aubes,4,4,8,2022,01-20,01:07
016 Antigone centre,16,0,16,2022,01-20,01:07
017 M�diath�que Emile Zola,16,0,16,2022,01-20,01:07
018 Nombre d'Or,10,6,16,2022,01-20,01:07
019 Louis Blanc,12,4,16,2022,01-20,01:07
020 Gambetta,6,2,8,2022,01-20,01:07
021 Port Marianne,5,11,16,2022,01-20,01:07
022 Clemenceau,1,11,12,2022,01-20,01:07
023 Les Arceaux,2,14,16,2022,01-20,01:07
024 Cit� Mion,4,4,8,2022,01-20,01:07
025 Nouveau Saint-Roch,4,4,8,2022,01-20,01:07
026 Renouvier,1,7,8,2022,01-20,01:07
027 Odysseum,0,8,8,2022,01-20,01:07
028 Saint-Denis,2,6,8,2022,01-20,01:07
029 Richter,14,2,16,2022,01-20,01:07
030 Charles Flahault,4,4,8,2022,01-20,01:07
031 Voltaire,2,6,8,2022,01-20,01:07
032 Pr�s d'Ar�nes,7,1,8,2022,01-20,01:07
033 Garcia Lorca,7,1,8,2022,01-20,01:07
034 Vert Bois,0,16,16,2022,01-20,01:07
035 Malbosc,1,7,8,2022,01-20,01:07
036 Occitanie,4,28,32,2022,01-20,01:07
037 FacdesSciences,5,19,24,2022,01-20,01:07
038 Fac de Lettres,1,15,16,2022,01-20,01:07
039 Aiguelongue,3,5,8,2022,01-20,01:07
040 Jeu de Mail des Abb�s,8,0,8,2022,01-20,01:07
041 Eurom�decine,0,8,8,2022,01-20,01:07
042 Marie Caizergues,1,7,8,2022,01-20,01:07
043 Sabines,4,4,8,2022,01-20,01:07
044 Celleneuve,2,6,8,2022,01-20,01:07
045 Jardin de la Lironde,2,6,8,2022,01-20,01:07
046 P�re Soulas,8,0,8,2022,01-20,01:07
047 Place Viala,2,6,8,2022,01-20,01:07
048 H�tel du D�partement,0,8,8,2022,01-20,01:07
049 Tonnelles,5,3,8,2022,01-20,01:07
050 Parvis Jules Ferry - Gare Saint-Roch,4,4,8,2022,01-20,01:07
051 Pont de Lattes - Gare Saint-Roch,1,11,12,2022,01-20,01:07
053 Deux Ponts - Gare Saint-Roch,1,7,8,2022,01-20,01:07
054 Providence - Ovalie,4,4,8,2022,01-20,01:07
055 P�rols Etang de l'Or,25,43,68,2022,01-20,01:07
056 Albert 1er - Cath�drale,4,8,12,2022,01-20,01:07
057 Saint-Guilhem - Courreau,0,8,8,2022,01-20,01:07
059 Sud De France,0,8,8,2022,01-20,01:07
001 Rue Jules Ferry - Gare Saint-Roch,8,4,12,2022,01-20,01:17
002 Com�die,5,19,24,2022,01-20,01:17
003 Esplanade,10,22,32,2022,01-20,01:17
004 H�tel de Ville,8,8,16,2022,01-20,01:17
005 Corum,10,2,12,2022,01-20,01:17
006 Place Albert 1er - St Charles,29,2,31,2022,01-20,01:17
007 Foch,4,4,8,2022,01-20,01:17
008 Halles Castellane,0,12,12,2022,01-20,01:17
009 Observatoire,7,1,8,2022,01-20,01:17
010 Rondelet,3,13,16,2022,01-20,01:17
011 Plan Cabanes,8,4,12,2022,01-20,01:17
012 Boutonnet,3,9,12,2022,01-20,01:17
013 Emile Combes,3,5,8,2022,01-20,01:17
014 Beaux-Arts,3,5,8,2022,01-20,01:17
015 Les Aubes,4,4,8,2022,01-20,01:17
016 Antigone centre,16,0,16,2022,01-20,01:17
017 M�diath�que Emile Zola,16,0,16,2022,01-20,01:17
018 Nombre d'Or,10,6,16,2022,01-20,01:17
019 Louis Blanc,12,4,16,2022,01-20,01:17
020 Gambetta,6,2,8,2022,01-20,01:17
021 Port Marianne,5,11,16,2022,01-20,01:17
022 Clemenceau,1,11,12,2022,01-20,01:17
023 Les Arceaux,2,14,16,2022,01-20,01:17
024 Cit� Mion,4,4,8,2022,01-20,01:17
025 Nouveau Saint-Roch,4,4,8,2022,01-20,01:17
026 Renouvier,1,7,8,2022,01-20,01:17
027 Odysseum,0,8,8,2022,01-20,01:17
028 Saint-Denis,2,6,8,2022,01-20,01:17
029 Richter,14,2,16,2022,01-20,01:17
030 Charles Flahault,4,4,8,2022,01-20,01:17
031 Voltaire,2,6,8,2022,01-20,01:17
032 Pr�s d'Ar�nes,7,1,8,2022,01-20,01:17
033 Garcia Lorca,7,1,8,2022,01-20,01:17
034 Vert Bois,0,16,16,2022,01-20,01:17
035 Malbosc,1,7,8,2022,01-20,01:17
036 Occitanie,4,28,32,2022,01-20,01:17
037 FacdesSciences,6,18,24,2022,01-20,01:17
038 Fac de Lettres,1,15,16,2022,01-20,01:17
039 Aiguelongue,3,5,8,2022,01-20,01:17
040 Jeu de Mail des Abb�s,8,0,8,2022,01-20,01:17
041 Eurom�decine,0,8,8,2022,01-20,01:17
042 Marie Caizergues,1,7,8,2022,01-20,01:17
043 Sabines,4,4,8,2022,01-20,01:17
044 Celleneuve,2,6,8,2022,01-20,01:17
045 Jardin de la Lironde,2,6,8,2022,01-20,01:17
046 P�re Soulas,8,0,8,2022,01-20,01:17
047 Place Viala,2,6,8,2022,01-20,01:17
048 H�tel du D�partement,0,8,8,2022,01-20,01:17
049 Tonnelles,5,3,8,2022,01-20,01:17
050 Parvis Jules Ferry - Gare Saint-Roch,4,4,8,2022,01-20,01:17
051 Pont de Lattes - Gare Saint-Roch,1,11,12,2022,01-20,01:17
053 Deux Ponts - Gare Saint-Roch,1,7,8,2022,01-20,01:17
054 Providence - Ovalie,4,4,8,2022,01-20,01:17
055 P�rols Etang de l'Or,25,43,68,2022,01-20,01:17
056 Albert 1er - Cath�drale,4,8,12,2022,01-20,01:17
057 Saint-Guilhem - Courreau,0,8,8,2022,01-20,01:17
059 Sud De France,0,8,8,2022,01-20,01:17
001 Rue Jules Ferry - Gare Saint-Roch,6,6,12,2022,01-20,01:27
002 Com�die,5,19,24,2022,01-20,01:27
003 Esplanade,10,22,32,2022,01-20,01:27
004 H�tel de Ville,8,8,16,2022,01-20,01:27
005 Corum,10,2,12,2022,01-20,01:27
006 Place Albert 1er - St Charles,29,2,31,2022,01-20,01:27
007 Foch,4,4,8,2022,01-20,01:27
008 Halles Castellane,0,12,12,2022,01-20,01:27
009 Observatoire,7,1,8,2022,01-20,01:27
010 Rondelet,3,13,16,2022,01-20,01:27
011 Plan Cabanes,8,4,12,2022,01-20,01:27
012 Boutonnet,3,9,12,2022,01-20,01:27
013 Emile Combes,3,5,8,2022,01-20,01:27
014 Beaux-Arts,3,5,8,2022,01-20,01:27
015 Les Aubes,4,4,8,2022,01-20,01:27
016 Antigone centre,16,0,16,2022,01-20,01:27
017 M�diath�que Emile Zola,16,0,16,2022,01-20,01:27
018 Nombre d'Or,12,4,16,2022,01-20,01:27
019 Louis Blanc,11,5,16,2022,01-20,01:27
020 Gambetta,6,2,8,2022,01-20,01:27
021 Port Marianne,5,11,16,2022,01-20,01:27
022 Clemenceau,1,11,12,2022,01-20,01:27
023 Les Arceaux,2,14,16,2022,01-20,01:27
024 Cit� Mion,4,4,8,2022,01-20,01:27
025 Nouveau Saint-Roch,4,4,8,2022,01-20,01:27
026 Renouvier,1,7,8,2022,01-20,01:27
027 Odysseum,0,8,8,2022,01-20,01:27
028 Saint-Denis,2,6,8,2022,01-20,01:27
029 Richter,14,2,16,2022,01-20,01:27
030 Charles Flahault,4,4,8,2022,01-20,01:27
031 Voltaire,2,6,8,2022,01-20,01:27
032 Pr�s d'Ar�nes,7,1,8,2022,01-20,01:27
033 Garcia Lorca,7,1,8,2022,01-20,01:27
034 Vert Bois,0,16,16,2022,01-20,01:27
035 Malbosc,1,7,8,2022,01-20,01:27
036 Occitanie,4,28,32,2022,01-20,01:27
037 FacdesSciences,6,18,24,2022,01-20,01:27
038 Fac de Lettres,1,15,16,2022,01-20,01:27
039 Aiguelongue,2,6,8,2022,01-20,01:27
040 Jeu de Mail des Abb�s,8,0,8,2022,01-20,01:27
041 Eurom�decine,0,8,8,2022,01-20,01:27
042 Marie Caizergues,1,7,8,2022,01-20,01:27
043 Sabines,4,4,8,2022,01-20,01:27
044 Celleneuve,2,6,8,2022,01-20,01:27
045 Jardin de la Lironde,2,6,8,2022,01-20,01:27
046 P�re Soulas,8,0,8,2022,01-20,01:27
047 Place Viala,2,6,8,2022,01-20,01:27
048 H�tel du D�partement,0,8,8,2022,01-20,01:27
049 Tonnelles,5,3,8,2022,01-20,01:27
050 Parvis Jules Ferry - Gare Saint-Roch,4,4,8,2022,01-20,01:27
051 Pont de Lattes - Gare Saint-Roch,1,11,12,2022,01-20,01:27
053 Deux Ponts - Gare Saint-Roch,1,7,8,2022,01-20,01:27
054 Providence - Ovalie,4,4,8,2022,01-20,01:27
055 P�rols Etang de l'Or,25,43,68,2022,01-20,01:27
056 Albert 1er - Cath�drale,4,8,12,2022,01-20,01:27
057 Saint-Guilhem - Courreau,0,8,8,2022,01-20,01:27
059 Sud De France,0,8,8,2022,01-20,01:27
001 Rue Jules Ferry - Gare Saint-Roch,6,6,12,2022,01-20,01:37
002 Com�die,5,19,24,2022,01-20,01:37
003 Esplanade,10,22,32,2022,01-20,01:37
004 H�tel de Ville,8,8,16,2022,01-20,01:37
005 Corum,10,2,12,2022,01-20,01:37
006 Place Albert 1er - St Charles,29,2,31,2022,01-20,01:37
007 Foch,4,4,8,2022,01-20,01:37
008 Halles Castellane,0,12,12,2022,01-20,01:37
009 Observatoire,7,1,8,2022,01-20,01:37
010 Rondelet,3,13,16,2022,01-20,01:37
011 Plan Cabanes,8,4,12,2022,01-20,01:37
012 Boutonnet,4,8,12,2022,01-20,01:37
013 Emile Combes,3,5,8,2022,01-20,01:37
014 Beaux-Arts,3,5,8,2022,01-20,01:37
015 Les Aubes,4,4,8,2022,01-20,01:37
016 Antigone centre,16,0,16,2022,01-20,01:37
017 M�diath�que Emile Zola,16,0,16,2022,01-20,01:37
018 Nombre d'Or,12,4,16,2022,01-20,01:37
019 Louis Blanc,11,5,16,2022,01-20,01:37
020 Gambetta,6,2,8,2022,01-20,01:37
021 Port Marianne,5,11,16,2022,01-20,01:37
022 Clemenceau,1,11,12,2022,01-20,01:37
023 Les Arceaux,2,14,16,2022,01-20,01:37
024 Cit� Mion,4,4,8,2022,01-20,01:37
025 Nouveau Saint-Roch,4,4,8,2022,01-20,01:37
026 Renouvier,1,7,8,2022,01-20,01:37
027 Odysseum,0,8,8,2022,01-20,01:37
028 Saint-Denis,2,6,8,2022,01-20,01:37
029 Richter,14,2,16,2022,01-20,01:37
030 Charles Flahault,4,4,8,2022,01-20,01:37
031 Voltaire,2,6,8,2022,01-20,01:37
032 Pr�s d'Ar�nes,7,1,8,2022,01-20,01:37
033 Garcia Lorca,6,2,8,2022,01-20,01:37
034 Vert Bois,0,16,16,2022,01-20,01:37
035 Malbosc,1,7,8,2022,01-20,01:37
036 Occitanie,4,28,32,2022,01-20,01:37
037 FacdesSciences,6,18,24,2022,01-20,01:37
038 Fac de Lettres,1,15,16,2022,01-20,01:37
039 Aiguelongue,2,6,8,2022,01-20,01:37
040 Jeu de Mail des Abb�s,8,0,8,2022,01-20,01:37
041 Eurom�decine,0,8,8,2022,01-20,01:37
042 Marie Caizergues,1,7,8,2022,01-20,01:37
043 Sabines,4,4,8,2022,01-20,01:37
044 Celleneuve,2,6,8,2022,01-20,01:37
045 Jardin de la Lironde,2,6,8,2022,01-20,01:37
046 P�re Soulas,8,0,8,2022,01-20,01:37
047 Place Viala,2,6,8,2022,01-20,01:37
048 H�tel du D�partement,0,8,8,2022,01-20,01:37
049 Tonnelles,6,2,8,2022,01-20,01:37
050 Parvis Jules Ferry - Gare Saint-Roch,4,4,8,2022,01-20,01:37
051 Pont de Lattes - Gare Saint-Roch,1,11,12,2022,01-20,01:37
053 Deux Ponts - Gare Saint-Roch,1,7,8,2022,01-20,01:37
054 Providence - Ovalie,4,4,8,2022,01-20,01:37
055 P�rols Etang de l'Or,25,43,68,2022,01-20,01:37
056 Albert 1er - Cath�drale,4,8,12,2022,01-20,01:37
057 Saint-Guilhem - Courreau,0,8,8,2022,01-20,01:37
059 Sud De France,0,8,8,2022,01-20,01:37
001 Rue Jules Ferry - Gare Saint-Roch,6,6,12,2022,01-20,01:48
002 Com�die,4,20,24,2022,01-20,01:48
003 Esplanade,10,22,32,2022,01-20,01:48
004 H�tel de Ville,8,8,16,2022,01-20,01:48
005 Corum,10,2,12,2022,01-20,01:48
006 Place Albert 1er - St Charles,29,2,31,2022,01-20,01:48
007 Foch,4,4,8,2022,01-20,01:48
008 Halles Castellane,0,12,12,2022,01-20,01:48
009 Observatoire,7,1,8,2022,01-20,01:48
010 Rondelet,3,13,16,2022,01-20,01:48
011 Plan Cabanes,8,4,12,2022,01-20,01:48
012 Boutonnet,4,8,12,2022,01-20,01:48
013 Emile Combes,3,5,8,2022,01-20,01:48
014 Beaux-Arts,3,5,8,2022,01-20,01:48
015 Les Aubes,4,4,8,2022,01-20,01:48
016 Antigone centre,16,0,16,2022,01-20,01:48
017 M�diath�que Emile Zola,16,0,16,2022,01-20,01:48
018 Nombre d'Or,12,4,16,2022,01-20,01:48
019 Louis Blanc,11,5,16,2022,01-20,01:48
020 Gambetta,6,2,8,2022,01-20,01:48
021 Port Marianne,5,11,16,2022,01-20,01:48
022 Clemenceau,1,11,12,2022,01-20,01:48
023 Les Arceaux,2,14,16,2022,01-20,01:48
024 Cit� Mion,4,4,8,2022,01-20,01:48
025 Nouveau Saint-Roch,4,4,8,2022,01-20,01:48
026 Renouvier,1,7,8,2022,01-20,01:48
027 Odysseum,0,8,8,2022,01-20,01:48
028 Saint-Denis,2,6,8,2022,01-20,01:48
029 Richter,14,2,16,2022,01-20,01:48
030 Charles Flahault,4,4,8,2022,01-20,01:48
031 Voltaire,2,6,8,2022,01-20,01:48
032 Pr�s d'Ar�nes,7,1,8,2022,01-20,01:48
033 Garcia Lorca,6,2,8,2022,01-20,01:48
034 Vert Bois,0,16,16,2022,01-20,01:48
035 Malbosc,1,7,8,2022,01-20,01:48
036 Occitanie,4,28,32,2022,01-20,01:48
037 FacdesSciences,6,18,24,2022,01-20,01:48
038 Fac de Lettres,1,15,16,2022,01-20,01:48
039 Aiguelongue,2,6,8,2022,01-20,01:48
040 Jeu de Mail des Abb�s,8,0,8,2022,01-20,01:48
041 Eurom�decine,0,8,8,2022,01-20,01:48
042 Marie Caizergues,1,7,8,2022,01-20,01:48
043 Sabines,4,4,8,2022,01-20,01:48
044 Celleneuve,2,6,8,2022,01-20,01:48
045 Jardin de la Lironde,2,6,8,2022,01-20,01:48
046 P�re Soulas,8,0,8,2022,01-20,01:48
047 Place Viala,2,6,8,2022,01-20,01:48
048 H�tel du D�partement,0,8,8,2022,01-20,01:48
049 Tonnelles,6,2,8,2022,01-20,01:48
050 Parvis Jules Ferry - Gare Saint-Roch,4,4,8,2022,01-20,01:48
051 Pont de Lattes - Gare Saint-Roch,1,11,12,2022,01-20,01:48
053 Deux Ponts - Gare Saint-Roch,1,7,8,2022,01-20,01:48
054 Providence - Ovalie,4,4,8,2022,01-20,01:48
055 P�rols Etang de l'Or,25,43,68,2022,01-20,01:48
056 Albert 1er - Cath�drale,1,11,12,2022,01-20,01:48
057 Saint-Guilhem - Courreau,0,8,8,2022,01-20,01:48
059 Sud De France,0,8,8,2022,01-20,01:48
001 Rue Jules Ferry - Gare Saint-Roch,6,6,12,2022,01-20,01:58
002 Com�die,3,21,24,2022,01-20,01:58
003 Esplanade,10,22,32,2022,01-20,01:58
004 H�tel de Ville,8,8,16,2022,01-20,01:58
005 Corum,10,2,12,2022,01-20,01:58
006 Place Albert 1er - St Charles,29,2,31,2022,01-20,01:58
007 Foch,4,4,8,2022,01-20,01:58
008 Halles Castellane,0,12,12,2022,01-20,01:58
009 Observatoire,7,1,8,2022,01-20,01:58
010 Rondelet,3,13,16,2022,01-20,01:58
011 Plan Cabanes,8,4,12,2022,01-20,01:58
012 Boutonnet,6,6,12,2022,01-20,01:58
013 Emile Combes,3,5,8,2022,01-20,01:58
014 Beaux-Arts,3,5,8,2022,01-20,01:58
015 Les Aubes,4,4,8,2022,01-20,01:58
016 Antigone centre,16,0,16,2022,01-20,01:58
017 M�diath�que Emile Zola,16,0,16,2022,01-20,01:58
018 Nombre d'Or,12,4,16,2022,01-20,01:58
019 Louis Blanc,11,5,16,2022,01-20,01:58
020 Gambetta,6,2,8,2022,01-20,01:58
021 Port Marianne,5,11,16,2022,01-20,01:58
022 Clemenceau,1,11,12,2022,01-20,01:58
023 Les Arceaux,2,14,16,2022,01-20,01:58
024 Cit� Mion,4,4,8,2022,01-20,01:58
025 Nouveau Saint-Roch,5,3,8,2022,01-20,01:58
026 Renouvier,1,7,8,2022,01-20,01:58
027 Odysseum,0,8,8,2022,01-20,01:58
028 Saint-Denis,2,6,8,2022,01-20,01:58
029 Richter,14,2,16,2022,01-20,01:58
030 Charles Flahault,4,4,8,2022,01-20,01:58
031 Voltaire,2,6,8,2022,01-20,01:58
032 Pr�s d'Ar�nes,7,1,8,2022,01-20,01:58
033 Garcia Lorca,6,2,8,2022,01-20,01:58
034 Vert Bois,0,16,16,2022,01-20,01:58
035 Malbosc,1,7,8,2022,01-20,01:58
036 Occitanie,4,28,32,2022,01-20,01:58
037 FacdesSciences,6,18,24,2022,01-20,01:58
038 Fac de Lettres,1,15,16,2022,01-20,01:58
039 Aiguelongue,2,6,8,2022,01-20,01:58
040 Jeu de Mail des Abb�s,8,0,8,2022,01-20,01:58
041 Eurom�decine,0,8,8,2022,01-20,01:58
042 Marie Caizergues,1,7,8,2022,01-20,01:58
043 Sabines,4,4,8,2022,01-20,01:58
044 Celleneuve,2,6,8,2022,01-20,01:58
045 Jardin de la Lironde,2,6,8,2022,01-20,01:58
046 P�re Soulas,8,0,8,2022,01-20,01:58
047 Place Viala,2,6,8,2022,01-20,01:58
048 H�tel du D�partement,0,8,8,2022,01-20,01:58
049 Tonnelles,6,2,8,2022,01-20,01:58
050 Parvis Jules Ferry - Gare Saint-Roch,4,4,8,2022,01-20,01:58
051 Pont de Lattes - Gare Saint-Roch,1,11,12,2022,01-20,01:58
053 Deux Ponts - Gare Saint-Roch,1,7,8,2022,01-20,01:58
054 Providence - Ovalie,4,4,8,2022,01-20,01:58
055 P�rols Etang de l'Or,25,43,68,2022,01-20,01:58
056 Albert 1er - Cath�drale,1,11,12,2022,01-20,01:58
057 Saint-Guilhem - Courreau,0,8,8,2022,01-20,01:58
059 Sud De France,0,8,8,2022,01-20,01:58
001 Rue Jules Ferry - Gare Saint-Roch,6,6,12,2022,01-20,02:08
002 Com�die,3,21,24,2022,01-20,02:08
003 Esplanade,10,22,32,2022,01-20,02:08
004 H�tel de Ville,8,8,16,2022,01-20,02:08
005 Corum,10,2,12,2022,01-20,02:08
006 Place Albert 1er - St Charles,29,2,31,2022,01-20,02:08
007 Foch,4,4,8,2022,01-20,02:08
008 Halles Castellane,0,12,12,2022,01-20,02:08
009 Observatoire,7,1,8,2022,01-20,02:08
010 Rondelet,3,13,16,2022,01-20,02:08
011 Plan Cabanes,8,4,12,2022,01-20,02:08
012 Boutonnet,7,5,12,2022,01-20,02:08
013 Emile Combes,3,5,8,2022,01-20,02:08
014 Beaux-Arts,3,5,8,2022,01-20,02:08
015 Les Aubes,4,4,8,2022,01-20,02:08
016 Antigone centre,16,0,16,2022,01-20,02:08
017 M�diath�que Emile Zola,16,0,16,2022,01-20,02:08
018 Nombre d'Or,12,4,16,2022,01-20,02:08
019 Louis Blanc,11,5,16,2022,01-20,02:08
020 Gambetta,6,2,8,2022,01-20,02:08
021 Port Marianne,5,11,16,2022,01-20,02:08
022 Clemenceau,1,11,12,2022,01-20,02:08
023 Les Arceaux,2,14,16,2022,01-20,02:08
024 Cit� Mion,4,4,8,2022,01-20,02:08
025 Nouveau Saint-Roch,5,3,8,2022,01-20,02:08
026 Renouvier,1,7,8,2022,01-20,02:08
027 Odysseum,0,8,8,2022,01-20,02:08
028 Saint-Denis,2,6,8,2022,01-20,02:08
029 Richter,14,2,16,2022,01-20,02:08
030 Charles Flahault,4,4,8,2022,01-20,02:08
031 Voltaire,2,6,8,2022,01-20,02:08
032 Pr�s d'Ar�nes,7,1,8,2022,01-20,02:08
033 Garcia Lorca,6,2,8,2022,01-20,02:08
034 Vert Bois,0,16,16,2022,01-20,02:08
035 Malbosc,1,7,8,2022,01-20,02:08
036 Occitanie,4,28,32,2022,01-20,02:08
037 FacdesSciences,6,18,24,2022,01-20,02:08
038 Fac de Lettres,1,15,16,2022,01-20,02:08
039 Aiguelongue,2,6,8,2022,01-20,02:08
040 Jeu de Mail des Abb�s,8,0,8,2022,01-20,02:08
041 Eurom�decine,0,8,8,2022,01-20,02:08
042 Marie Caizergues,1,7,8,2022,01-20,02:08
043 Sabines,4,4,8,2022,01-20,02:08
044 Celleneuve,2,6,8,2022,01-20,02:08
045 Jardin de la Lironde,2,6,8,2022,01-20,02:08
046 P�re Soulas,8,0,8,2022,01-20,02:08
047 Place Viala,2,6,8,2022,01-20,02:08
048 H�tel du D�partement,0,8,8,2022,01-20,02:08
049 Tonnelles,6,2,8,2022,01-20,02:08
050 Parvis Jules Ferry - Gare Saint-Roch,4,4,8,2022,01-20,02:08
051 Pont de Lattes - Gare Saint-Roch,1,11,12,2022,01-20,02:08
053 Deux Ponts - Gare Saint-Roch,1,7,8,2022,01-20,02:08
054 Providence - Ovalie,4,4,8,2022,01-20,02:08
055 P�rols Etang de l'Or,25,43,68,2022,01-20,02:08
056 Albert 1er - Cath�drale,1,11,12,2022,01-20,02:08
057 Saint-Guilhem - Courreau,0,8,8,2022,01-20,02:08
059 Sud De France,0,8,8,2022,01-20,02:08
001 Rue Jules Ferry - Gare Saint-Roch,6,6,12,2022,01-20,02:18
002 Com�die,3,21,24,2022,01-20,02:18
003 Esplanade,10,22,32,2022,01-20,02:18
004 H�tel de Ville,8,8,16,2022,01-20,02:18
005 Corum,10,2,12,2022,01-20,02:18
006 Place Albert 1er - St Charles,29,2,31,2022,01-20,02:18
007 Foch,4,4,8,2022,01-20,02:18
008 Halles Castellane,0,12,12,2022,01-20,02:18
009 Observatoire,7,1,8,2022,01-20,02:18
010 Rondelet,3,13,16,2022,01-20,02:18
011 Plan Cabanes,8,4,12,2022,01-20,02:18
012 Boutonnet,8,4,12,2022,01-20,02:18
013 Emile Combes,3,5,8,2022,01-20,02:18
014 Beaux-Arts,3,5,8,2022,01-20,02:18
015 Les Aubes,4,4,8,2022,01-20,02:18
016 Antigone centre,16,0,16,2022,01-20,02:18
017 M�diath�que Emile Zola,16,0,16,2022,01-20,02:18
018 Nombre d'Or,12,4,16,2022,01-20,02:18
019 Louis Blanc,11,5,16,2022,01-20,02:18
020 Gambetta,6,2,8,2022,01-20,02:18
021 Port Marianne,5,11,16,2022,01-20,02:18
022 Clemenceau,1,11,12,2022,01-20,02:18
023 Les Arceaux,2,14,16,2022,01-20,02:18
024 Cit� Mion,4,4,8,2022,01-20,02:18
025 Nouveau Saint-Roch,5,3,8,2022,01-20,02:18
026 Renouvier,1,7,8,2022,01-20,02:18
027 Odysseum,0,8,8,2022,01-20,02:18
028 Saint-Denis,2,6,8,2022,01-20,02:18
029 Richter,14,2,16,2022,01-20,02:18
030 Charles Flahault,4,4,8,2022,01-20,02:18
031 Voltaire,2,6,8,2022,01-20,02:18
032 Pr�s d'Ar�nes,7,1,8,2022,01-20,02:18
033 Garcia Lorca,6,2,8,2022,01-20,02:18
034 Vert Bois,0,16,16,2022,01-20,02:18
035 Malbosc,1,7,8,2022,01-20,02:18
036 Occitanie,4,28,32,2022,01-20,02:18
037 FacdesSciences,6,18,24,2022,01-20,02:18
038 Fac de Lettres,1,15,16,2022,01-20,02:18
039 Aiguelongue,2,6,8,2022,01-20,02:18
040 Jeu de Mail des Abb�s,8,0,8,2022,01-20,02:18
041 Eurom�decine,0,8,8,2022,01-20,02:18
042 Marie Caizergues,1,7,8,2022,01-20,02:18
043 Sabines,4,4,8,2022,01-20,02:18
044 Celleneuve,2,6,8,2022,01-20,02:18
045 Jardin de la Lironde,2,6,8,2022,01-20,02:18
046 P�re Soulas,8,0,8,2022,01-20,02:18
047 Place Viala,2,6,8,2022,01-20,02:18
048 H�tel du D�partement,0,8,8,2022,01-20,02:18
049 Tonnelles,6,2,8,2022,01-20,02:18
050 Parvis Jules Ferry - Gare Saint-Roch,4,4,8,2022,01-20,02:18
051 Pont de Lattes - Gare Saint-Roch,1,11,12,2022,01-20,02:18
053 Deux Ponts - Gare Saint-Roch,1,7,8,2022,01-20,02:18
054 Providence - Ovalie,4,4,8,2022,01-20,02:18
055 P�rols Etang de l'Or,25,43,68,2022,01-20,02:18
056 Albert 1er - Cath�drale,1,11,12,2022,01-20,02:18
057 Saint-Guilhem - Courreau,0,8,8,2022,01-20,02:18
059 Sud De France,0,8,8,2022,01-20,02:18
001 Rue Jules Ferry - Gare Saint-Roch,6,6,12,2022,01-20,02:28
002 Com�die,3,21,24,2022,01-20,02:28
003 Esplanade,10,22,32,2022,01-20,02:28
004 H�tel de Ville,8,8,16,2022,01-20,02:28
005 Corum,10,2,12,2022,01-20,02:28
006 Place Albert 1er - St Charles,29,2,31,2022,01-20,02:28
007 Foch,4,4,8,2022,01-20,02:28
008 Halles Castellane,0,12,12,2022,01-20,02:28
009 Observatoire,7,1,8,2022,01-20,02:28
010 Rondelet,3,13,16,2022,01-20,02:28
011 Plan Cabanes,8,4,12,2022,01-20,02:28
012 Boutonnet,8,4,12,2022,01-20,02:28
013 Emile Combes,3,5,8,2022,01-20,02:28
014 Beaux-Arts,3,5,8,2022,01-20,02:28
015 Les Aubes,4,4,8,2022,01-20,02:28
016 Antigone centre,16,0,16,2022,01-20,02:28
017 M�diath�que Emile Zola,16,0,16,2022,01-20,02:28
018 Nombre d'Or,12,4,16,2022,01-20,02:28
019 Louis Blanc,11,5,16,2022,01-20,02:28
020 Gambetta,6,2,8,2022,01-20,02:28
021 Port Marianne,5,11,16,2022,01-20,02:28
022 Clemenceau,1,11,12,2022,01-20,02:28
023 Les Arceaux,2,14,16,2022,01-20,02:28
024 Cit� Mion,4,4,8,2022,01-20,02:28
025 Nouveau Saint-Roch,5,3,8,2022,01-20,02:28
026 Renouvier,1,7,8,2022,01-20,02:28
027 Odysseum,0,8,8,2022,01-20,02:28
028 Saint-Denis,2,6,8,2022,01-20,02:28
029 Richter,14,2,16,2022,01-20,02:28
030 Charles Flahault,4,4,8,2022,01-20,02:28
031 Voltaire,2,6,8,2022,01-20,02:28
032 Pr�s d'Ar�nes,7,1,8,2022,01-20,02:28
033 Garcia Lorca,6,2,8,2022,01-20,02:28
034 Vert Bois,0,16,16,2022,01-20,02:28
035 Malbosc,1,7,8,2022,01-20,02:28
036 Occitanie,4,28,32,2022,01-20,02:28
037 FacdesSciences,6,18,24,2022,01-20,02:28
038 Fac de Lettres,1,15,16,2022,01-20,02:28
039 Aiguelongue,2,6,8,2022,01-20,02:28
040 Jeu de Mail des Abb�s,8,0,8,2022,01-20,02:28
041 Eurom�decine,0,8,8,2022,01-20,02:28
042 Marie Caizergues,1,7,8,2022,01-20,02:28
043 Sabines,4,4,8,2022,01-20,02:28
044 Celleneuve,2,6,8,2022,01-20,02:28
045 Jardin de la Lironde,2,6,8,2022,01-20,02:28
046 P�re Soulas,8,0,8,2022,01-20,02:28
047 Place Viala,3,5,8,2022,01-20,02:28
048 H�tel du D�partement,0,8,8,2022,01-20,02:28
049 Tonnelles,6,2,8,2022,01-20,02:28
050 Parvis Jules Ferry - Gare Saint-Roch,4,4,8,2022,01-20,02:28
051 Pont de Lattes - Gare Saint-Roch,1,11,12,2022,01-20,02:28
053 Deux Ponts - Gare Saint-Roch,1,7,8,2022,01-20,02:28
054 Providence - Ovalie,4,4,8,2022,01-20,02:28
055 P�rols Etang de l'Or,25,43,68,2022,01-20,02:28
056 Albert 1er - Cath�drale,1,11,12,2022,01-20,02:28
057 Saint-Guilhem - Courreau,0,8,8,2022,01-20,02:28
059 Sud De France,0,8,8,2022,01-20,02:28
001 Rue Jules Ferry - Gare Saint-Roch,6,6,12,2022,01-20,02:38
002 Com�die,3,21,24,2022,01-20,02:38
003 Esplanade,10,22,32,2022,01-20,02:38
004 H�tel de Ville,8,8,16,2022,01-20,02:38
005 Corum,10,2,12,2022,01-20,02:38
006 Place Albert 1er - St Charles,29,2,31,2022,01-20,02:38
007 Foch,4,4,8,2022,01-20,02:38
008 Halles Castellane,0,12,12,2022,01-20,02:38
009 Observatoire,7,1,8,2022,01-20,02:38
010 Rondelet,3,13,16,2022,01-20,02:38
011 Plan Cabanes,8,4,12,2022,01-20,02:38
012 Boutonnet,8,4,12,2022,01-20,02:38
013 Emile Combes,3,5,8,2022,01-20,02:38
014 Beaux-Arts,3,5,8,2022,01-20,02:38
015 Les Aubes,4,4,8,2022,01-20,02:38
016 Antigone centre,16,0,16,2022,01-20,02:38
017 M�diath�que Emile Zola,16,0,16,2022,01-20,02:38
018 Nombre d'Or,12,4,16,2022,01-20,02:38
019 Louis Blanc,11,5,16,2022,01-20,02:38
020 Gambetta,6,2,8,2022,01-20,02:38
021 Port Marianne,5,11,16,2022,01-20,02:38
022 Clemenceau,1,11,12,2022,01-20,02:38
023 Les Arceaux,2,14,16,2022,01-20,02:38
024 Cit� Mion,4,4,8,2022,01-20,02:38
025 Nouveau Saint-Roch,5,3,8,2022,01-20,02:38
026 Renouvier,1,7,8,2022,01-20,02:38
027 Odysseum,0,8,8,2022,01-20,02:38
028 Saint-Denis,2,6,8,2022,01-20,02:38
029 Richter,14,2,16,2022,01-20,02:38
030 Charles Flahault,4,4,8,2022,01-20,02:38
031 Voltaire,2,6,8,2022,01-20,02:38
032 Pr�s d'Ar�nes,7,1,8,2022,01-20,02:38
033 Garcia Lorca,6,2,8,2022,01-20,02:38
034 Vert Bois,0,16,16,2022,01-20,02:38
035 Malbosc,1,7,8,2022,01-20,02:38
036 Occitanie,4,28,32,2022,01-20,02:38
037 FacdesSciences,6,18,24,2022,01-20,02:38
038 Fac de Lettres,1,15,16,2022,01-20,02:38
039 Aiguelongue,2,6,8,2022,01-20,02:38
040 Jeu de Mail des Abb�s,8,0,8,2022,01-20,02:38
041 Eurom�decine,0,8,8,2022,01-20,02:38
042 Marie Caizergues,1,7,8,2022,01-20,02:38
043 Sabines,4,4,8,2022,01-20,02:38
044 Celleneuve,2,6,8,2022,01-20,02:38
045 Jardin de la Lironde,2,6,8,2022,01-20,02:38
046 P�re Soulas,8,0,8,2022,01-20,02:38
047 Place Viala,3,5,8,2022,01-20,02:38
048 H�tel du D�partement,0,8,8,2022,01-20,02:38
049 Tonnelles,6,2,8,2022,01-20,02:38
050 Parvis Jules Ferry - Gare Saint-Roch,4,4,8,2022,01-20,02:38
051 Pont de Lattes - Gare Saint-Roch,1,11,12,2022,01-20,02:38
053 Deux Ponts - Gare Saint-Roch,1,7,8,2022,01-20,02:38
054 Providence - Ovalie,4,4,8,2022,01-20,02:38
055 P�rols Etang de l'Or,25,43,68,2022,01-20,02:38
056 Albert 1er - Cath�drale,1,11,12,2022,01-20,02:38
057 Saint-Guilhem - Courreau,0,8,8,2022,01-20,02:38
059 Sud De France,0,8,8,2022,01-20,02:38
001 Rue Jules Ferry - Gare Saint-Roch,6,6,12,2022,01-20,02:48
002 Com�die,3,21,24,2022,01-20,02:48
003 Esplanade,10,22,32,2022,01-20,02:48
004 H�tel de Ville,8,8,16,2022,01-20,02:48
005 Corum,10,2,12,2022,01-20,02:48
006 Place Albert 1er - St Charles,29,2,31,2022,01-20,02:48
007 Foch,4,4,8,2022,01-20,02:48
008 Halles Castellane,0,12,12,2022,01-20,02:48
009 Observatoire,7,1,8,2022,01-20,02:48
010 Rondelet,3,13,16,2022,01-20,02:48
011 Plan Cabanes,8,4,12,2022,01-20,02:48
012 Boutonnet,8,4,12,2022,01-20,02:48
013 Emile Combes,3,5,8,2022,01-20,02:48
014 Beaux-Arts,3,5,8,2022,01-20,02:48
015 Les Aubes,4,4,8,2022,01-20,02:48
016 Antigone centre,16,0,16,2022,01-20,02:48
017 M�diath�que Emile Zola,16,0,16,2022,01-20,02:48
018 Nombre d'Or,12,4,16,2022,01-20,02:48
019 Louis Blanc,10,6,16,2022,01-20,02:48
020 Gambetta,6,2,8,2022,01-20,02:48
021 Port Marianne,3,13,16,2022,01-20,02:48
022 Clemenceau,0,12,12,2022,01-20,02:48
023 Les Arceaux,2,14,16,2022,01-20,02:48
024 Cit� Mion,4,4,8,2022,01-20,02:48
025 Nouveau Saint-Roch,5,3,8,2022,01-20,02:48
026 Renouvier,1,7,8,2022,01-20,02:48
027 Odysseum,0,8,8,2022,01-20,02:48
028 Saint-Denis,2,6,8,2022,01-20,02:48
029 Richter,14,2,16,2022,01-20,02:48
030 Charles Flahault,4,4,8,2022,01-20,02:48
031 Voltaire,2,6,8,2022,01-20,02:48
032 Pr�s d'Ar�nes,7,1,8,2022,01-20,02:48
033 Garcia Lorca,6,2,8,2022,01-20,02:48
034 Vert Bois,0,16,16,2022,01-20,02:48
035 Malbosc,1,7,8,2022,01-20,02:48
036 Occitanie,4,28,32,2022,01-20,02:48
037 FacdesSciences,6,18,24,2022,01-20,02:48
038 Fac de Lettres,1,15,16,2022,01-20,02:48
039 Aiguelongue,2,6,8,2022,01-20,02:48
040 Jeu de Mail des Abb�s,8,0,8,2022,01-20,02:48
041 Eurom�decine,0,8,8,2022,01-20,02:48
042 Marie Caizergues,1,7,8,2022,01-20,02:48
043 Sabines,4,4,8,2022,01-20,02:48
044 Celleneuve,2,6,8,2022,01-20,02:48
045 Jardin de la Lironde,2,6,8,2022,01-20,02:48
046 P�re Soulas,8,0,8,2022,01-20,02:48
047 Place Viala,3,5,8,2022,01-20,02:48
048 H�tel du D�partement,0,8,8,2022,01-20,02:48
049 Tonnelles,6,2,8,2022,01-20,02:48
050 Parvis Jules Ferry - Gare Saint-Roch,4,4,8,2022,01-20,02:48
051 Pont de Lattes - Gare Saint-Roch,1,11,12,2022,01-20,02:48
053 Deux Ponts - Gare Saint-Roch,1,7,8,2022,01-20,02:48
054 Providence - Ovalie,4,4,8,2022,01-20,02:48
055 P�rols Etang de l'Or,25,43,68,2022,01-20,02:48
056 Albert 1er - Cath�drale,1,11,12,2022,01-20,02:48
057 Saint-Guilhem - Courreau,0,8,8,2022,01-20,02:48
059 Sud De France,0,8,8,2022,01-20,02:48
001 Rue Jules Ferry - Gare Saint-Roch,6,6,12,2022,01-20,02:59
002 Com�die,3,21,24,2022,01-20,02:59
003 Esplanade,10,22,32,2022,01-20,02:59
004 H�tel de Ville,8,8,16,2022,01-20,02:59
005 Corum,10,2,12,2022,01-20,02:59
006 Place Albert 1er - St Charles,29,2,31,2022,01-20,02:59
007 Foch,4,4,8,2022,01-20,02:59
008 Halles Castellane,0,12,12,2022,01-20,02:59
009 Observatoire,7,1,8,2022,01-20,02:59
010 Rondelet,3,13,16,2022,01-20,02:59
011 Plan Cabanes,8,4,12,2022,01-20,02:59
012 Boutonnet,8,4,12,2022,01-20,02:59
013 Emile Combes,3,5,8,2022,01-20,02:59
014 Beaux-Arts,3,5,8,2022,01-20,02:59
015 Les Aubes,4,4,8,2022,01-20,02:59
016 Antigone centre,16,0,16,2022,01-20,02:59
017 M�diath�que Emile Zola,16,0,16,2022,01-20,02:59
018 Nombre d'Or,13,3,16,2022,01-20,02:59
019 Louis Blanc,10,6,16,2022,01-20,02:59
020 Gambetta,6,2,8,2022,01-20,02:59
021 Port Marianne,3,13,16,2022,01-20,02:59
022 Clemenceau,0,12,12,2022,01-20,02:59
023 Les Arceaux,2,14,16,2022,01-20,02:59
024 Cit� Mion,4,4,8,2022,01-20,02:59
025 Nouveau Saint-Roch,5,3,8,2022,01-20,02:59
026 Renouvier,1,7,8,2022,01-20,02:59
027 Odysseum,0,8,8,2022,01-20,02:59
028 Saint-Denis,2,6,8,2022,01-20,02:59
029 Richter,14,2,16,2022,01-20,02:59
030 Charles Flahault,4,4,8,2022,01-20,02:59
031 Voltaire,2,6,8,2022,01-20,02:59
032 Pr�s d'Ar�nes,7,1,8,2022,01-20,02:59
033 Garcia Lorca,6,2,8,2022,01-20,02:59
034 Vert Bois,0,16,16,2022,01-20,02:59
035 Malbosc,1,7,8,2022,01-20,02:59
036 Occitanie,4,28,32,2022,01-20,02:59
037 FacdesSciences,5,19,24,2022,01-20,02:59
038 Fac de Lettres,1,15,16,2022,01-20,02:59
039 Aiguelongue,2,6,8,2022,01-20,02:59
040 Jeu de Mail des Abb�s,8,0,8,2022,01-20,02:59
041 Eurom�decine,0,8,8,2022,01-20,02:59
042 Marie Caizergues,1,7,8,2022,01-20,02:59
043 Sabines,4,4,8,2022,01-20,02:59
044 Celleneuve,2,6,8,2022,01-20,02:59
045 Jardin de la Lironde,2,6,8,2022,01-20,02:59
046 P�re Soulas,8,0,8,2022,01-20,02:59
047 Place Viala,4,4,8,2022,01-20,02:59
048 H�tel du D�partement,0,8,8,2022,01-20,02:59
049 Tonnelles,6,2,8,2022,01-20,02:59
050 Parvis Jules Ferry - Gare Saint-Roch,4,4,8,2022,01-20,02:59
051 Pont de Lattes - Gare Saint-Roch,1,11,12,2022,01-20,02:59
053 Deux Ponts - Gare Saint-Roch,1,7,8,2022,01-20,02:59
054 Providence - Ovalie,4,4,8,2022,01-20,02:59
055 P�rols Etang de l'Or,25,43,68,2022,01-20,02:59
056 Albert 1er - Cath�drale,1,11,12,2022,01-20,02:59
057 Saint-Guilhem - Courreau,0,8,8,2022,01-20,02:59
059 Sud De France,0,8,8,2022,01-20,02:59
001 Rue Jules Ferry - Gare Saint-Roch,6,6,12,2022,01-20,03:09
002 Com�die,3,21,24,2022,01-20,03:09
003 Esplanade,10,22,32,2022,01-20,03:09
004 H�tel de Ville,8,8,16,2022,01-20,03:09
005 Corum,10,2,12,2022,01-20,03:09
006 Place Albert 1er - St Charles,29,2,31,2022,01-20,03:09
007 Foch,4,4,8,2022,01-20,03:09
008 Halles Castellane,0,12,12,2022,01-20,03:09
009 Observatoire,7,1,8,2022,01-20,03:09
010 Rondelet,3,13,16,2022,01-20,03:09
011 Plan Cabanes,8,4,12,2022,01-20,03:09
012 Boutonnet,8,4,12,2022,01-20,03:09
013 Emile Combes,3,5,8,2022,01-20,03:09
014 Beaux-Arts,3,5,8,2022,01-20,03:09
015 Les Aubes,4,4,8,2022,01-20,03:09
016 Antigone centre,16,0,16,2022,01-20,03:09
017 M�diath�que Emile Zola,16,0,16,2022,01-20,03:09
018 Nombre d'Or,13,3,16,2022,01-20,03:09
019 Louis Blanc,10,6,16,2022,01-20,03:09
020 Gambetta,6,2,8,2022,01-20,03:09
021 Port Marianne,3,13,16,2022,01-20,03:09
022 Clemenceau,2,10,12,2022,01-20,03:09
023 Les Arceaux,2,14,16,2022,01-20,03:09
024 Cit� Mion,4,4,8,2022,01-20,03:09
025 Nouveau Saint-Roch,5,3,8,2022,01-20,03:09
026 Renouvier,1,7,8,2022,01-20,03:09
027 Odysseum,0,8,8,2022,01-20,03:09
028 Saint-Denis,2,6,8,2022,01-20,03:09
029 Richter,14,2,16,2022,01-20,03:09
030 Charles Flahault,4,4,8,2022,01-20,03:09
031 Voltaire,2,6,8,2022,01-20,03:09
032 Pr�s d'Ar�nes,7,1,8,2022,01-20,03:09
033 Garcia Lorca,6,2,8,2022,01-20,03:09
034 Vert Bois,0,16,16,2022,01-20,03:09
035 Malbosc,1,7,8,2022,01-20,03:09
036 Occitanie,4,28,32,2022,01-20,03:09
037 FacdesSciences,5,19,24,2022,01-20,03:09
038 Fac de Lettres,1,15,16,2022,01-20,03:09
039 Aiguelongue,2,6,8,2022,01-20,03:09
040 Jeu de Mail des Abb�s,8,0,8,2022,01-20,03:09
041 Eurom�decine,0,8,8,2022,01-20,03:09
042 Marie Caizergues,1,7,8,2022,01-20,03:09
043 Sabines,4,4,8,2022,01-20,03:09
044 Celleneuve,2,6,8,2022,01-20,03:09
045 Jardin de la Lironde,2,6,8,2022,01-20,03:09
046 P�re Soulas,8,0,8,2022,01-20,03:09
047 Place Viala,4,4,8,2022,01-20,03:09
048 H�tel du D�partement,0,8,8,2022,01-20,03:09
049 Tonnelles,6,2,8,2022,01-20,03:09
050 Parvis Jules Ferry - Gare Saint-Roch,4,4,8,2022,01-20,03:09
051 Pont de Lattes - Gare Saint-Roch,1,11,12,2022,01-20,03:09
053 Deux Ponts - Gare Saint-Roch,1,7,8,2022,01-20,03:09
054 Providence - Ovalie,4,4,8,2022,01-20,03:09
055 P�rols Etang de l'Or,25,43,68,2022,01-20,03:09
056 Albert 1er - Cath�drale,1,11,12,2022,01-20,03:09
057 Saint-Guilhem - Courreau,0,8,8,2022,01-20,03:09
059 Sud De France,0,8,8,2022,01-20,03:09
001 Rue Jules Ferry - Gare Saint-Roch,6,6,12,2022,01-20,03:19
002 Com�die,3,21,24,2022,01-20,03:19
003 Esplanade,10,22,32,2022,01-20,03:19
004 H�tel de Ville,8,8,16,2022,01-20,03:19
005 Corum,11,1,12,2022,01-20,03:19
006 Place Albert 1er - St Charles,29,2,31,2022,01-20,03:19
007 Foch,4,4,8,2022,01-20,03:19
008 Halles Castellane,0,12,12,2022,01-20,03:19
009 Observatoire,7,1,8,2022,01-20,03:19
010 Rondelet,3,13,16,2022,01-20,03:19
011 Plan Cabanes,8,4,12,2022,01-20,03:19
012 Boutonnet,8,4,12,2022,01-20,03:19
013 Emile Combes,3,5,8,2022,01-20,03:19
014 Beaux-Arts,3,5,8,2022,01-20,03:19
015 Les Aubes,4,4,8,2022,01-20,03:19
016 Antigone centre,16,0,16,2022,01-20,03:19
017 M�diath�que Emile Zola,16,0,16,2022,01-20,03:19
018 Nombre d'Or,13,3,16,2022,01-20,03:19
019 Louis Blanc,10,6,16,2022,01-20,03:19
020 Gambetta,6,2,8,2022,01-20,03:19
021 Port Marianne,3,13,16,2022,01-20,03:19
022 Clemenceau,2,10,12,2022,01-20,03:19
023 Les Arceaux,2,14,16,2022,01-20,03:19
024 Cit� Mion,4,4,8,2022,01-20,03:19
025 Nouveau Saint-Roch,5,3,8,2022,01-20,03:19
026 Renouvier,1,7,8,2022,01-20,03:19
027 Odysseum,0,8,8,2022,01-20,03:19
028 Saint-Denis,2,6,8,2022,01-20,03:19
029 Richter,14,2,16,2022,01-20,03:19
030 Charles Flahault,4,4,8,2022,01-20,03:19
031 Voltaire,2,6,8,2022,01-20,03:19
032 Pr�s d'Ar�nes,7,1,8,2022,01-20,03:19
033 Garcia Lorca,6,2,8,2022,01-20,03:19
034 Vert Bois,0,16,16,2022,01-20,03:19
035 Malbosc,1,7,8,2022,01-20,03:19
036 Occitanie,4,28,32,2022,01-20,03:19
037 FacdesSciences,5,19,24,2022,01-20,03:19
038 Fac de Lettres,1,15,16,2022,01-20,03:19
039 Aiguelongue,2,6,8,2022,01-20,03:19
040 Jeu de Mail des Abb�s,8,0,8,2022,01-20,03:19
041 Eurom�decine,0,8,8,2022,01-20,03:19
042 Marie Caizergues,1,7,8,2022,01-20,03:19
043 Sabines,4,4,8,2022,01-20,03:19
044 Celleneuve,2,6,8,2022,01-20,03:19
045 Jardin de la Lironde,2,6,8,2022,01-20,03:19
046 P�re Soulas,8,0,8,2022,01-20,03:19
047 Place Viala,4,4,8,2022,01-20,03:19
048 H�tel du D�partement,0,8,8,2022,01-20,03:19
049 Tonnelles,6,2,8,2022,01-20,03:19
050 Parvis Jules Ferry - Gare Saint-Roch,4,4,8,2022,01-20,03:19
051 Pont de Lattes - Gare Saint-Roch,1,11,12,2022,01-20,03:19
053 Deux Ponts - Gare Saint-Roch,1,7,8,2022,01-20,03:19
054 Providence - Ovalie,4,4,8,2022,01-20,03:19
055 P�rols Etang de l'Or,25,43,68,2022,01-20,03:19
056 Albert 1er - Cath�drale,1,11,12,2022,01-20,03:19
057 Saint-Guilhem - Courreau,0,8,8,2022,01-20,03:19
059 Sud De France,0,8,8,2022,01-20,03:19
001 Rue Jules Ferry - Gare Saint-Roch,6,6,12,2022,01-20,03:29
002 Com�die,3,21,24,2022,01-20,03:29
003 Esplanade,9,23,32,2022,01-20,03:29
004 H�tel de Ville,8,8,16,2022,01-20,03:29
005 Corum,11,1,12,2022,01-20,03:29
006 Place Albert 1er - St Charles,29,2,31,2022,01-20,03:29
007 Foch,4,4,8,2022,01-20,03:29
008 Halles Castellane,0,12,12,2022,01-20,03:29
009 Observatoire,7,1,8,2022,01-20,03:29
010 Rondelet,3,13,16,2022,01-20,03:29
011 Plan Cabanes,8,4,12,2022,01-20,03:29
012 Boutonnet,8,4,12,2022,01-20,03:29
013 Emile Combes,3,5,8,2022,01-20,03:29
014 Beaux-Arts,3,5,8,2022,01-20,03:29
015 Les Aubes,4,4,8,2022,01-20,03:29
016 Antigone centre,16,0,16,2022,01-20,03:29
017 M�diath�que Emile Zola,16,0,16,2022,01-20,03:29
018 Nombre d'Or,13,3,16,2022,01-20,03:29
019 Louis Blanc,10,6,16,2022,01-20,03:29
020 Gambetta,6,2,8,2022,01-20,03:29
021 Port Marianne,3,13,16,2022,01-20,03:29
022 Clemenceau,2,10,12,2022,01-20,03:29
023 Les Arceaux,2,14,16,2022,01-20,03:29
024 Cit� Mion,4,4,8,2022,01-20,03:29
025 Nouveau Saint-Roch,5,3,8,2022,01-20,03:29
026 Renouvier,1,7,8,2022,01-20,03:29
027 Odysseum,0,8,8,2022,01-20,03:29
028 Saint-Denis,2,6,8,2022,01-20,03:29
029 Richter,14,2,16,2022,01-20,03:29
030 Charles Flahault,4,4,8,2022,01-20,03:29
031 Voltaire,2,6,8,2022,01-20,03:29
032 Pr�s d'Ar�nes,7,1,8,2022,01-20,03:29
033 Garcia Lorca,6,2,8,2022,01-20,03:29
034 Vert Bois,0,16,16,2022,01-20,03:29
035 Malbosc,1,7,8,2022,01-20,03:29
036 Occitanie,4,28,32,2022,01-20,03:29
037 FacdesSciences,5,19,24,2022,01-20,03:29
038 Fac de Lettres,1,15,16,2022,01-20,03:29
039 Aiguelongue,2,6,8,2022,01-20,03:29
040 Jeu de Mail des Abb�s,8,0,8,2022,01-20,03:29
041 Eurom�decine,0,8,8,2022,01-20,03:29
042 Marie Caizergues,1,7,8,2022,01-20,03:29
043 Sabines,4,4,8,2022,01-20,03:29
044 Celleneuve,2,6,8,2022,01-20,03:29
045 Jardin de la Lironde,2,6,8,2022,01-20,03:29
046 P�re Soulas,8,0,8,2022,01-20,03:29
047 Place Viala,4,4,8,2022,01-20,03:29
048 H�tel du D�partement,0,8,8,2022,01-20,03:29
049 Tonnelles,6,2,8,2022,01-20,03:29
050 Parvis Jules Ferry - Gare Saint-Roch,4,4,8,2022,01-20,03:29
051 Pont de Lattes - Gare Saint-Roch,1,11,12,2022,01-20,03:29
053 Deux Ponts - Gare Saint-Roch,1,7,8,2022,01-20,03:29
054 Providence - Ovalie,4,4,8,2022,01-20,03:29
055 P�rols Etang de l'Or,25,43,68,2022,01-20,03:29
056 Albert 1er - Cath�drale,1,11,12,2022,01-20,03:29
057 Saint-Guilhem - Courreau,0,8,8,2022,01-20,03:29
059 Sud De France,0,8,8,2022,01-20,03:29
001 Rue Jules Ferry - Gare Saint-Roch,6,6,12,2022,01-20,03:39
002 Com�die,3,21,24,2022,01-20,03:39
003 Esplanade,9,23,32,2022,01-20,03:39
004 H�tel de Ville,8,8,16,2022,01-20,03:39
005 Corum,11,1,12,2022,01-20,03:39
006 Place Albert 1er - St Charles,29,2,31,2022,01-20,03:39
007 Foch,4,4,8,2022,01-20,03:39
008 Halles Castellane,0,12,12,2022,01-20,03:39
009 Observatoire,7,1,8,2022,01-20,03:39
010 Rondelet,4,12,16,2022,01-20,03:39
011 Plan Cabanes,8,4,12,2022,01-20,03:39
012 Boutonnet,8,4,12,2022,01-20,03:39
013 Emile Combes,3,5,8,2022,01-20,03:39
014 Beaux-Arts,3,5,8,2022,01-20,03:39
015 Les Aubes,4,4,8,2022,01-20,03:39
016 Antigone centre,16,0,16,2022,01-20,03:39
017 M�diath�que Emile Zola,16,0,16,2022,01-20,03:39
018 Nombre d'Or,13,3,16,2022,01-20,03:39
019 Louis Blanc,10,6,16,2022,01-20,03:39
020 Gambetta,6,2,8,2022,01-20,03:39
021 Port Marianne,3,13,16,2022,01-20,03:39
022 Clemenceau,2,10,12,2022,01-20,03:39
023 Les Arceaux,2,14,16,2022,01-20,03:39
024 Cit� Mion,4,4,8,2022,01-20,03:39
025 Nouveau Saint-Roch,5,3,8,2022,01-20,03:39
026 Renouvier,1,7,8,2022,01-20,03:39
027 Odysseum,0,8,8,2022,01-20,03:39
028 Saint-Denis,2,6,8,2022,01-20,03:39
029 Richter,14,2,16,2022,01-20,03:39
030 Charles Flahault,4,4,8,2022,01-20,03:39
031 Voltaire,2,6,8,2022,01-20,03:39
032 Pr�s d'Ar�nes,7,1,8,2022,01-20,03:39
033 Garcia Lorca,6,2,8,2022,01-20,03:39
034 Vert Bois,0,16,16,2022,01-20,03:39
035 Malbosc,1,7,8,2022,01-20,03:39
036 Occitanie,4,28,32,2022,01-20,03:39
037 FacdesSciences,5,19,24,2022,01-20,03:39
038 Fac de Lettres,1,15,16,2022,01-20,03:39
039 Aiguelongue,2,6,8,2022,01-20,03:39
040 Jeu de Mail des Abb�s,8,0,8,2022,01-20,03:39
041 Eurom�decine,0,8,8,2022,01-20,03:39
042 Marie Caizergues,1,7,8,2022,01-20,03:39
043 Sabines,4,4,8,2022,01-20,03:39
044 Celleneuve,2,6,8,2022,01-20,03:39
045 Jardin de la Lironde,2,6,8,2022,01-20,03:39
046 P�re Soulas,8,0,8,2022,01-20,03:39
047 Place Viala,4,4,8,2022,01-20,03:39
048 H�tel du D�partement,0,8,8,2022,01-20,03:39
049 Tonnelles,6,2,8,2022,01-20,03:39
050 Parvis Jules Ferry - Gare Saint-Roch,4,4,8,2022,01-20,03:39
051 Pont de Lattes - Gare Saint-Roch,1,11,12,2022,01-20,03:39
053 Deux Ponts - Gare Saint-Roch,1,7,8,2022,01-20,03:39
054 Providence - Ovalie,4,4,8,2022,01-20,03:39
055 P�rols Etang de l'Or,25,43,68,2022,01-20,03:39
056 Albert 1er - Cath�drale,1,11,12,2022,01-20,03:39
057 Saint-Guilhem - Courreau,0,8,8,2022,01-20,03:39
059 Sud De France,0,8,8,2022,01-20,03:39
001 Rue Jules Ferry - Gare Saint-Roch,6,6,12,2022,01-20,03:50
002 Com�die,3,21,24,2022,01-20,03:50
003 Esplanade,9,23,32,2022,01-20,03:50
004 H�tel de Ville,8,8,16,2022,01-20,03:50
005 Corum,11,1,12,2022,01-20,03:50
006 Place Albert 1er - St Charles,29,2,31,2022,01-20,03:50
007 Foch,4,4,8,2022,01-20,03:50
008 Halles Castellane,0,12,12,2022,01-20,03:50
009 Observatoire,7,1,8,2022,01-20,03:50
010 Rondelet,4,12,16,2022,01-20,03:50
011 Plan Cabanes,6,6,12,2022,01-20,03:50
012 Boutonnet,8,4,12,2022,01-20,03:50
013 Emile Combes,3,5,8,2022,01-20,03:50
014 Beaux-Arts,3,5,8,2022,01-20,03:50
015 Les Aubes,4,4,8,2022,01-20,03:50
016 Antigone centre,16,0,16,2022,01-20,03:50
017 M�diath�que Emile Zola,16,0,16,2022,01-20,03:50
018 Nombre d'Or,13,3,16,2022,01-20,03:50
019 Louis Blanc,10,6,16,2022,01-20,03:50
020 Gambetta,6,2,8,2022,01-20,03:50
021 Port Marianne,3,13,16,2022,01-20,03:50
022 Clemenceau,2,10,12,2022,01-20,03:50
023 Les Arceaux,2,14,16,2022,01-20,03:50
024 Cit� Mion,4,4,8,2022,01-20,03:50
025 Nouveau Saint-Roch,5,3,8,2022,01-20,03:50
026 Renouvier,1,7,8,2022,01-20,03:50
027 Odysseum,0,8,8,2022,01-20,03:50
028 Saint-Denis,2,6,8,2022,01-20,03:50
029 Richter,14,2,16,2022,01-20,03:50
030 Charles Flahault,4,4,8,2022,01-20,03:50
031 Voltaire,2,6,8,2022,01-20,03:50
032 Pr�s d'Ar�nes,7,1,8,2022,01-20,03:50
033 Garcia Lorca,6,2,8,2022,01-20,03:50
034 Vert Bois,0,16,16,2022,01-20,03:50
035 Malbosc,1,7,8,2022,01-20,03:50
036 Occitanie,4,28,32,2022,01-20,03:50
037 FacdesSciences,5,19,24,2022,01-20,03:50
038 Fac de Lettres,1,15,16,2022,01-20,03:50
039 Aiguelongue,2,6,8,2022,01-20,03:50
040 Jeu de Mail des Abb�s,8,0,8,2022,01-20,03:50
041 Eurom�decine,0,8,8,2022,01-20,03:50
042 Marie Caizergues,1,7,8,2022,01-20,03:50
043 Sabines,4,4,8,2022,01-20,03:50
044 Celleneuve,2,6,8,2022,01-20,03:50
045 Jardin de la Lironde,2,6,8,2022,01-20,03:50
046 P�re Soulas,8,0,8,2022,01-20,03:50
047 Place Viala,4,4,8,2022,01-20,03:50
048 H�tel du D�partement,0,8,8,2022,01-20,03:50
049 Tonnelles,6,2,8,2022,01-20,03:50
050 Parvis Jules Ferry - Gare Saint-Roch,4,4,8,2022,01-20,03:50
051 Pont de Lattes - Gare Saint-Roch,1,11,12,2022,01-20,03:50
053 Deux Ponts - Gare Saint-Roch,1,7,8,2022,01-20,03:50
054 Providence - Ovalie,4,4,8,2022,01-20,03:50
055 P�rols Etang de l'Or,25,43,68,2022,01-20,03:50
056 Albert 1er - Cath�drale,1,11,12,2022,01-20,03:50
057 Saint-Guilhem - Courreau,0,8,8,2022,01-20,03:50
059 Sud De France,0,8,8,2022,01-20,03:50
001 Rue Jules Ferry - Gare Saint-Roch,6,6,12,2022,01-20,04:00
002 Com�die,3,21,24,2022,01-20,04:00
003 Esplanade,9,23,32,2022,01-20,04:00
004 H�tel de Ville,8,8,16,2022,01-20,04:00
005 Corum,11,1,12,2022,01-20,04:00
006 Place Albert 1er - St Charles,29,2,31,2022,01-20,04:00
007 Foch,4,4,8,2022,01-20,04:00
008 Halles Castellane,0,12,12,2022,01-20,04:00
009 Observatoire,7,1,8,2022,01-20,04:00
010 Rondelet,4,12,16,2022,01-20,04:00
011 Plan Cabanes,6,6,12,2022,01-20,04:00
012 Boutonnet,8,4,12,2022,01-20,04:00
013 Emile Combes,3,5,8,2022,01-20,04:00
014 Beaux-Arts,3,5,8,2022,01-20,04:00
015 Les Aubes,4,4,8,2022,01-20,04:00
016 Antigone centre,16,0,16,2022,01-20,04:00
017 M�diath�que Emile Zola,16,0,16,2022,01-20,04:00
018 Nombre d'Or,15,1,16,2022,01-20,04:00
019 Louis Blanc,11,5,16,2022,01-20,04:00
020 Gambetta,6,2,8,2022,01-20,04:00
021 Port Marianne,3,13,16,2022,01-20,04:00
022 Clemenceau,2,10,12,2022,01-20,04:00
023 Les Arceaux,2,14,16,2022,01-20,04:00
024 Cit� Mion,4,4,8,2022,01-20,04:00
025 Nouveau Saint-Roch,5,3,8,2022,01-20,04:00
026 Renouvier,1,7,8,2022,01-20,04:00
027 Odysseum,0,8,8,2022,01-20,04:00
028 Saint-Denis,2,6,8,2022,01-20,04:00
029 Richter,14,2,16,2022,01-20,04:00
030 Charles Flahault,4,4,8,2022,01-20,04:00
031 Voltaire,2,6,8,2022,01-20,04:00
032 Pr�s d'Ar�nes,7,1,8,2022,01-20,04:00
033 Garcia Lorca,6,2,8,2022,01-20,04:00
034 Vert Bois,0,16,16,2022,01-20,04:00
035 Malbosc,1,7,8,2022,01-20,04:00
036 Occitanie,4,28,32,2022,01-20,04:00
037 FacdesSciences,5,19,24,2022,01-20,04:00
038 Fac de Lettres,1,15,16,2022,01-20,04:00
039 Aiguelongue,2,6,8,2022,01-20,04:00
040 Jeu de Mail des Abb�s,8,0,8,2022,01-20,04:00
041 Eurom�decine,0,8,8,2022,01-20,04:00
042 Marie Caizergues,1,7,8,2022,01-20,04:00
043 Sabines,4,4,8,2022,01-20,04:00
044 Celleneuve,2,6,8,2022,01-20,04:00
045 Jardin de la Lironde,2,6,8,2022,01-20,04:00
046 P�re Soulas,8,0,8,2022,01-20,04:00
047 Place Viala,4,4,8,2022,01-20,04:00
048 H�tel du D�partement,0,8,8,2022,01-20,04:00
049 Tonnelles,6,2,8,2022,01-20,04:00
050 Parvis Jules Ferry - Gare Saint-Roch,4,4,8,2022,01-20,04:00
051 Pont de Lattes - Gare Saint-Roch,1,11,12,2022,01-20,04:00
053 Deux Ponts - Gare Saint-Roch,1,7,8,2022,01-20,04:00
054 Providence - Ovalie,4,4,8,2022,01-20,04:00
055 P�rols Etang de l'Or,25,43,68,2022,01-20,04:00
056 Albert 1er - Cath�drale,1,11,12,2022,01-20,04:00
057 Saint-Guilhem - Courreau,0,8,8,2022,01-20,04:00
059 Sud De France,0,8,8,2022,01-20,04:00
001 Rue Jules Ferry - Gare Saint-Roch,6,6,12,2022,01-20,04:10
002 Com�die,3,21,24,2022,01-20,04:10
003 Esplanade,9,23,32,2022,01-20,04:10
004 H�tel de Ville,8,8,16,2022,01-20,04:10
005 Corum,11,1,12,2022,01-20,04:10
006 Place Albert 1er - St Charles,29,2,31,2022,01-20,04:10
007 Foch,4,4,8,2022,01-20,04:10
008 Halles Castellane,0,12,12,2022,01-20,04:10
009 Observatoire,7,1,8,2022,01-20,04:10
010 Rondelet,4,12,16,2022,01-20,04:10
011 Plan Cabanes,6,6,12,2022,01-20,04:10
012 Boutonnet,8,4,12,2022,01-20,04:10
013 Emile Combes,3,5,8,2022,01-20,04:10
014 Beaux-Arts,3,5,8,2022,01-20,04:10
015 Les Aubes,4,4,8,2022,01-20,04:10
016 Antigone centre,16,0,16,2022,01-20,04:10
017 M�diath�que Emile Zola,16,0,16,2022,01-20,04:10
018 Nombre d'Or,15,1,16,2022,01-20,04:10
019 Louis Blanc,11,5,16,2022,01-20,04:10
020 Gambetta,6,2,8,2022,01-20,04:10
021 Port Marianne,3,13,16,2022,01-20,04:10
022 Clemenceau,2,10,12,2022,01-20,04:10
023 Les Arceaux,2,14,16,2022,01-20,04:10
024 Cit� Mion,4,4,8,2022,01-20,04:10
025 Nouveau Saint-Roch,5,3,8,2022,01-20,04:10
026 Renouvier,1,7,8,2022,01-20,04:10
027 Odysseum,0,8,8,2022,01-20,04:10
028 Saint-Denis,2,6,8,2022,01-20,04:10
029 Richter,14,2,16,2022,01-20,04:10
030 Charles Flahault,4,4,8,2022,01-20,04:10
031 Voltaire,2,6,8,2022,01-20,04:10
032 Pr�s d'Ar�nes,7,1,8,2022,01-20,04:10
033 Garcia Lorca,6,2,8,2022,01-20,04:10
034 Vert Bois,0,16,16,2022,01-20,04:10
035 Malbosc,1,7,8,2022,01-20,04:10
036 Occitanie,4,28,32,2022,01-20,04:10
037 FacdesSciences,5,19,24,2022,01-20,04:10
038 Fac de Lettres,1,15,16,2022,01-20,04:10
039 Aiguelongue,2,6,8,2022,01-20,04:10
040 Jeu de Mail des Abb�s,8,0,8,2022,01-20,04:10
041 Eurom�decine,0,8,8,2022,01-20,04:10
042 Marie Caizergues,1,7,8,2022,01-20,04:10
043 Sabines,4,4,8,2022,01-20,04:10
044 Celleneuve,2,6,8,2022,01-20,04:10
045 Jardin de la Lironde,2,6,8,2022,01-20,04:10
046 P�re Soulas,8,0,8,2022,01-20,04:10
047 Place Viala,4,4,8,2022,01-20,04:10
048 H�tel du D�partement,0,8,8,2022,01-20,04:10
049 Tonnelles,6,2,8,2022,01-20,04:10
050 Parvis Jules Ferry - Gare Saint-Roch,4,4,8,2022,01-20,04:10
051 Pont de Lattes - Gare Saint-Roch,1,11,12,2022,01-20,04:10
053 Deux Ponts - Gare Saint-Roch,1,7,8,2022,01-20,04:10
054 Providence - Ovalie,4,4,8,2022,01-20,04:10
055 P�rols Etang de l'Or,25,43,68,2022,01-20,04:10
056 Albert 1er - Cath�drale,1,11,12,2022,01-20,04:10
057 Saint-Guilhem - Courreau,0,8,8,2022,01-20,04:10
059 Sud De France,0,8,8,2022,01-20,04:10
001 Rue Jules Ferry - Gare Saint-Roch,6,6,12,2022,01-20,04:20
002 Com�die,3,21,24,2022,01-20,04:20
003 Esplanade,9,23,32,2022,01-20,04:20
004 H�tel de Ville,8,8,16,2022,01-20,04:20
005 Corum,11,1,12,2022,01-20,04:20
006 Place Albert 1er - St Charles,29,2,31,2022,01-20,04:20
007 Foch,4,4,8,2022,01-20,04:20
008 Halles Castellane,0,12,12,2022,01-20,04:20
009 Observatoire,7,1,8,2022,01-20,04:20
010 Rondelet,4,12,16,2022,01-20,04:20
011 Plan Cabanes,6,6,12,2022,01-20,04:20
012 Boutonnet,8,4,12,2022,01-20,04:20
013 Emile Combes,3,5,8,2022,01-20,04:20
014 Beaux-Arts,3,5,8,2022,01-20,04:20
015 Les Aubes,4,4,8,2022,01-20,04:20
016 Antigone centre,16,0,16,2022,01-20,04:20
017 M�diath�que Emile Zola,15,1,16,2022,01-20,04:20
018 Nombre d'Or,14,2,16,2022,01-20,04:20
019 Louis Blanc,11,5,16,2022,01-20,04:20
020 Gambetta,6,2,8,2022,01-20,04:20
021 Port Marianne,3,13,16,2022,01-20,04:20
022 Clemenceau,2,10,12,2022,01-20,04:20
023 Les Arceaux,2,14,16,2022,01-20,04:20
024 Cit� Mion,4,4,8,2022,01-20,04:20
025 Nouveau Saint-Roch,5,3,8,2022,01-20,04:20
026 Renouvier,1,7,8,2022,01-20,04:20
027 Odysseum,0,8,8,2022,01-20,04:20
028 Saint-Denis,2,6,8,2022,01-20,04:20
029 Richter,14,2,16,2022,01-20,04:20
030 Charles Flahault,4,4,8,2022,01-20,04:20
031 Voltaire,2,6,8,2022,01-20,04:20
032 Pr�s d'Ar�nes,7,1,8,2022,01-20,04:20
033 Garcia Lorca,6,2,8,2022,01-20,04:20
034 Vert Bois,0,16,16,2022,01-20,04:20
035 Malbosc,1,7,8,2022,01-20,04:20
036 Occitanie,4,28,32,2022,01-20,04:20
037 FacdesSciences,5,19,24,2022,01-20,04:20
038 Fac de Lettres,1,15,16,2022,01-20,04:20
039 Aiguelongue,2,6,8,2022,01-20,04:20
040 Jeu de Mail des Abb�s,8,0,8,2022,01-20,04:20
041 Eurom�decine,0,8,8,2022,01-20,04:20
042 Marie Caizergues,1,7,8,2022,01-20,04:20
043 Sabines,4,4,8,2022,01-20,04:20
044 Celleneuve,2,6,8,2022,01-20,04:20
045 Jardin de la Lironde,2,6,8,2022,01-20,04:20
046 P�re Soulas,8,0,8,2022,01-20,04:20
047 Place Viala,4,4,8,2022,01-20,04:20
048 H�tel du D�partement,0,8,8,2022,01-20,04:20
049 Tonnelles,6,2,8,2022,01-20,04:20
050 Parvis Jules Ferry - Gare Saint-Roch,4,4,8,2022,01-20,04:20
051 Pont de Lattes - Gare Saint-Roch,1,11,12,2022,01-20,04:20
053 Deux Ponts - Gare Saint-Roch,1,7,8,2022,01-20,04:20
054 Providence - Ovalie,4,4,8,2022,01-20,04:20
055 P�rols Etang de l'Or,25,43,68,2022,01-20,04:20
056 Albert 1er - Cath�drale,1,11,12,2022,01-20,04:20
057 Saint-Guilhem - Courreau,0,8,8,2022,01-20,04:20
059 Sud De France,0,8,8,2022,01-20,04:20
001 Rue Jules Ferry - Gare Saint-Roch,6,6,12,2022,01-20,04:30
002 Com�die,3,21,24,2022,01-20,04:30
003 Esplanade,9,23,32,2022,01-20,04:30
004 H�tel de Ville,8,8,16,2022,01-20,04:30
005 Corum,11,1,12,2022,01-20,04:30
006 Place Albert 1er - St Charles,29,2,31,2022,01-20,04:30
007 Foch,4,4,8,2022,01-20,04:30
008 Halles Castellane,0,12,12,2022,01-20,04:30
009 Observatoire,7,1,8,2022,01-20,04:30
010 Rondelet,4,12,16,2022,01-20,04:30
011 Plan Cabanes,7,5,12,2022,01-20,04:30
012 Boutonnet,8,4,12,2022,01-20,04:30
013 Emile Combes,3,5,8,2022,01-20,04:30
014 Beaux-Arts,3,5,8,2022,01-20,04:30
015 Les Aubes,4,4,8,2022,01-20,04:30
016 Antigone centre,16,0,16,2022,01-20,04:30
017 M�diath�que Emile Zola,15,1,16,2022,01-20,04:30
018 Nombre d'Or,14,2,16,2022,01-20,04:30
019 Louis Blanc,11,5,16,2022,01-20,04:30
020 Gambetta,6,2,8,2022,01-20,04:30
021 Port Marianne,3,13,16,2022,01-20,04:30
022 Clemenceau,2,10,12,2022,01-20,04:30
023 Les Arceaux,2,14,16,2022,01-20,04:30
024 Cit� Mion,4,4,8,2022,01-20,04:30
025 Nouveau Saint-Roch,5,3,8,2022,01-20,04:30
026 Renouvier,1,7,8,2022,01-20,04:30
027 Odysseum,0,8,8,2022,01-20,04:30
028 Saint-Denis,2,6,8,2022,01-20,04:30
029 Richter,14,2,16,2022,01-20,04:30
030 Charles Flahault,4,4,8,2022,01-20,04:30
031 Voltaire,2,6,8,2022,01-20,04:30
032 Pr�s d'Ar�nes,7,1,8,2022,01-20,04:30
033 Garcia Lorca,6,2,8,2022,01-20,04:30
034 Vert Bois,0,16,16,2022,01-20,04:30
035 Malbosc,1,7,8,2022,01-20,04:30
036 Occitanie,4,28,32,2022,01-20,04:30
037 FacdesSciences,5,19,24,2022,01-20,04:30
038 Fac de Lettres,1,15,16,2022,01-20,04:30
039 Aiguelongue,2,6,8,2022,01-20,04:30
040 Jeu de Mail des Abb�s,8,0,8,2022,01-20,04:30
041 Eurom�decine,0,8,8,2022,01-20,04:30
042 Marie Caizergues,1,7,8,2022,01-20,04:30
043 Sabines,4,4,8,2022,01-20,04:30
044 Celleneuve,2,6,8,2022,01-20,04:30
045 Jardin de la Lironde,2,6,8,2022,01-20,04:30
046 P�re Soulas,8,0,8,2022,01-20,04:30
047 Place Viala,4,4,8,2022,01-20,04:30
048 H�tel du D�partement,0,8,8,2022,01-20,04:30
049 Tonnelles,6,2,8,2022,01-20,04:30
050 Parvis Jules Ferry - Gare Saint-Roch,4,4,8,2022,01-20,04:30
051 Pont de Lattes - Gare Saint-Roch,1,11,12,2022,01-20,04:30
053 Deux Ponts - Gare Saint-Roch,1,7,8,2022,01-20,04:30
054 Providence - Ovalie,4,4,8,2022,01-20,04:30
055 P�rols Etang de l'Or,25,43,68,2022,01-20,04:30
056 Albert 1er - Cath�drale,1,11,12,2022,01-20,04:30
057 Saint-Guilhem - Courreau,0,8,8,2022,01-20,04:30
059 Sud De France,0,8,8,2022,01-20,04:30
001 Rue Jules Ferry - Gare Saint-Roch,6,6,12,2022,01-20,04:40
002 Com�die,3,21,24,2022,01-20,04:40
003 Esplanade,9,23,32,2022,01-20,04:40
004 H�tel de Ville,8,8,16,2022,01-20,04:40
005 Corum,11,1,12,2022,01-20,04:40
006 Place Albert 1er - St Charles,29,2,31,2022,01-20,04:40
007 Foch,4,4,8,2022,01-20,04:40
008 Halles Castellane,0,12,12,2022,01-20,04:40
009 Observatoire,7,1,8,2022,01-20,04:40
010 Rondelet,4,12,16,2022,01-20,04:40
011 Plan Cabanes,7,5,12,2022,01-20,04:40
012 Boutonnet,8,4,12,2022,01-20,04:40
013 Emile Combes,3,5,8,2022,01-20,04:40
014 Beaux-Arts,3,5,8,2022,01-20,04:40
015 Les Aubes,4,4,8,2022,01-20,04:40
016 Antigone centre,16,0,16,2022,01-20,04:40
017 M�diath�que Emile Zola,15,1,16,2022,01-20,04:40
018 Nombre d'Or,14,2,16,2022,01-20,04:40
019 Louis Blanc,11,5,16,2022,01-20,04:40
020 Gambetta,6,2,8,2022,01-20,04:40
021 Port Marianne,3,13,16,2022,01-20,04:40
022 Clemenceau,2,10,12,2022,01-20,04:40
023 Les Arceaux,2,14,16,2022,01-20,04:40
024 Cit� Mion,4,4,8,2022,01-20,04:40
025 Nouveau Saint-Roch,5,3,8,2022,01-20,04:40
026 Renouvier,1,7,8,2022,01-20,04:40
027 Odysseum,0,8,8,2022,01-20,04:40
028 Saint-Denis,2,6,8,2022,01-20,04:40
029 Richter,14,2,16,2022,01-20,04:40
030 Charles Flahault,4,4,8,2022,01-20,04:40
031 Voltaire,2,6,8,2022,01-20,04:40
032 Pr�s d'Ar�nes,7,1,8,2022,01-20,04:40
033 Garcia Lorca,6,2,8,2022,01-20,04:40
034 Vert Bois,0,16,16,2022,01-20,04:40
035 Malbosc,1,7,8,2022,01-20,04:40
036 Occitanie,4,28,32,2022,01-20,04:40
037 FacdesSciences,5,19,24,2022,01-20,04:40
038 Fac de Lettres,1,15,16,2022,01-20,04:40
039 Aiguelongue,2,6,8,2022,01-20,04:40
040 Jeu de Mail des Abb�s,8,0,8,2022,01-20,04:40
041 Eurom�decine,0,8,8,2022,01-20,04:40
042 Marie Caizergues,1,7,8,2022,01-20,04:40
043 Sabines,4,4,8,2022,01-20,04:40
044 Celleneuve,2,6,8,2022,01-20,04:40
045 Jardin de la Lironde,2,6,8,2022,01-20,04:40
046 P�re Soulas,8,0,8,2022,01-20,04:40
047 Place Viala,4,4,8,2022,01-20,04:40
048 H�tel du D�partement,0,8,8,2022,01-20,04:40
049 Tonnelles,6,2,8,2022,01-20,04:40
050 Parvis Jules Ferry - Gare Saint-Roch,4,4,8,2022,01-20,04:40
051 Pont de Lattes - Gare Saint-Roch,1,11,12,2022,01-20,04:40
053 Deux Ponts - Gare Saint-Roch,1,7,8,2022,01-20,04:40
054 Providence - Ovalie,4,4,8,2022,01-20,04:40
055 P�rols Etang de l'Or,25,43,68,2022,01-20,04:40
056 Albert 1er - Cath�drale,1,11,12,2022,01-20,04:40
057 Saint-Guilhem - Courreau,0,8,8,2022,01-20,04:40
059 Sud De France,0,8,8,2022,01-20,04:40
001 Rue Jules Ferry - Gare Saint-Roch,6,6,12,2022,01-20,04:50
002 Com�die,3,21,24,2022,01-20,04:50
003 Esplanade,9,23,32,2022,01-20,04:50
004 H�tel de Ville,8,8,16,2022,01-20,04:50
005 Corum,11,1,12,2022,01-20,04:50
006 Place Albert 1er - St Charles,29,2,31,2022,01-20,04:50
007 Foch,4,4,8,2022,01-20,04:50
008 Halles Castellane,0,12,12,2022,01-20,04:50
009 Observatoire,7,1,8,2022,01-20,04:50
010 Rondelet,4,12,16,2022,01-20,04:50
011 Plan Cabanes,7,5,12,2022,01-20,04:50
012 Boutonnet,8,4,12,2022,01-20,04:50
013 Emile Combes,3,5,8,2022,01-20,04:50
014 Beaux-Arts,3,5,8,2022,01-20,04:50
015 Les Aubes,4,4,8,2022,01-20,04:50
016 Antigone centre,16,0,16,2022,01-20,04:50
017 M�diath�que Emile Zola,15,1,16,2022,01-20,04:50
018 Nombre d'Or,14,2,16,2022,01-20,04:50
019 Louis Blanc,11,5,16,2022,01-20,04:50
020 Gambetta,6,2,8,2022,01-20,04:50
021 Port Marianne,3,13,16,2022,01-20,04:50
022 Clemenceau,2,10,12,2022,01-20,04:50
023 Les Arceaux,2,14,16,2022,01-20,04:50
024 Cit� Mion,4,4,8,2022,01-20,04:50
025 Nouveau Saint-Roch,5,3,8,2022,01-20,04:50
026 Renouvier,1,7,8,2022,01-20,04:50
027 Odysseum,0,8,8,2022,01-20,04:50
028 Saint-Denis,2,6,8,2022,01-20,04:50
029 Richter,14,2,16,2022,01-20,04:50
030 Charles Flahault,4,4,8,2022,01-20,04:50
031 Voltaire,2,6,8,2022,01-20,04:50
032 Pr�s d'Ar�nes,7,1,8,2022,01-20,04:50
033 Garcia Lorca,5,3,8,2022,01-20,04:50
034 Vert Bois,0,16,16,2022,01-20,04:50
035 Malbosc,1,7,8,2022,01-20,04:50
036 Occitanie,4,28,32,2022,01-20,04:50
037 FacdesSciences,5,19,24,2022,01-20,04:50
038 Fac de Lettres,1,15,16,2022,01-20,04:50
039 Aiguelongue,2,6,8,2022,01-20,04:50
040 Jeu de Mail des Abb�s,8,0,8,2022,01-20,04:50
041 Eurom�decine,0,8,8,2022,01-20,04:50
042 Marie Caizergues,1,7,8,2022,01-20,04:50
043 Sabines,4,4,8,2022,01-20,04:50
044 Celleneuve,2,6,8,2022,01-20,04:50
045 Jardin de la Lironde,2,6,8,2022,01-20,04:50
046 P�re Soulas,8,0,8,2022,01-20,04:50
047 Place Viala,3,5,8,2022,01-20,04:50
048 H�tel du D�partement,0,8,8,2022,01-20,04:50
049 Tonnelles,6,2,8,2022,01-20,04:50
050 Parvis Jules Ferry - Gare Saint-Roch,4,4,8,2022,01-20,04:50
051 Pont de Lattes - Gare Saint-Roch,1,11,12,2022,01-20,04:50
053 Deux Ponts - Gare Saint-Roch,1,7,8,2022,01-20,04:50
054 Providence - Ovalie,4,4,8,2022,01-20,04:50
055 P�rols Etang de l'Or,25,43,68,2022,01-20,04:50
056 Albert 1er - Cath�drale,1,11,12,2022,01-20,04:50
057 Saint-Guilhem - Courreau,0,8,8,2022,01-20,04:50
059 Sud De France,0,8,8,2022,01-20,04:50
001 Rue Jules Ferry - Gare Saint-Roch,7,5,12,2022,01-20,05:01
002 Com�die,3,21,24,2022,01-20,05:01
003 Esplanade,9,23,32,2022,01-20,05:01
004 H�tel de Ville,8,8,16,2022,01-20,05:01
005 Corum,11,1,12,2022,01-20,05:01
006 Place Albert 1er - St Charles,29,2,31,2022,01-20,05:01
007 Foch,4,4,8,2022,01-20,05:01
008 Halles Castellane,0,12,12,2022,01-20,05:01
009 Observatoire,7,1,8,2022,01-20,05:01
010 Rondelet,4,12,16,2022,01-20,05:01
011 Plan Cabanes,7,5,12,2022,01-20,05:01
012 Boutonnet,8,4,12,2022,01-20,05:01
013 Emile Combes,3,5,8,2022,01-20,05:01
014 Beaux-Arts,3,5,8,2022,01-20,05:01
015 Les Aubes,4,4,8,2022,01-20,05:01
016 Antigone centre,16,0,16,2022,01-20,05:01
017 M�diath�que Emile Zola,15,1,16,2022,01-20,05:01
018 Nombre d'Or,14,2,16,2022,01-20,05:01
019 Louis Blanc,11,5,16,2022,01-20,05:01
020 Gambetta,6,2,8,2022,01-20,05:01
021 Port Marianne,3,13,16,2022,01-20,05:01
022 Clemenceau,2,10,12,2022,01-20,05:01
023 Les Arceaux,2,14,16,2022,01-20,05:01
024 Cit� Mion,4,4,8,2022,01-20,05:01
025 Nouveau Saint-Roch,5,3,8,2022,01-20,05:01
026 Renouvier,1,7,8,2022,01-20,05:01
027 Odysseum,0,8,8,2022,01-20,05:01
028 Saint-Denis,2,6,8,2022,01-20,05:01
029 Richter,14,2,16,2022,01-20,05:01
030 Charles Flahault,4,4,8,2022,01-20,05:01
031 Voltaire,2,6,8,2022,01-20,05:01
032 Pr�s d'Ar�nes,7,1,8,2022,01-20,05:01
033 Garcia Lorca,5,3,8,2022,01-20,05:01
034 Vert Bois,0,16,16,2022,01-20,05:01
035 Malbosc,2,6,8,2022,01-20,05:01
036 Occitanie,4,28,32,2022,01-20,05:01
037 FacdesSciences,5,19,24,2022,01-20,05:01
038 Fac de Lettres,1,15,16,2022,01-20,05:01
039 Aiguelongue,2,6,8,2022,01-20,05:01
040 Jeu de Mail des Abb�s,8,0,8,2022,01-20,05:01
041 Eurom�decine,0,8,8,2022,01-20,05:01
042 Marie Caizergues,1,7,8,2022,01-20,05:01
043 Sabines,4,4,8,2022,01-20,05:01
044 Celleneuve,2,6,8,2022,01-20,05:01
045 Jardin de la Lironde,2,6,8,2022,01-20,05:01
046 P�re Soulas,8,0,8,2022,01-20,05:01
047 Place Viala,3,5,8,2022,01-20,05:01
048 H�tel du D�partement,0,8,8,2022,01-20,05:01
049 Tonnelles,6,2,8,2022,01-20,05:01
050 Parvis Jules Ferry - Gare Saint-Roch,5,3,8,2022,01-20,05:01
051 Pont de Lattes - Gare Saint-Roch,1,11,12,2022,01-20,05:01
053 Deux Ponts - Gare Saint-Roch,1,7,8,2022,01-20,05:01
054 Providence - Ovalie,4,4,8,2022,01-20,05:01
055 P�rols Etang de l'Or,25,43,68,2022,01-20,05:01
056 Albert 1er - Cath�drale,1,11,12,2022,01-20,05:01
057 Saint-Guilhem - Courreau,0,8,8,2022,01-20,05:01
059 Sud De France,0,8,8,2022,01-20,05:01
001 Rue Jules Ferry - Gare Saint-Roch,7,5,12,2022,01-20,05:11
002 Com�die,3,21,24,2022,01-20,05:11
003 Esplanade,9,23,32,2022,01-20,05:11
004 H�tel de Ville,8,8,16,2022,01-20,05:11
005 Corum,11,1,12,2022,01-20,05:11
006 Place Albert 1er - St Charles,29,2,31,2022,01-20,05:11
007 Foch,4,4,8,2022,01-20,05:11
008 Halles Castellane,0,12,12,2022,01-20,05:11
009 Observatoire,7,1,8,2022,01-20,05:11
010 Rondelet,4,12,16,2022,01-20,05:11
011 Plan Cabanes,7,5,12,2022,01-20,05:11
012 Boutonnet,8,4,12,2022,01-20,05:11
013 Emile Combes,3,5,8,2022,01-20,05:11
014 Beaux-Arts,3,5,8,2022,01-20,05:11
015 Les Aubes,4,4,8,2022,01-20,05:11
016 Antigone centre,16,0,16,2022,01-20,05:11
017 M�diath�que Emile Zola,15,1,16,2022,01-20,05:11
018 Nombre d'Or,14,2,16,2022,01-20,05:11
019 Louis Blanc,11,5,16,2022,01-20,05:11
020 Gambetta,6,2,8,2022,01-20,05:11
021 Port Marianne,3,13,16,2022,01-20,05:11
022 Clemenceau,2,10,12,2022,01-20,05:11
023 Les Arceaux,2,14,16,2022,01-20,05:11
024 Cit� Mion,4,4,8,2022,01-20,05:11
025 Nouveau Saint-Roch,5,3,8,2022,01-20,05:11
026 Renouvier,1,7,8,2022,01-20,05:11
027 Odysseum,0,8,8,2022,01-20,05:11
028 Saint-Denis,2,6,8,2022,01-20,05:11
029 Richter,14,2,16,2022,01-20,05:11
030 Charles Flahault,4,4,8,2022,01-20,05:11
031 Voltaire,2,6,8,2022,01-20,05:11
032 Pr�s d'Ar�nes,7,1,8,2022,01-20,05:11
033 Garcia Lorca,5,3,8,2022,01-20,05:11
034 Vert Bois,0,16,16,2022,01-20,05:11
035 Malbosc,2,6,8,2022,01-20,05:11
036 Occitanie,4,28,32,2022,01-20,05:11
037 FacdesSciences,4,20,24,2022,01-20,05:11
038 Fac de Lettres,1,15,16,2022,01-20,05:11
039 Aiguelongue,2,6,8,2022,01-20,05:11
040 Jeu de Mail des Abb�s,8,0,8,2022,01-20,05:11
041 Eurom�decine,0,8,8,2022,01-20,05:11
042 Marie Caizergues,1,7,8,2022,01-20,05:11
043 Sabines,4,4,8,2022,01-20,05:11
044 Celleneuve,2,6,8,2022,01-20,05:11
045 Jardin de la Lironde,2,6,8,2022,01-20,05:11
046 P�re Soulas,8,0,8,2022,01-20,05:11
047 Place Viala,3,5,8,2022,01-20,05:11
048 H�tel du D�partement,0,8,8,2022,01-20,05:11
049 Tonnelles,6,2,8,2022,01-20,05:11
050 Parvis Jules Ferry - Gare Saint-Roch,5,3,8,2022,01-20,05:11
051 Pont de Lattes - Gare Saint-Roch,1,11,12,2022,01-20,05:11
053 Deux Ponts - Gare Saint-Roch,1,7,8,2022,01-20,05:11
054 Providence - Ovalie,4,4,8,2022,01-20,05:11
055 P�rols Etang de l'Or,25,43,68,2022,01-20,05:11
056 Albert 1er - Cath�drale,1,11,12,2022,01-20,05:11
057 Saint-Guilhem - Courreau,0,8,8,2022,01-20,05:11
059 Sud De France,0,8,8,2022,01-20,05:11
001 Rue Jules Ferry - Gare Saint-Roch,7,5,12,2022,01-20,05:21
002 Com�die,3,21,24,2022,01-20,05:21
003 Esplanade,9,23,32,2022,01-20,05:21
004 H�tel de Ville,8,8,16,2022,01-20,05:21
005 Corum,12,0,12,2022,01-20,05:21
006 Place Albert 1er - St Charles,29,2,31,2022,01-20,05:21
007 Foch,4,4,8,2022,01-20,05:21
008 Halles Castellane,0,12,12,2022,01-20,05:21
009 Observatoire,7,1,8,2022,01-20,05:21
010 Rondelet,4,12,16,2022,01-20,05:21
011 Plan Cabanes,7,5,12,2022,01-20,05:21
012 Boutonnet,8,4,12,2022,01-20,05:21
013 Emile Combes,3,5,8,2022,01-20,05:21
014 Beaux-Arts,3,5,8,2022,01-20,05:21
015 Les Aubes,4,4,8,2022,01-20,05:21
016 Antigone centre,16,0,16,2022,01-20,05:21
017 M�diath�que Emile Zola,15,1,16,2022,01-20,05:21
018 Nombre d'Or,14,2,16,2022,01-20,05:21
019 Louis Blanc,11,5,16,2022,01-20,05:21
020 Gambetta,6,2,8,2022,01-20,05:21
021 Port Marianne,3,13,16,2022,01-20,05:21
022 Clemenceau,2,10,12,2022,01-20,05:21
023 Les Arceaux,2,14,16,2022,01-20,05:21
024 Cit� Mion,4,4,8,2022,01-20,05:21
025 Nouveau Saint-Roch,5,3,8,2022,01-20,05:21
026 Renouvier,1,7,8,2022,01-20,05:21
027 Odysseum,0,8,8,2022,01-20,05:21
028 Saint-Denis,2,6,8,2022,01-20,05:21
029 Richter,14,2,16,2022,01-20,05:21
030 Charles Flahault,4,4,8,2022,01-20,05:21
031 Voltaire,2,6,8,2022,01-20,05:21
032 Pr�s d'Ar�nes,7,1,8,2022,01-20,05:21
033 Garcia Lorca,5,3,8,2022,01-20,05:21
034 Vert Bois,0,16,16,2022,01-20,05:21
035 Malbosc,2,6,8,2022,01-20,05:21
036 Occitanie,4,28,32,2022,01-20,05:21
037 FacdesSciences,4,20,24,2022,01-20,05:21
038 Fac de Lettres,1,15,16,2022,01-20,05:21
039 Aiguelongue,2,6,8,2022,01-20,05:21
040 Jeu de Mail des Abb�s,8,0,8,2022,01-20,05:21
041 Eurom�decine,0,8,8,2022,01-20,05:21
042 Marie Caizergues,1,7,8,2022,01-20,05:21
043 Sabines,4,4,8,2022,01-20,05:21
044 Celleneuve,2,6,8,2022,01-20,05:21
045 Jardin de la Lironde,2,6,8,2022,01-20,05:21
046 P�re Soulas,8,0,8,2022,01-20,05:21
047 Place Viala,3,5,8,2022,01-20,05:21
048 H�tel du D�partement,0,8,8,2022,01-20,05:21
049 Tonnelles,6,2,8,2022,01-20,05:21
050 Parvis Jules Ferry - Gare Saint-Roch,5,3,8,2022,01-20,05:21
051 Pont de Lattes - Gare Saint-Roch,1,11,12,2022,01-20,05:21
053 Deux Ponts - Gare Saint-Roch,1,7,8,2022,01-20,05:21
054 Providence - Ovalie,4,4,8,2022,01-20,05:21
055 P�rols Etang de l'Or,25,43,68,2022,01-20,05:21
056 Albert 1er - Cath�drale,1,11,12,2022,01-20,05:21
057 Saint-Guilhem - Courreau,0,8,8,2022,01-20,05:21
059 Sud De France,0,8,8,2022,01-20,05:21
001 Rue Jules Ferry - Gare Saint-Roch,7,5,12,2022,01-20,05:31
002 Com�die,3,21,24,2022,01-20,05:31
003 Esplanade,9,23,32,2022,01-20,05:31
004 H�tel de Ville,8,8,16,2022,01-20,05:31
005 Corum,12,0,12,2022,01-20,05:31
006 Place Albert 1er - St Charles,29,2,31,2022,01-20,05:31
007 Foch,4,4,8,2022,01-20,05:31
008 Halles Castellane,0,12,12,2022,01-20,05:31
009 Observatoire,7,1,8,2022,01-20,05:31
010 Rondelet,4,12,16,2022,01-20,05:31
011 Plan Cabanes,7,5,12,2022,01-20,05:31
012 Boutonnet,8,4,12,2022,01-20,05:31
013 Emile Combes,3,5,8,2022,01-20,05:31
014 Beaux-Arts,3,5,8,2022,01-20,05:31
015 Les Aubes,4,4,8,2022,01-20,05:31
016 Antigone centre,16,0,16,2022,01-20,05:31
017 M�diath�que Emile Zola,14,2,16,2022,01-20,05:31
018 Nombre d'Or,14,2,16,2022,01-20,05:31
019 Louis Blanc,11,5,16,2022,01-20,05:31
020 Gambetta,6,2,8,2022,01-20,05:31
021 Port Marianne,3,13,16,2022,01-20,05:31
022 Clemenceau,2,10,12,2022,01-20,05:31
023 Les Arceaux,2,14,16,2022,01-20,05:31
024 Cit� Mion,4,4,8,2022,01-20,05:31
025 Nouveau Saint-Roch,5,3,8,2022,01-20,05:31
026 Renouvier,1,7,8,2022,01-20,05:31
027 Odysseum,0,8,8,2022,01-20,05:31
028 Saint-Denis,2,6,8,2022,01-20,05:31
029 Richter,14,2,16,2022,01-20,05:31
030 Charles Flahault,4,4,8,2022,01-20,05:31
031 Voltaire,2,6,8,2022,01-20,05:31
032 Pr�s d'Ar�nes,7,1,8,2022,01-20,05:31
033 Garcia Lorca,5,3,8,2022,01-20,05:31
034 Vert Bois,0,16,16,2022,01-20,05:31
035 Malbosc,2,6,8,2022,01-20,05:31
036 Occitanie,4,28,32,2022,01-20,05:31
037 FacdesSciences,4,20,24,2022,01-20,05:31
038 Fac de Lettres,1,15,16,2022,01-20,05:31
039 Aiguelongue,2,6,8,2022,01-20,05:31
040 Jeu de Mail des Abb�s,8,0,8,2022,01-20,05:31
041 Eurom�decine,0,8,8,2022,01-20,05:31
042 Marie Caizergues,1,7,8,2022,01-20,05:31
043 Sabines,4,4,8,2022,01-20,05:31
044 Celleneuve,2,6,8,2022,01-20,05:31
045 Jardin de la Lironde,2,6,8,2022,01-20,05:31
046 P�re Soulas,8,0,8,2022,01-20,05:31
047 Place Viala,3,5,8,2022,01-20,05:31
048 H�tel du D�partement,0,8,8,2022,01-20,05:31
049 Tonnelles,6,2,8,2022,01-20,05:31
050 Parvis Jules Ferry - Gare Saint-Roch,5,3,8,2022,01-20,05:31
051 Pont de Lattes - Gare Saint-Roch,1,11,12,2022,01-20,05:31
053 Deux Ponts - Gare Saint-Roch,1,7,8,2022,01-20,05:31
054 Providence - Ovalie,4,4,8,2022,01-20,05:31
055 P�rols Etang de l'Or,25,43,68,2022,01-20,05:31
056 Albert 1er - Cath�drale,1,11,12,2022,01-20,05:31
057 Saint-Guilhem - Courreau,0,8,8,2022,01-20,05:31
059 Sud De France,0,8,8,2022,01-20,05:31
001 Rue Jules Ferry - Gare Saint-Roch,7,5,12,2022,01-20,05:41
002 Com�die,3,21,24,2022,01-20,05:41
003 Esplanade,9,23,32,2022,01-20,05:41
004 H�tel de Ville,8,8,16,2022,01-20,05:41
005 Corum,12,0,12,2022,01-20,05:41
006 Place Albert 1er - St Charles,29,2,31,2022,01-20,05:41
007 Foch,4,4,8,2022,01-20,05:41
008 Halles Castellane,0,12,12,2022,01-20,05:41
009 Observatoire,7,1,8,2022,01-20,05:41
010 Rondelet,4,12,16,2022,01-20,05:41
011 Plan Cabanes,7,5,12,2022,01-20,05:41
012 Boutonnet,8,4,12,2022,01-20,05:41
013 Emile Combes,3,5,8,2022,01-20,05:41
014 Beaux-Arts,3,5,8,2022,01-20,05:41
015 Les Aubes,4,4,8,2022,01-20,05:41
016 Antigone centre,16,0,16,2022,01-20,05:41
017 M�diath�que Emile Zola,14,2,16,2022,01-20,05:41
018 Nombre d'Or,14,2,16,2022,01-20,05:41
019 Louis Blanc,11,5,16,2022,01-20,05:41
020 Gambetta,6,2,8,2022,01-20,05:41
021 Port Marianne,3,13,16,2022,01-20,05:41
022 Clemenceau,2,10,12,2022,01-20,05:41
023 Les Arceaux,2,14,16,2022,01-20,05:41
024 Cit� Mion,4,4,8,2022,01-20,05:41
025 Nouveau Saint-Roch,5,3,8,2022,01-20,05:41
026 Renouvier,1,7,8,2022,01-20,05:41
027 Odysseum,0,8,8,2022,01-20,05:41
028 Saint-Denis,2,6,8,2022,01-20,05:41
029 Richter,14,2,16,2022,01-20,05:41
030 Charles Flahault,4,4,8,2022,01-20,05:41
031 Voltaire,2,6,8,2022,01-20,05:41
032 Pr�s d'Ar�nes,7,1,8,2022,01-20,05:41
033 Garcia Lorca,5,3,8,2022,01-20,05:41
034 Vert Bois,0,16,16,2022,01-20,05:41
035 Malbosc,2,6,8,2022,01-20,05:41
036 Occitanie,4,28,32,2022,01-20,05:41
037 FacdesSciences,4,20,24,2022,01-20,05:41
038 Fac de Lettres,1,15,16,2022,01-20,05:41
039 Aiguelongue,2,6,8,2022,01-20,05:41
040 Jeu de Mail des Abb�s,8,0,8,2022,01-20,05:41
041 Eurom�decine,0,8,8,2022,01-20,05:41
042 Marie Caizergues,1,7,8,2022,01-20,05:41
043 Sabines,4,4,8,2022,01-20,05:41
044 Celleneuve,2,6,8,2022,01-20,05:41
045 Jardin de la Lironde,2,6,8,2022,01-20,05:41
046 P�re Soulas,8,0,8,2022,01-20,05:41
047 Place Viala,3,5,8,2022,01-20,05:41
048 H�tel du D�partement,0,8,8,2022,01-20,05:41
049 Tonnelles,6,2,8,2022,01-20,05:41
050 Parvis Jules Ferry - Gare Saint-Roch,5,3,8,2022,01-20,05:41
051 Pont de Lattes - Gare Saint-Roch,1,11,12,2022,01-20,05:41
053 Deux Ponts - Gare Saint-Roch,1,7,8,2022,01-20,05:41
054 Providence - Ovalie,4,4,8,2022,01-20,05:41
055 P�rols Etang de l'Or,25,43,68,2022,01-20,05:41
056 Albert 1er - Cath�drale,1,11,12,2022,01-20,05:41
057 Saint-Guilhem - Courreau,0,8,8,2022,01-20,05:41
059 Sud De France,0,8,8,2022,01-20,05:41
001 Rue Jules Ferry - Gare Saint-Roch,7,5,12,2022,01-20,05:51
002 Com�die,3,21,24,2022,01-20,05:51
003 Esplanade,9,23,32,2022,01-20,05:51
004 H�tel de Ville,8,8,16,2022,01-20,05:51
005 Corum,12,0,12,2022,01-20,05:51
006 Place Albert 1er - St Charles,30,1,31,2022,01-20,05:51
007 Foch,4,4,8,2022,01-20,05:51
008 Halles Castellane,0,12,12,2022,01-20,05:51
009 Observatoire,7,1,8,2022,01-20,05:51
010 Rondelet,4,12,16,2022,01-20,05:51
011 Plan Cabanes,7,5,12,2022,01-20,05:51
012 Boutonnet,8,4,12,2022,01-20,05:51
013 Emile Combes,3,5,8,2022,01-20,05:51
014 Beaux-Arts,3,5,8,2022,01-20,05:51
015 Les Aubes,4,4,8,2022,01-20,05:51
016 Antigone centre,16,0,16,2022,01-20,05:51
017 M�diath�que Emile Zola,14,2,16,2022,01-20,05:51
018 Nombre d'Or,14,2,16,2022,01-20,05:51
019 Louis Blanc,11,5,16,2022,01-20,05:51
020 Gambetta,6,2,8,2022,01-20,05:51
021 Port Marianne,3,13,16,2022,01-20,05:51
022 Clemenceau,2,10,12,2022,01-20,05:51
023 Les Arceaux,2,14,16,2022,01-20,05:51
024 Cit� Mion,4,4,8,2022,01-20,05:51
025 Nouveau Saint-Roch,5,3,8,2022,01-20,05:51
026 Renouvier,1,7,8,2022,01-20,05:51
027 Odysseum,0,8,8,2022,01-20,05:51
028 Saint-Denis,2,6,8,2022,01-20,05:51
029 Richter,14,2,16,2022,01-20,05:51
030 Charles Flahault,4,4,8,2022,01-20,05:51
031 Voltaire,2,6,8,2022,01-20,05:51
032 Pr�s d'Ar�nes,7,1,8,2022,01-20,05:51
033 Garcia Lorca,5,3,8,2022,01-20,05:51
034 Vert Bois,0,16,16,2022,01-20,05:51
035 Malbosc,2,6,8,2022,01-20,05:51
036 Occitanie,4,28,32,2022,01-20,05:51
037 FacdesSciences,4,20,24,2022,01-20,05:51
038 Fac de Lettres,1,15,16,2022,01-20,05:51
039 Aiguelongue,1,7,8,2022,01-20,05:51
040 Jeu de Mail des Abb�s,8,0,8,2022,01-20,05:51
041 Eurom�decine,0,8,8,2022,01-20,05:51
042 Marie Caizergues,1,7,8,2022,01-20,05:51
043 Sabines,4,4,8,2022,01-20,05:51
044 Celleneuve,2,6,8,2022,01-20,05:51
045 Jardin de la Lironde,2,6,8,2022,01-20,05:51
046 P�re Soulas,8,0,8,2022,01-20,05:51
047 Place Viala,3,5,8,2022,01-20,05:51
048 H�tel du D�partement,0,8,8,2022,01-20,05:51
049 Tonnelles,6,2,8,2022,01-20,05:51
050 Parvis Jules Ferry - Gare Saint-Roch,5,3,8,2022,01-20,05:51
051 Pont de Lattes - Gare Saint-Roch,1,11,12,2022,01-20,05:51
053 Deux Ponts - Gare Saint-Roch,1,7,8,2022,01-20,05:51
054 Providence - Ovalie,4,4,8,2022,01-20,05:51
055 P�rols Etang de l'Or,25,43,68,2022,01-20,05:51
056 Albert 1er - Cath�drale,1,11,12,2022,01-20,05:51
057 Saint-Guilhem - Courreau,0,8,8,2022,01-20,05:51
059 Sud De France,0,8,8,2022,01-20,05:51
001 Rue Jules Ferry - Gare Saint-Roch,7,5,12,2022,01-20,06:02
002 Com�die,3,21,24,2022,01-20,06:02
003 Esplanade,9,23,32,2022,01-20,06:02
004 H�tel de Ville,8,8,16,2022,01-20,06:02
005 Corum,12,0,12,2022,01-20,06:02
006 Place Albert 1er - St Charles,30,1,31,2022,01-20,06:02
007 Foch,4,4,8,2022,01-20,06:02
008 Halles Castellane,0,12,12,2022,01-20,06:02
009 Observatoire,7,1,8,2022,01-20,06:02
010 Rondelet,4,12,16,2022,01-20,06:02
011 Plan Cabanes,7,5,12,2022,01-20,06:02
012 Boutonnet,8,4,12,2022,01-20,06:02
013 Emile Combes,3,5,8,2022,01-20,06:02
014 Beaux-Arts,3,5,8,2022,01-20,06:02
015 Les Aubes,4,4,8,2022,01-20,06:02
016 Antigone centre,16,0,16,2022,01-20,06:02
017 M�diath�que Emile Zola,14,2,16,2022,01-20,06:02
018 Nombre d'Or,14,2,16,2022,01-20,06:02
019 Louis Blanc,11,5,16,2022,01-20,06:02
020 Gambetta,6,2,8,2022,01-20,06:02
021 Port Marianne,3,13,16,2022,01-20,06:02
022 Clemenceau,2,10,12,2022,01-20,06:02
023 Les Arceaux,2,14,16,2022,01-20,06:02
024 Cit� Mion,4,4,8,2022,01-20,06:02
025 Nouveau Saint-Roch,5,3,8,2022,01-20,06:02
026 Renouvier,1,7,8,2022,01-20,06:02
027 Odysseum,0,8,8,2022,01-20,06:02
028 Saint-Denis,2,6,8,2022,01-20,06:02
029 Richter,14,2,16,2022,01-20,06:02
030 Charles Flahault,4,4,8,2022,01-20,06:02
031 Voltaire,2,6,8,2022,01-20,06:02
032 Pr�s d'Ar�nes,7,1,8,2022,01-20,06:02
033 Garcia Lorca,5,3,8,2022,01-20,06:02
034 Vert Bois,0,16,16,2022,01-20,06:02
035 Malbosc,2,6,8,2022,01-20,06:02
036 Occitanie,4,28,32,2022,01-20,06:02
037 FacdesSciences,5,19,24,2022,01-20,06:02
038 Fac de Lettres,1,15,16,2022,01-20,06:02
039 Aiguelongue,1,7,8,2022,01-20,06:02
040 Jeu de Mail des Abb�s,8,0,8,2022,01-20,06:02
041 Eurom�decine,0,8,8,2022,01-20,06:02
042 Marie Caizergues,1,7,8,2022,01-20,06:02
043 Sabines,4,4,8,2022,01-20,06:02
044 Celleneuve,2,6,8,2022,01-20,06:02
045 Jardin de la Lironde,2,6,8,2022,01-20,06:02
046 P�re Soulas,8,0,8,2022,01-20,06:02
047 Place Viala,3,5,8,2022,01-20,06:02
048 H�tel du D�partement,0,8,8,2022,01-20,06:02
049 Tonnelles,6,2,8,2022,01-20,06:02
050 Parvis Jules Ferry - Gare Saint-Roch,5,3,8,2022,01-20,06:02
051 Pont de Lattes - Gare Saint-Roch,1,11,12,2022,01-20,06:02
053 Deux Ponts - Gare Saint-Roch,1,7,8,2022,01-20,06:02
054 Providence - Ovalie,4,4,8,2022,01-20,06:02
055 P�rols Etang de l'Or,25,43,68,2022,01-20,06:02
056 Albert 1er - Cath�drale,1,11,12,2022,01-20,06:02
057 Saint-Guilhem - Courreau,0,8,8,2022,01-20,06:02
059 Sud De France,0,8,8,2022,01-20,06:02
001 Rue Jules Ferry - Gare Saint-Roch,7,5,12,2022,01-20,06:12
002 Com�die,3,21,24,2022,01-20,06:12
003 Esplanade,9,23,32,2022,01-20,06:12
004 H�tel de Ville,8,8,16,2022,01-20,06:12
005 Corum,11,1,12,2022,01-20,06:12
006 Place Albert 1er - St Charles,30,1,31,2022,01-20,06:12
007 Foch,4,4,8,2022,01-20,06:12
008 Halles Castellane,0,12,12,2022,01-20,06:12
009 Observatoire,7,1,8,2022,01-20,06:12
010 Rondelet,4,12,16,2022,01-20,06:12
011 Plan Cabanes,7,5,12,2022,01-20,06:12
012 Boutonnet,8,4,12,2022,01-20,06:12
013 Emile Combes,3,5,8,2022,01-20,06:12
014 Beaux-Arts,3,5,8,2022,01-20,06:12
015 Les Aubes,4,4,8,2022,01-20,06:12
016 Antigone centre,16,0,16,2022,01-20,06:12
017 M�diath�que Emile Zola,13,3,16,2022,01-20,06:12
018 Nombre d'Or,14,2,16,2022,01-20,06:12
019 Louis Blanc,11,5,16,2022,01-20,06:12
020 Gambetta,6,2,8,2022,01-20,06:12
021 Port Marianne,3,13,16,2022,01-20,06:12
022 Clemenceau,2,10,12,2022,01-20,06:12
023 Les Arceaux,2,14,16,2022,01-20,06:12
024 Cit� Mion,4,4,8,2022,01-20,06:12
025 Nouveau Saint-Roch,5,3,8,2022,01-20,06:12
026 Renouvier,1,7,8,2022,01-20,06:12
027 Odysseum,0,8,8,2022,01-20,06:12
028 Saint-Denis,2,6,8,2022,01-20,06:12
029 Richter,14,2,16,2022,01-20,06:12
030 Charles Flahault,4,4,8,2022,01-20,06:12
031 Voltaire,2,6,8,2022,01-20,06:12
032 Pr�s d'Ar�nes,7,1,8,2022,01-20,06:12
033 Garcia Lorca,5,3,8,2022,01-20,06:12
034 Vert Bois,0,16,16,2022,01-20,06:12
035 Malbosc,2,6,8,2022,01-20,06:12
036 Occitanie,4,28,32,2022,01-20,06:12
037 FacdesSciences,5,19,24,2022,01-20,06:12
038 Fac de Lettres,1,15,16,2022,01-20,06:12
039 Aiguelongue,1,7,8,2022,01-20,06:12
040 Jeu de Mail des Abb�s,8,0,8,2022,01-20,06:12
041 Eurom�decine,0,8,8,2022,01-20,06:12
042 Marie Caizergues,1,7,8,2022,01-20,06:12
043 Sabines,4,4,8,2022,01-20,06:12
044 Celleneuve,2,6,8,2022,01-20,06:12
045 Jardin de la Lironde,2,6,8,2022,01-20,06:12
046 P�re Soulas,8,0,8,2022,01-20,06:12
047 Place Viala,3,5,8,2022,01-20,06:12
048 H�tel du D�partement,0,8,8,2022,01-20,06:12
049 Tonnelles,6,2,8,2022,01-20,06:12
050 Parvis Jules Ferry - Gare Saint-Roch,5,3,8,2022,01-20,06:12
051 Pont de Lattes - Gare Saint-Roch,1,11,12,2022,01-20,06:12
053 Deux Ponts - Gare Saint-Roch,1,7,8,2022,01-20,06:12
054 Providence - Ovalie,4,4,8,2022,01-20,06:12
055 P�rols Etang de l'Or,25,43,68,2022,01-20,06:12
056 Albert 1er - Cath�drale,1,11,12,2022,01-20,06:12
057 Saint-Guilhem - Courreau,0,8,8,2022,01-20,06:12
059 Sud De France,0,8,8,2022,01-20,06:12
001 Rue Jules Ferry - Gare Saint-Roch,7,5,12,2022,01-20,06:22
002 Com�die,3,21,24,2022,01-20,06:22
003 Esplanade,9,23,32,2022,01-20,06:22
004 H�tel de Ville,8,8,16,2022,01-20,06:22
005 Corum,11,1,12,2022,01-20,06:22
006 Place Albert 1er - St Charles,30,1,31,2022,01-20,06:22
007 Foch,4,4,8,2022,01-20,06:22
008 Halles Castellane,0,12,12,2022,01-20,06:22
009 Observatoire,7,1,8,2022,01-20,06:22
010 Rondelet,4,12,16,2022,01-20,06:22
011 Plan Cabanes,7,5,12,2022,01-20,06:22
012 Boutonnet,8,4,12,2022,01-20,06:22
013 Emile Combes,3,5,8,2022,01-20,06:22
014 Beaux-Arts,3,5,8,2022,01-20,06:22
015 Les Aubes,4,4,8,2022,01-20,06:22
016 Antigone centre,15,1,16,2022,01-20,06:22
017 M�diath�que Emile Zola,13,3,16,2022,01-20,06:22
018 Nombre d'Or,4,12,16,2022,01-20,06:22
019 Louis Blanc,11,5,16,2022,01-20,06:22
020 Gambetta,6,2,8,2022,01-20,06:22
021 Port Marianne,3,13,16,2022,01-20,06:22
022 Clemenceau,2,10,12,2022,01-20,06:22
023 Les Arceaux,2,14,16,2022,01-20,06:22
024 Cit� Mion,4,4,8,2022,01-20,06:22
025 Nouveau Saint-Roch,5,3,8,2022,01-20,06:22
026 Renouvier,1,7,8,2022,01-20,06:22
027 Odysseum,0,8,8,2022,01-20,06:22
028 Saint-Denis,2,6,8,2022,01-20,06:22
029 Richter,14,2,16,2022,01-20,06:22
030 Charles Flahault,4,4,8,2022,01-20,06:22
031 Voltaire,2,6,8,2022,01-20,06:22
032 Pr�s d'Ar�nes,7,1,8,2022,01-20,06:22
033 Garcia Lorca,5,3,8,2022,01-20,06:22
034 Vert Bois,0,16,16,2022,01-20,06:22
035 Malbosc,2,6,8,2022,01-20,06:22
036 Occitanie,4,28,32,2022,01-20,06:22
037 FacdesSciences,5,19,24,2022,01-20,06:22
038 Fac de Lettres,1,15,16,2022,01-20,06:22
039 Aiguelongue,1,7,8,2022,01-20,06:22
040 Jeu de Mail des Abb�s,8,0,8,2022,01-20,06:22
041 Eurom�decine,0,8,8,2022,01-20,06:22
042 Marie Caizergues,1,7,8,2022,01-20,06:22
043 Sabines,4,4,8,2022,01-20,06:22
044 Celleneuve,2,6,8,2022,01-20,06:22
045 Jardin de la Lironde,2,6,8,2022,01-20,06:22
046 P�re Soulas,8,0,8,2022,01-20,06:22
047 Place Viala,3,5,8,2022,01-20,06:22
048 H�tel du D�partement,0,8,8,2022,01-20,06:22
049 Tonnelles,6,2,8,2022,01-20,06:22
050 Parvis Jules Ferry - Gare Saint-Roch,5,3,8,2022,01-20,06:22
051 Pont de Lattes - Gare Saint-Roch,2,10,12,2022,01-20,06:22
053 Deux Ponts - Gare Saint-Roch,1,7,8,2022,01-20,06:22
054 Providence - Ovalie,4,4,8,2022,01-20,06:22
055 P�rols Etang de l'Or,25,43,68,2022,01-20,06:22
056 Albert 1er - Cath�drale,1,11,12,2022,01-20,06:22
057 Saint-Guilhem - Courreau,0,8,8,2022,01-20,06:22
059 Sud De France,0,8,8,2022,01-20,06:22
001 Rue Jules Ferry - Gare Saint-Roch,7,5,12,2022,01-20,06:32
002 Com�die,15,9,24,2022,01-20,06:32
003 Esplanade,9,23,32,2022,01-20,06:32
004 H�tel de Ville,8,8,16,2022,01-20,06:32
005 Corum,11,1,12,2022,01-20,06:32
006 Place Albert 1er - St Charles,30,1,31,2022,01-20,06:32
007 Foch,4,4,8,2022,01-20,06:32
008 Halles Castellane,0,12,12,2022,01-20,06:32
009 Observatoire,7,1,8,2022,01-20,06:32
010 Rondelet,5,11,16,2022,01-20,06:32
011 Plan Cabanes,7,5,12,2022,01-20,06:32
012 Boutonnet,8,4,12,2022,01-20,06:32
013 Emile Combes,3,5,8,2022,01-20,06:32
014 Beaux-Arts,3,5,8,2022,01-20,06:32
015 Les Aubes,4,4,8,2022,01-20,06:32
016 Antigone centre,15,1,16,2022,01-20,06:32
017 M�diath�que Emile Zola,13,3,16,2022,01-20,06:32
018 Nombre d'Or,4,12,16,2022,01-20,06:32
019 Louis Blanc,11,5,16,2022,01-20,06:32
020 Gambetta,6,2,8,2022,01-20,06:32
021 Port Marianne,3,13,16,2022,01-20,06:32
022 Clemenceau,2,10,12,2022,01-20,06:32
023 Les Arceaux,2,14,16,2022,01-20,06:32
024 Cit� Mion,4,4,8,2022,01-20,06:32
025 Nouveau Saint-Roch,5,3,8,2022,01-20,06:32
026 Renouvier,1,7,8,2022,01-20,06:32
027 Odysseum,0,8,8,2022,01-20,06:32
028 Saint-Denis,2,6,8,2022,01-20,06:32
029 Richter,14,2,16,2022,01-20,06:32
030 Charles Flahault,4,4,8,2022,01-20,06:32
031 Voltaire,2,6,8,2022,01-20,06:32
032 Pr�s d'Ar�nes,7,1,8,2022,01-20,06:32
033 Garcia Lorca,5,3,8,2022,01-20,06:32
034 Vert Bois,0,16,16,2022,01-20,06:32
035 Malbosc,2,6,8,2022,01-20,06:32
036 Occitanie,5,27,32,2022,01-20,06:32
037 FacdesSciences,5,19,24,2022,01-20,06:32
038 Fac de Lettres,1,15,16,2022,01-20,06:32
039 Aiguelongue,1,7,8,2022,01-20,06:32
040 Jeu de Mail des Abb�s,8,0,8,2022,01-20,06:32
041 Eurom�decine,0,8,8,2022,01-20,06:32
042 Marie Caizergues,1,7,8,2022,01-20,06:32
043 Sabines,4,4,8,2022,01-20,06:32
044 Celleneuve,2,6,8,2022,01-20,06:32
045 Jardin de la Lironde,2,6,8,2022,01-20,06:32
046 P�re Soulas,8,0,8,2022,01-20,06:32
047 Place Viala,3,5,8,2022,01-20,06:32
048 H�tel du D�partement,0,8,8,2022,01-20,06:32
049 Tonnelles,6,2,8,2022,01-20,06:32
050 Parvis Jules Ferry - Gare Saint-Roch,5,3,8,2022,01-20,06:32
051 Pont de Lattes - Gare Saint-Roch,2,10,12,2022,01-20,06:32
053 Deux Ponts - Gare Saint-Roch,1,7,8,2022,01-20,06:32
054 Providence - Ovalie,4,4,8,2022,01-20,06:32
055 P�rols Etang de l'Or,25,43,68,2022,01-20,06:32
056 Albert 1er - Cath�drale,1,11,12,2022,01-20,06:32
057 Saint-Guilhem - Courreau,0,8,8,2022,01-20,06:32
059 Sud De France,0,8,8,2022,01-20,06:32
001 Rue Jules Ferry - Gare Saint-Roch,7,5,12,2022,01-20,06:42
002 Com�die,15,9,24,2022,01-20,06:42
003 Esplanade,9,23,32,2022,01-20,06:42
004 H�tel de Ville,8,8,16,2022,01-20,06:42
005 Corum,11,1,12,2022,01-20,06:42
006 Place Albert 1er - St Charles,22,9,31,2022,01-20,06:42
007 Foch,4,4,8,2022,01-20,06:42
008 Halles Castellane,0,12,12,2022,01-20,06:42
009 Observatoire,7,1,8,2022,01-20,06:42
010 Rondelet,5,11,16,2022,01-20,06:42
011 Plan Cabanes,7,5,12,2022,01-20,06:42
012 Boutonnet,8,4,12,2022,01-20,06:42
013 Emile Combes,3,5,8,2022,01-20,06:42
014 Beaux-Arts,3,5,8,2022,01-20,06:42
015 Les Aubes,4,4,8,2022,01-20,06:42
016 Antigone centre,15,1,16,2022,01-20,06:42
017 M�diath�que Emile Zola,13,3,16,2022,01-20,06:42
018 Nombre d'Or,4,12,16,2022,01-20,06:42
019 Louis Blanc,11,5,16,2022,01-20,06:42
020 Gambetta,6,2,8,2022,01-20,06:42
021 Port Marianne,3,13,16,2022,01-20,06:42
022 Clemenceau,2,10,12,2022,01-20,06:42
023 Les Arceaux,2,14,16,2022,01-20,06:42
024 Cit� Mion,4,4,8,2022,01-20,06:42
025 Nouveau Saint-Roch,5,3,8,2022,01-20,06:42
026 Renouvier,1,7,8,2022,01-20,06:42
027 Odysseum,0,8,8,2022,01-20,06:42
028 Saint-Denis,2,6,8,2022,01-20,06:42
029 Richter,14,2,16,2022,01-20,06:42
030 Charles Flahault,4,4,8,2022,01-20,06:42
031 Voltaire,2,6,8,2022,01-20,06:42
032 Pr�s d'Ar�nes,7,1,8,2022,01-20,06:42
033 Garcia Lorca,5,3,8,2022,01-20,06:42
034 Vert Bois,0,16,16,2022,01-20,06:42
035 Malbosc,2,6,8,2022,01-20,06:42
036 Occitanie,5,27,32,2022,01-20,06:42
037 FacdesSciences,5,19,24,2022,01-20,06:42
038 Fac de Lettres,1,15,16,2022,01-20,06:42
039 Aiguelongue,1,7,8,2022,01-20,06:42
040 Jeu de Mail des Abb�s,8,0,8,2022,01-20,06:42
041 Eurom�decine,0,8,8,2022,01-20,06:42
042 Marie Caizergues,1,7,8,2022,01-20,06:42
043 Sabines,4,4,8,2022,01-20,06:42
044 Celleneuve,2,6,8,2022,01-20,06:42
045 Jardin de la Lironde,2,6,8,2022,01-20,06:42
046 P�re Soulas,8,0,8,2022,01-20,06:42
047 Place Viala,3,5,8,2022,01-20,06:42
048 H�tel du D�partement,0,8,8,2022,01-20,06:42
049 Tonnelles,6,2,8,2022,01-20,06:42
050 Parvis Jules Ferry - Gare Saint-Roch,5,3,8,2022,01-20,06:42
051 Pont de Lattes - Gare Saint-Roch,2,10,12,2022,01-20,06:42
053 Deux Ponts - Gare Saint-Roch,1,7,8,2022,01-20,06:42
054 Providence - Ovalie,4,4,8,2022,01-20,06:42
055 P�rols Etang de l'Or,25,43,68,2022,01-20,06:42
056 Albert 1er - Cath�drale,1,11,12,2022,01-20,06:42
057 Saint-Guilhem - Courreau,0,8,8,2022,01-20,06:42
059 Sud De France,0,8,8,2022,01-20,06:42
001 Rue Jules Ferry - Gare Saint-Roch,7,5,12,2022,01-20,06:52
002 Com�die,15,9,24,2022,01-20,06:52
003 Esplanade,9,23,32,2022,01-20,06:52
004 H�tel de Ville,8,8,16,2022,01-20,06:52
005 Corum,11,1,12,2022,01-20,06:52
006 Place Albert 1er - St Charles,14,17,31,2022,01-20,06:52
007 Foch,4,4,8,2022,01-20,06:52
008 Halles Castellane,0,12,12,2022,01-20,06:52
009 Observatoire,7,1,8,2022,01-20,06:52
010 Rondelet,5,11,16,2022,01-20,06:52
011 Plan Cabanes,7,5,12,2022,01-20,06:52
012 Boutonnet,8,4,12,2022,01-20,06:52
013 Emile Combes,3,5,8,2022,01-20,06:52
014 Beaux-Arts,3,5,8,2022,01-20,06:52
015 Les Aubes,4,4,8,2022,01-20,06:52
016 Antigone centre,15,1,16,2022,01-20,06:52
017 M�diath�que Emile Zola,13,3,16,2022,01-20,06:52
018 Nombre d'Or,4,12,16,2022,01-20,06:52
019 Louis Blanc,11,5,16,2022,01-20,06:52
020 Gambetta,6,2,8,2022,01-20,06:52
021 Port Marianne,3,13,16,2022,01-20,06:52
022 Clemenceau,2,10,12,2022,01-20,06:52
023 Les Arceaux,2,14,16,2022,01-20,06:52
024 Cit� Mion,4,4,8,2022,01-20,06:52
025 Nouveau Saint-Roch,5,3,8,2022,01-20,06:52
026 Renouvier,1,7,8,2022,01-20,06:52
027 Odysseum,0,8,8,2022,01-20,06:52
028 Saint-Denis,2,6,8,2022,01-20,06:52
029 Richter,14,2,16,2022,01-20,06:52
030 Charles Flahault,4,4,8,2022,01-20,06:52
031 Voltaire,2,6,8,2022,01-20,06:52
032 Pr�s d'Ar�nes,6,2,8,2022,01-20,06:52
033 Garcia Lorca,5,3,8,2022,01-20,06:52
034 Vert Bois,0,16,16,2022,01-20,06:52
035 Malbosc,2,6,8,2022,01-20,06:52
036 Occitanie,5,27,32,2022,01-20,06:52
037 FacdesSciences,5,19,24,2022,01-20,06:52
038 Fac de Lettres,1,15,16,2022,01-20,06:52
039 Aiguelongue,1,7,8,2022,01-20,06:52
040 Jeu de Mail des Abb�s,8,0,8,2022,01-20,06:52
041 Eurom�decine,0,8,8,2022,01-20,06:52
042 Marie Caizergues,1,7,8,2022,01-20,06:52
043 Sabines,4,4,8,2022,01-20,06:52
044 Celleneuve,2,6,8,2022,01-20,06:52
045 Jardin de la Lironde,2,6,8,2022,01-20,06:52
046 P�re Soulas,8,0,8,2022,01-20,06:52
047 Place Viala,3,5,8,2022,01-20,06:52
048 H�tel du D�partement,0,8,8,2022,01-20,06:52
049 Tonnelles,6,2,8,2022,01-20,06:52
050 Parvis Jules Ferry - Gare Saint-Roch,5,3,8,2022,01-20,06:52
051 Pont de Lattes - Gare Saint-Roch,2,10,12,2022,01-20,06:52
053 Deux Ponts - Gare Saint-Roch,1,7,8,2022,01-20,06:52
054 Providence - Ovalie,4,4,8,2022,01-20,06:52
055 P�rols Etang de l'Or,25,43,68,2022,01-20,06:52
056 Albert 1er - Cath�drale,1,11,12,2022,01-20,06:52
057 Saint-Guilhem - Courreau,0,8,8,2022,01-20,06:52
059 Sud De France,0,8,8,2022,01-20,06:52
001 Rue Jules Ferry - Gare Saint-Roch,7,5,12,2022,01-20,07:03
002 Com�die,15,9,24,2022,01-20,07:03
003 Esplanade,9,23,32,2022,01-20,07:03
004 H�tel de Ville,8,8,16,2022,01-20,07:03
005 Corum,11,1,12,2022,01-20,07:03
006 Place Albert 1er - St Charles,14,17,31,2022,01-20,07:03
007 Foch,4,4,8,2022,01-20,07:03
008 Halles Castellane,0,12,12,2022,01-20,07:03
009 Observatoire,7,1,8,2022,01-20,07:03
010 Rondelet,5,11,16,2022,01-20,07:03
011 Plan Cabanes,7,5,12,2022,01-20,07:03
012 Boutonnet,8,4,12,2022,01-20,07:03
013 Emile Combes,3,5,8,2022,01-20,07:03
014 Beaux-Arts,3,5,8,2022,01-20,07:03
015 Les Aubes,4,4,8,2022,01-20,07:03
016 Antigone centre,15,1,16,2022,01-20,07:03
017 M�diath�que Emile Zola,13,3,16,2022,01-20,07:03
018 Nombre d'Or,4,12,16,2022,01-20,07:03
019 Louis Blanc,11,5,16,2022,01-20,07:03
020 Gambetta,6,2,8,2022,01-20,07:03
021 Port Marianne,3,13,16,2022,01-20,07:03
022 Clemenceau,2,10,12,2022,01-20,07:03
023 Les Arceaux,2,14,16,2022,01-20,07:03
024 Cit� Mion,4,4,8,2022,01-20,07:03
025 Nouveau Saint-Roch,5,3,8,2022,01-20,07:03
026 Renouvier,1,7,8,2022,01-20,07:03
027 Odysseum,0,8,8,2022,01-20,07:03
028 Saint-Denis,2,6,8,2022,01-20,07:03
029 Richter,14,2,16,2022,01-20,07:03
030 Charles Flahault,4,4,8,2022,01-20,07:03
031 Voltaire,2,6,8,2022,01-20,07:03
032 Pr�s d'Ar�nes,6,2,8,2022,01-20,07:03
033 Garcia Lorca,5,3,8,2022,01-20,07:03
034 Vert Bois,0,16,16,2022,01-20,07:03
035 Malbosc,2,6,8,2022,01-20,07:03
036 Occitanie,5,27,32,2022,01-20,07:03
037 FacdesSciences,5,19,24,2022,01-20,07:03
038 Fac de Lettres,1,15,16,2022,01-20,07:03
039 Aiguelongue,1,7,8,2022,01-20,07:03
040 Jeu de Mail des Abb�s,8,0,8,2022,01-20,07:03
041 Eurom�decine,0,8,8,2022,01-20,07:03
042 Marie Caizergues,1,7,8,2022,01-20,07:03
043 Sabines,4,4,8,2022,01-20,07:03
044 Celleneuve,2,6,8,2022,01-20,07:03
045 Jardin de la Lironde,2,6,8,2022,01-20,07:03
046 P�re Soulas,8,0,8,2022,01-20,07:03
047 Place Viala,3,5,8,2022,01-20,07:03
048 H�tel du D�partement,0,8,8,2022,01-20,07:03
049 Tonnelles,6,2,8,2022,01-20,07:03
050 Parvis Jules Ferry - Gare Saint-Roch,5,3,8,2022,01-20,07:03
051 Pont de Lattes - Gare Saint-Roch,2,10,12,2022,01-20,07:03
053 Deux Ponts - Gare Saint-Roch,1,7,8,2022,01-20,07:03
054 Providence - Ovalie,4,4,8,2022,01-20,07:03
055 P�rols Etang de l'Or,25,43,68,2022,01-20,07:03
056 Albert 1er - Cath�drale,1,11,12,2022,01-20,07:03
057 Saint-Guilhem - Courreau,0,8,8,2022,01-20,07:03
059 Sud De France,0,8,8,2022,01-20,07:03
001 Rue Jules Ferry - Gare Saint-Roch,7,5,12,2022,01-20,07:13
002 Com�die,15,9,24,2022,01-20,07:13
003 Esplanade,18,14,32,2022,01-20,07:13
004 H�tel de Ville,8,8,16,2022,01-20,07:13
005 Corum,11,1,12,2022,01-20,07:13
006 Place Albert 1er - St Charles,14,17,31,2022,01-20,07:13
007 Foch,4,4,8,2022,01-20,07:13
008 Halles Castellane,0,12,12,2022,01-20,07:13
009 Observatoire,7,1,8,2022,01-20,07:13
010 Rondelet,5,11,16,2022,01-20,07:13
011 Plan Cabanes,7,5,12,2022,01-20,07:13
012 Boutonnet,8,4,12,2022,01-20,07:13
013 Emile Combes,3,5,8,2022,01-20,07:13
014 Beaux-Arts,3,5,8,2022,01-20,07:13
015 Les Aubes,4,4,8,2022,01-20,07:13
016 Antigone centre,15,1,16,2022,01-20,07:13
017 M�diath�que Emile Zola,13,3,16,2022,01-20,07:13
018 Nombre d'Or,4,12,16,2022,01-20,07:13
019 Louis Blanc,11,5,16,2022,01-20,07:13
020 Gambetta,5,3,8,2022,01-20,07:13
021 Port Marianne,3,13,16,2022,01-20,07:13
022 Clemenceau,2,10,12,2022,01-20,07:13
023 Les Arceaux,2,14,16,2022,01-20,07:13
024 Cit� Mion,4,4,8,2022,01-20,07:13
025 Nouveau Saint-Roch,5,3,8,2022,01-20,07:13
026 Renouvier,1,7,8,2022,01-20,07:13
027 Odysseum,0,8,8,2022,01-20,07:13
028 Saint-Denis,2,6,8,2022,01-20,07:13
029 Richter,14,2,16,2022,01-20,07:13
030 Charles Flahault,4,4,8,2022,01-20,07:13
031 Voltaire,2,6,8,2022,01-20,07:13
032 Pr�s d'Ar�nes,6,2,8,2022,01-20,07:13
033 Garcia Lorca,5,3,8,2022,01-20,07:13
034 Vert Bois,0,16,16,2022,01-20,07:13
035 Malbosc,2,6,8,2022,01-20,07:13
036 Occitanie,5,27,32,2022,01-20,07:13
037 FacdesSciences,5,19,24,2022,01-20,07:13
038 Fac de Lettres,1,15,16,2022,01-20,07:13
039 Aiguelongue,1,7,8,2022,01-20,07:13
040 Jeu de Mail des Abb�s,8,0,8,2022,01-20,07:13
041 Eurom�decine,0,8,8,2022,01-20,07:13
042 Marie Caizergues,1,7,8,2022,01-20,07:13
043 Sabines,4,4,8,2022,01-20,07:13
044 Celleneuve,2,6,8,2022,01-20,07:13
045 Jardin de la Lironde,2,6,8,2022,01-20,07:13
046 P�re Soulas,8,0,8,2022,01-20,07:13
047 Place Viala,3,5,8,2022,01-20,07:13
048 H�tel du D�partement,0,8,8,2022,01-20,07:13
049 Tonnelles,6,2,8,2022,01-20,07:13
050 Parvis Jules Ferry - Gare Saint-Roch,5,3,8,2022,01-20,07:13
051 Pont de Lattes - Gare Saint-Roch,2,10,12,2022,01-20,07:13
053 Deux Ponts - Gare Saint-Roch,1,7,8,2022,01-20,07:13
054 Providence - Ovalie,4,4,8,2022,01-20,07:13
055 P�rols Etang de l'Or,25,43,68,2022,01-20,07:13
056 Albert 1er - Cath�drale,1,11,12,2022,01-20,07:13
057 Saint-Guilhem - Courreau,0,8,8,2022,01-20,07:13
059 Sud De France,0,8,8,2022,01-20,07:13
001 Rue Jules Ferry - Gare Saint-Roch,7,5,12,2022,01-20,07:23
002 Com�die,15,9,24,2022,01-20,07:23
003 Esplanade,18,14,32,2022,01-20,07:23
004 H�tel de Ville,8,8,16,2022,01-20,07:23
005 Corum,11,1,12,2022,01-20,07:23
006 Place Albert 1er - St Charles,15,16,31,2022,01-20,07:23
007 Foch,4,4,8,2022,01-20,07:23
008 Halles Castellane,8,4,12,2022,01-20,07:23
009 Observatoire,7,1,8,2022,01-20,07:23
010 Rondelet,5,11,16,2022,01-20,07:23
011 Plan Cabanes,7,5,12,2022,01-20,07:23
012 Boutonnet,8,4,12,2022,01-20,07:23
013 Emile Combes,3,5,8,2022,01-20,07:23
014 Beaux-Arts,3,5,8,2022,01-20,07:23
015 Les Aubes,4,4,8,2022,01-20,07:23
016 Antigone centre,15,1,16,2022,01-20,07:23
017 M�diath�que Emile Zola,13,3,16,2022,01-20,07:23
018 Nombre d'Or,4,12,16,2022,01-20,07:23
019 Louis Blanc,11,5,16,2022,01-20,07:23
020 Gambetta,5,3,8,2022,01-20,07:23
021 Port Marianne,3,13,16,2022,01-20,07:23
022 Clemenceau,2,10,12,2022,01-20,07:23
023 Les Arceaux,2,14,16,2022,01-20,07:23
024 Cit� Mion,4,4,8,2022,01-20,07:23
025 Nouveau Saint-Roch,5,3,8,2022,01-20,07:23
026 Renouvier,1,7,8,2022,01-20,07:23
027 Odysseum,0,8,8,2022,01-20,07:23
028 Saint-Denis,2,6,8,2022,01-20,07:23
029 Richter,14,2,16,2022,01-20,07:23
030 Charles Flahault,4,4,8,2022,01-20,07:23
031 Voltaire,2,6,8,2022,01-20,07:23
032 Pr�s d'Ar�nes,6,2,8,2022,01-20,07:23
033 Garcia Lorca,5,3,8,2022,01-20,07:23
034 Vert Bois,0,16,16,2022,01-20,07:23
035 Malbosc,2,6,8,2022,01-20,07:23
036 Occitanie,5,27,32,2022,01-20,07:23
037 FacdesSciences,5,19,24,2022,01-20,07:23
038 Fac de Lettres,1,15,16,2022,01-20,07:23
039 Aiguelongue,1,7,8,2022,01-20,07:23
040 Jeu de Mail des Abb�s,8,0,8,2022,01-20,07:23
041 Eurom�decine,0,8,8,2022,01-20,07:23
042 Marie Caizergues,1,7,8,2022,01-20,07:23
043 Sabines,4,4,8,2022,01-20,07:23
044 Celleneuve,2,6,8,2022,01-20,07:23
045 Jardin de la Lironde,2,6,8,2022,01-20,07:23
046 P�re Soulas,8,0,8,2022,01-20,07:23
047 Place Viala,3,5,8,2022,01-20,07:23
048 H�tel du D�partement,0,8,8,2022,01-20,07:23
049 Tonnelles,6,2,8,2022,01-20,07:23
050 Parvis Jules Ferry - Gare Saint-Roch,5,3,8,2022,01-20,07:23
051 Pont de Lattes - Gare Saint-Roch,2,10,12,2022,01-20,07:23
053 Deux Ponts - Gare Saint-Roch,1,7,8,2022,01-20,07:23
054 Providence - Ovalie,4,4,8,2022,01-20,07:23
055 P�rols Etang de l'Or,25,43,68,2022,01-20,07:23
056 Albert 1er - Cath�drale,1,11,12,2022,01-20,07:23
057 Saint-Guilhem - Courreau,0,8,8,2022,01-20,07:23
059 Sud De France,0,8,8,2022,01-20,07:23
001 Rue Jules Ferry - Gare Saint-Roch,7,5,12,2022,01-20,07:33
002 Com�die,15,9,24,2022,01-20,07:33
003 Esplanade,18,14,32,2022,01-20,07:33
004 H�tel de Ville,8,8,16,2022,01-20,07:33
005 Corum,11,1,12,2022,01-20,07:33
006 Place Albert 1er - St Charles,15,16,31,2022,01-20,07:33
007 Foch,4,4,8,2022,01-20,07:33
008 Halles Castellane,8,4,12,2022,01-20,07:33
009 Observatoire,7,1,8,2022,01-20,07:33
010 Rondelet,5,11,16,2022,01-20,07:33
011 Plan Cabanes,7,5,12,2022,01-20,07:33
012 Boutonnet,8,4,12,2022,01-20,07:33
013 Emile Combes,3,5,8,2022,01-20,07:33
014 Beaux-Arts,3,5,8,2022,01-20,07:33
015 Les Aubes,4,4,8,2022,01-20,07:33
016 Antigone centre,15,1,16,2022,01-20,07:33
017 M�diath�que Emile Zola,13,3,16,2022,01-20,07:33
018 Nombre d'Or,4,12,16,2022,01-20,07:33
019 Louis Blanc,11,5,16,2022,01-20,07:33
020 Gambetta,5,3,8,2022,01-20,07:33
021 Port Marianne,3,13,16,2022,01-20,07:33
022 Clemenceau,2,10,12,2022,01-20,07:33
023 Les Arceaux,2,14,16,2022,01-20,07:33
024 Cit� Mion,4,4,8,2022,01-20,07:33
025 Nouveau Saint-Roch,5,3,8,2022,01-20,07:33
026 Renouvier,1,7,8,2022,01-20,07:33
027 Odysseum,0,8,8,2022,01-20,07:33
028 Saint-Denis,2,6,8,2022,01-20,07:33
029 Richter,14,2,16,2022,01-20,07:33
030 Charles Flahault,4,4,8,2022,01-20,07:33
031 Voltaire,2,6,8,2022,01-20,07:33
032 Pr�s d'Ar�nes,6,2,8,2022,01-20,07:33
033 Garcia Lorca,5,3,8,2022,01-20,07:33
034 Vert Bois,0,16,16,2022,01-20,07:33
035 Malbosc,2,6,8,2022,01-20,07:33
036 Occitanie,5,27,32,2022,01-20,07:33
037 FacdesSciences,5,19,24,2022,01-20,07:33
038 Fac de Lettres,1,15,16,2022,01-20,07:33
039 Aiguelongue,1,7,8,2022,01-20,07:33
040 Jeu de Mail des Abb�s,8,0,8,2022,01-20,07:33
041 Eurom�decine,0,8,8,2022,01-20,07:33
042 Marie Caizergues,1,7,8,2022,01-20,07:33
043 Sabines,4,4,8,2022,01-20,07:33
044 Celleneuve,2,6,8,2022,01-20,07:33
045 Jardin de la Lironde,2,6,8,2022,01-20,07:33
046 P�re Soulas,8,0,8,2022,01-20,07:33
047 Place Viala,3,5,8,2022,01-20,07:33
048 H�tel du D�partement,0,8,8,2022,01-20,07:33
049 Tonnelles,6,2,8,2022,01-20,07:33
050 Parvis Jules Ferry - Gare Saint-Roch,5,3,8,2022,01-20,07:33
051 Pont de Lattes - Gare Saint-Roch,2,10,12,2022,01-20,07:33
053 Deux Ponts - Gare Saint-Roch,1,7,8,2022,01-20,07:33
054 Providence - Ovalie,4,4,8,2022,01-20,07:33
055 P�rols Etang de l'Or,25,43,68,2022,01-20,07:33
056 Albert 1er - Cath�drale,1,11,12,2022,01-20,07:33
057 Saint-Guilhem - Courreau,0,8,8,2022,01-20,07:33
059 Sud De France,0,8,8,2022,01-20,07:33
001 Rue Jules Ferry - Gare Saint-Roch,7,5,12,2022,01-20,07:43
002 Com�die,16,8,24,2022,01-20,07:43
003 Esplanade,18,14,32,2022,01-20,07:43
004 H�tel de Ville,8,8,16,2022,01-20,07:43
005 Corum,11,1,12,2022,01-20,07:43
006 Place Albert 1er - St Charles,15,16,31,2022,01-20,07:43
007 Foch,4,4,8,2022,01-20,07:43
008 Halles Castellane,8,4,12,2022,01-20,07:43
009 Observatoire,7,1,8,2022,01-20,07:43
010 Rondelet,5,11,16,2022,01-20,07:43
011 Plan Cabanes,7,5,12,2022,01-20,07:43
012 Boutonnet,8,4,12,2022,01-20,07:43
013 Emile Combes,3,5,8,2022,01-20,07:43
014 Beaux-Arts,3,5,8,2022,01-20,07:43
015 Les Aubes,4,4,8,2022,01-20,07:43
016 Antigone centre,6,10,16,2022,01-20,07:43
017 M�diath�que Emile Zola,13,3,16,2022,01-20,07:43
018 Nombre d'Or,4,12,16,2022,01-20,07:43
019 Louis Blanc,10,6,16,2022,01-20,07:43
020 Gambetta,5,3,8,2022,01-20,07:43
021 Port Marianne,3,13,16,2022,01-20,07:43
022 Clemenceau,2,10,12,2022,01-20,07:43
023 Les Arceaux,1,15,16,2022,01-20,07:43
024 Cit� Mion,4,4,8,2022,01-20,07:43
025 Nouveau Saint-Roch,5,3,8,2022,01-20,07:43
026 Renouvier,1,7,8,2022,01-20,07:43
027 Odysseum,0,8,8,2022,01-20,07:43
028 Saint-Denis,1,7,8,2022,01-20,07:43
029 Richter,14,2,16,2022,01-20,07:43
030 Charles Flahault,4,4,8,2022,01-20,07:43
031 Voltaire,2,6,8,2022,01-20,07:43
032 Pr�s d'Ar�nes,6,2,8,2022,01-20,07:43
033 Garcia Lorca,5,3,8,2022,01-20,07:43
034 Vert Bois,0,16,16,2022,01-20,07:43
035 Malbosc,2,6,8,2022,01-20,07:43
036 Occitanie,5,27,32,2022,01-20,07:43
037 FacdesSciences,5,19,24,2022,01-20,07:43
038 Fac de Lettres,1,15,16,2022,01-20,07:43
039 Aiguelongue,1,7,8,2022,01-20,07:43
040 Jeu de Mail des Abb�s,8,0,8,2022,01-20,07:43
041 Eurom�decine,0,8,8,2022,01-20,07:43
042 Marie Caizergues,1,7,8,2022,01-20,07:43
043 Sabines,4,4,8,2022,01-20,07:43
044 Celleneuve,2,6,8,2022,01-20,07:43
045 Jardin de la Lironde,2,6,8,2022,01-20,07:43
046 P�re Soulas,8,0,8,2022,01-20,07:43
047 Place Viala,3,5,8,2022,01-20,07:43
048 H�tel du D�partement,0,8,8,2022,01-20,07:43
049 Tonnelles,6,2,8,2022,01-20,07:43
050 Parvis Jules Ferry - Gare Saint-Roch,5,3,8,2022,01-20,07:43
051 Pont de Lattes - Gare Saint-Roch,2,10,12,2022,01-20,07:43
053 Deux Ponts - Gare Saint-Roch,1,7,8,2022,01-20,07:43
054 Providence - Ovalie,4,4,8,2022,01-20,07:43
055 P�rols Etang de l'Or,25,43,68,2022,01-20,07:43
056 Albert 1er - Cath�drale,1,11,12,2022,01-20,07:43
057 Saint-Guilhem - Courreau,0,8,8,2022,01-20,07:43
059 Sud De France,0,8,8,2022,01-20,07:43
001 Rue Jules Ferry - Gare Saint-Roch,7,5,12,2022,01-20,07:53
002 Com�die,16,8,24,2022,01-20,07:53
003 Esplanade,18,14,32,2022,01-20,07:53
004 H�tel de Ville,8,8,16,2022,01-20,07:53
005 Corum,11,1,12,2022,01-20,07:53
006 Place Albert 1er - St Charles,15,16,31,2022,01-20,07:53
007 Foch,4,4,8,2022,01-20,07:53
008 Halles Castellane,8,4,12,2022,01-20,07:53
009 Observatoire,7,1,8,2022,01-20,07:53
010 Rondelet,5,11,16,2022,01-20,07:53
011 Plan Cabanes,7,5,12,2022,01-20,07:53
012 Boutonnet,8,4,12,2022,01-20,07:53
013 Emile Combes,3,5,8,2022,01-20,07:53
014 Beaux-Arts,3,5,8,2022,01-20,07:53
015 Les Aubes,4,4,8,2022,01-20,07:53
016 Antigone centre,6,10,16,2022,01-20,07:53
017 M�diath�que Emile Zola,13,3,16,2022,01-20,07:53
018 Nombre d'Or,4,12,16,2022,01-20,07:53
019 Louis Blanc,10,6,16,2022,01-20,07:53
020 Gambetta,5,3,8,2022,01-20,07:53
021 Port Marianne,3,13,16,2022,01-20,07:53
022 Clemenceau,2,10,12,2022,01-20,07:53
023 Les Arceaux,1,15,16,2022,01-20,07:53
024 Cit� Mion,3,5,8,2022,01-20,07:53
025 Nouveau Saint-Roch,5,3,8,2022,01-20,07:53
026 Renouvier,1,7,8,2022,01-20,07:53
027 Odysseum,0,8,8,2022,01-20,07:53
028 Saint-Denis,1,7,8,2022,01-20,07:53
029 Richter,14,2,16,2022,01-20,07:53
030 Charles Flahault,4,4,8,2022,01-20,07:53
031 Voltaire,2,6,8,2022,01-20,07:53
032 Pr�s d'Ar�nes,6,2,8,2022,01-20,07:53
033 Garcia Lorca,5,3,8,2022,01-20,07:53
034 Vert Bois,0,16,16,2022,01-20,07:53
035 Malbosc,2,6,8,2022,01-20,07:53
036 Occitanie,5,27,32,2022,01-20,07:53
037 FacdesSciences,5,19,24,2022,01-20,07:53
038 Fac de Lettres,1,15,16,2022,01-20,07:53
039 Aiguelongue,1,7,8,2022,01-20,07:53
040 Jeu de Mail des Abb�s,8,0,8,2022,01-20,07:53
041 Eurom�decine,0,8,8,2022,01-20,07:53
042 Marie Caizergues,1,7,8,2022,01-20,07:53
043 Sabines,4,4,8,2022,01-20,07:53
044 Celleneuve,2,6,8,2022,01-20,07:53
045 Jardin de la Lironde,2,6,8,2022,01-20,07:53
046 P�re Soulas,8,0,8,2022,01-20,07:53
047 Place Viala,3,5,8,2022,01-20,07:53
048 H�tel du D�partement,0,8,8,2022,01-20,07:53
049 Tonnelles,6,2,8,2022,01-20,07:53
050 Parvis Jules Ferry - Gare Saint-Roch,5,3,8,2022,01-20,07:53
051 Pont de Lattes - Gare Saint-Roch,2,10,12,2022,01-20,07:53
053 Deux Ponts - Gare Saint-Roch,1,7,8,2022,01-20,07:53
054 Providence - Ovalie,4,4,8,2022,01-20,07:53
055 P�rols Etang de l'Or,25,43,68,2022,01-20,07:53
056 Albert 1er - Cath�drale,1,11,12,2022,01-20,07:53
057 Saint-Guilhem - Courreau,0,8,8,2022,01-20,07:53
059 Sud De France,0,8,8,2022,01-20,07:53
001 Rue Jules Ferry - Gare Saint-Roch,7,5,12,2022,01-20,08:04
002 Com�die,16,8,24,2022,01-20,08:04
003 Esplanade,18,14,32,2022,01-20,08:04
004 H�tel de Ville,8,8,16,2022,01-20,08:04
005 Corum,11,1,12,2022,01-20,08:04
006 Place Albert 1er - St Charles,15,16,31,2022,01-20,08:04
007 Foch,4,4,8,2022,01-20,08:04
008 Halles Castellane,8,4,12,2022,01-20,08:04
009 Observatoire,7,1,8,2022,01-20,08:04
010 Rondelet,5,11,16,2022,01-20,08:04
011 Plan Cabanes,7,5,12,2022,01-20,08:04
012 Boutonnet,8,4,12,2022,01-20,08:04
013 Emile Combes,3,5,8,2022,01-20,08:04
014 Beaux-Arts,3,5,8,2022,01-20,08:04
015 Les Aubes,4,4,8,2022,01-20,08:04
016 Antigone centre,6,10,16,2022,01-20,08:04
017 M�diath�que Emile Zola,10,6,16,2022,01-20,08:04
018 Nombre d'Or,4,12,16,2022,01-20,08:04
019 Louis Blanc,10,6,16,2022,01-20,08:04
020 Gambetta,5,3,8,2022,01-20,08:04
021 Port Marianne,3,13,16,2022,01-20,08:04
022 Clemenceau,2,10,12,2022,01-20,08:04
023 Les Arceaux,1,15,16,2022,01-20,08:04
024 Cit� Mion,3,5,8,2022,01-20,08:04
025 Nouveau Saint-Roch,5,3,8,2022,01-20,08:04
026 Renouvier,1,7,8,2022,01-20,08:04
027 Odysseum,0,8,8,2022,01-20,08:04
028 Saint-Denis,1,7,8,2022,01-20,08:04
029 Richter,14,2,16,2022,01-20,08:04
030 Charles Flahault,4,4,8,2022,01-20,08:04
031 Voltaire,2,6,8,2022,01-20,08:04
032 Pr�s d'Ar�nes,6,2,8,2022,01-20,08:04
033 Garcia Lorca,5,3,8,2022,01-20,08:04
034 Vert Bois,0,16,16,2022,01-20,08:04
035 Malbosc,2,6,8,2022,01-20,08:04
036 Occitanie,4,28,32,2022,01-20,08:04
037 FacdesSciences,6,18,24,2022,01-20,08:04
038 Fac de Lettres,1,15,16,2022,01-20,08:04
039 Aiguelongue,1,7,8,2022,01-20,08:04
040 Jeu de Mail des Abb�s,8,0,8,2022,01-20,08:04
041 Eurom�decine,0,8,8,2022,01-20,08:04
042 Marie Caizergues,1,7,8,2022,01-20,08:04
043 Sabines,4,4,8,2022,01-20,08:04
044 Celleneuve,2,6,8,2022,01-20,08:04
045 Jardin de la Lironde,2,6,8,2022,01-20,08:04
046 P�re Soulas,7,1,8,2022,01-20,08:04
047 Place Viala,3,5,8,2022,01-20,08:04
048 H�tel du D�partement,0,8,8,2022,01-20,08:04
049 Tonnelles,6,2,8,2022,01-20,08:04
050 Parvis Jules Ferry - Gare Saint-Roch,5,3,8,2022,01-20,08:04
051 Pont de Lattes - Gare Saint-Roch,2,10,12,2022,01-20,08:04
053 Deux Ponts - Gare Saint-Roch,1,7,8,2022,01-20,08:04
054 Providence - Ovalie,4,4,8,2022,01-20,08:04
055 P�rols Etang de l'Or,25,43,68,2022,01-20,08:04
056 Albert 1er - Cath�drale,1,11,12,2022,01-20,08:04
057 Saint-Guilhem - Courreau,0,8,8,2022,01-20,08:04
059 Sud De France,0,8,8,2022,01-20,08:04
001 Rue Jules Ferry - Gare Saint-Roch,6,6,12,2022,01-20,08:14
002 Com�die,16,8,24,2022,01-20,08:14
003 Esplanade,18,14,32,2022,01-20,08:14
004 H�tel de Ville,8,8,16,2022,01-20,08:14
005 Corum,11,1,12,2022,01-20,08:14
006 Place Albert 1er - St Charles,15,16,31,2022,01-20,08:14
007 Foch,4,4,8,2022,01-20,08:14
008 Halles Castellane,8,4,12,2022,01-20,08:14
009 Observatoire,7,1,8,2022,01-20,08:14
010 Rondelet,5,11,16,2022,01-20,08:14
011 Plan Cabanes,7,5,12,2022,01-20,08:14
012 Boutonnet,8,4,12,2022,01-20,08:14
013 Emile Combes,3,5,8,2022,01-20,08:14
014 Beaux-Arts,3,5,8,2022,01-20,08:14
015 Les Aubes,4,4,8,2022,01-20,08:14
016 Antigone centre,6,10,16,2022,01-20,08:14
017 M�diath�que Emile Zola,7,9,16,2022,01-20,08:14
018 Nombre d'Or,4,12,16,2022,01-20,08:14
019 Louis Blanc,10,6,16,2022,01-20,08:14
020 Gambetta,5,3,8,2022,01-20,08:14
021 Port Marianne,3,13,16,2022,01-20,08:14
022 Clemenceau,1,11,12,2022,01-20,08:14
023 Les Arceaux,1,15,16,2022,01-20,08:14
024 Cit� Mion,3,5,8,2022,01-20,08:14
025 Nouveau Saint-Roch,5,3,8,2022,01-20,08:14
026 Renouvier,1,7,8,2022,01-20,08:14
027 Odysseum,0,8,8,2022,01-20,08:14
028 Saint-Denis,1,7,8,2022,01-20,08:14
029 Richter,14,2,16,2022,01-20,08:14
030 Charles Flahault,4,4,8,2022,01-20,08:14
031 Voltaire,2,6,8,2022,01-20,08:14
032 Pr�s d'Ar�nes,6,2,8,2022,01-20,08:14
033 Garcia Lorca,5,3,8,2022,01-20,08:14
034 Vert Bois,0,16,16,2022,01-20,08:14
035 Malbosc,3,5,8,2022,01-20,08:14
036 Occitanie,4,28,32,2022,01-20,08:14
037 FacdesSciences,6,18,24,2022,01-20,08:14
038 Fac de Lettres,1,15,16,2022,01-20,08:14
039 Aiguelongue,1,7,8,2022,01-20,08:14
040 Jeu de Mail des Abb�s,8,0,8,2022,01-20,08:14
041 Eurom�decine,0,8,8,2022,01-20,08:14
042 Marie Caizergues,0,8,8,2022,01-20,08:14
043 Sabines,4,4,8,2022,01-20,08:14
044 Celleneuve,2,6,8,2022,01-20,08:14
045 Jardin de la Lironde,2,6,8,2022,01-20,08:14
046 P�re Soulas,7,1,8,2022,01-20,08:14
047 Place Viala,3,5,8,2022,01-20,08:14
048 H�tel du D�partement,0,8,8,2022,01-20,08:14
049 Tonnelles,6,2,8,2022,01-20,08:14
050 Parvis Jules Ferry - Gare Saint-Roch,5,3,8,2022,01-20,08:14
051 Pont de Lattes - Gare Saint-Roch,2,10,12,2022,01-20,08:14
053 Deux Ponts - Gare Saint-Roch,1,7,8,2022,01-20,08:14
054 Providence - Ovalie,4,4,8,2022,01-20,08:14
055 P�rols Etang de l'Or,25,43,68,2022,01-20,08:14
056 Albert 1er - Cath�drale,1,11,12,2022,01-20,08:14
057 Saint-Guilhem - Courreau,0,8,8,2022,01-20,08:14
059 Sud De France,0,8,8,2022,01-20,08:14
001 Rue Jules Ferry - Gare Saint-Roch,6,6,12,2022,01-20,08:24
002 Com�die,16,8,24,2022,01-20,08:24
003 Esplanade,18,14,32,2022,01-20,08:24
004 H�tel de Ville,8,8,16,2022,01-20,08:24
005 Corum,11,1,12,2022,01-20,08:24
006 Place Albert 1er - St Charles,15,16,31,2022,01-20,08:24
007 Foch,4,4,8,2022,01-20,08:24
008 Halles Castellane,9,3,12,2022,01-20,08:24
009 Observatoire,7,1,8,2022,01-20,08:24
010 Rondelet,5,11,16,2022,01-20,08:24
011 Plan Cabanes,7,5,12,2022,01-20,08:24
012 Boutonnet,8,4,12,2022,01-20,08:24
013 Emile Combes,3,5,8,2022,01-20,08:24
014 Beaux-Arts,3,5,8,2022,01-20,08:24
015 Les Aubes,4,4,8,2022,01-20,08:24
016 Antigone centre,6,10,16,2022,01-20,08:24
017 M�diath�que Emile Zola,7,9,16,2022,01-20,08:24
018 Nombre d'Or,4,12,16,2022,01-20,08:24
019 Louis Blanc,10,6,16,2022,01-20,08:24
020 Gambetta,5,3,8,2022,01-20,08:24
021 Port Marianne,3,13,16,2022,01-20,08:24
022 Clemenceau,1,11,12,2022,01-20,08:24
023 Les Arceaux,2,14,16,2022,01-20,08:24
024 Cit� Mion,3,5,8,2022,01-20,08:24
025 Nouveau Saint-Roch,5,3,8,2022,01-20,08:24
026 Renouvier,0,8,8,2022,01-20,08:24
027 Odysseum,0,8,8,2022,01-20,08:24
028 Saint-Denis,1,7,8,2022,01-20,08:24
029 Richter,14,2,16,2022,01-20,08:24
030 Charles Flahault,3,5,8,2022,01-20,08:24
031 Voltaire,2,6,8,2022,01-20,08:24
032 Pr�s d'Ar�nes,6,2,8,2022,01-20,08:24
033 Garcia Lorca,6,2,8,2022,01-20,08:24
034 Vert Bois,0,16,16,2022,01-20,08:24
035 Malbosc,3,5,8,2022,01-20,08:24
036 Occitanie,4,28,32,2022,01-20,08:24
037 FacdesSciences,6,18,24,2022,01-20,08:24
038 Fac de Lettres,2,14,16,2022,01-20,08:24
039 Aiguelongue,1,7,8,2022,01-20,08:24
040 Jeu de Mail des Abb�s,8,0,8,2022,01-20,08:24
041 Eurom�decine,0,8,8,2022,01-20,08:24
042 Marie Caizergues,0,8,8,2022,01-20,08:24
043 Sabines,4,4,8,2022,01-20,08:24
044 Celleneuve,2,6,8,2022,01-20,08:24
045 Jardin de la Lironde,1,7,8,2022,01-20,08:24
046 P�re Soulas,7,1,8,2022,01-20,08:24
047 Place Viala,3,5,8,2022,01-20,08:24
048 H�tel du D�partement,0,8,8,2022,01-20,08:24
049 Tonnelles,6,2,8,2022,01-20,08:24
050 Parvis Jules Ferry - Gare Saint-Roch,5,3,8,2022,01-20,08:24
051 Pont de Lattes - Gare Saint-Roch,2,10,12,2022,01-20,08:24
053 Deux Ponts - Gare Saint-Roch,1,7,8,2022,01-20,08:24
054 Providence - Ovalie,4,4,8,2022,01-20,08:24
055 P�rols Etang de l'Or,25,43,68,2022,01-20,08:24
056 Albert 1er - Cath�drale,1,11,12,2022,01-20,08:24
057 Saint-Guilhem - Courreau,5,3,8,2022,01-20,08:24
059 Sud De France,0,8,8,2022,01-20,08:24
001 Rue Jules Ferry - Gare Saint-Roch,6,6,12,2022,01-20,08:34
002 Com�die,17,7,24,2022,01-20,08:34
003 Esplanade,18,14,32,2022,01-20,08:34
004 H�tel de Ville,8,8,16,2022,01-20,08:34
005 Corum,11,1,12,2022,01-20,08:34
006 Place Albert 1er - St Charles,15,16,31,2022,01-20,08:34
007 Foch,4,4,8,2022,01-20,08:34
008 Halles Castellane,9,3,12,2022,01-20,08:34
009 Observatoire,7,1,8,2022,01-20,08:34
010 Rondelet,5,11,16,2022,01-20,08:34
011 Plan Cabanes,7,5,12,2022,01-20,08:34
012 Boutonnet,8,4,12,2022,01-20,08:34
013 Emile Combes,3,5,8,2022,01-20,08:34
014 Beaux-Arts,3,5,8,2022,01-20,08:34
015 Les Aubes,4,4,8,2022,01-20,08:34
016 Antigone centre,6,10,16,2022,01-20,08:34
017 M�diath�que Emile Zola,6,10,16,2022,01-20,08:34
018 Nombre d'Or,4,12,16,2022,01-20,08:34
019 Louis Blanc,10,6,16,2022,01-20,08:34
020 Gambetta,5,3,8,2022,01-20,08:34
021 Port Marianne,3,13,16,2022,01-20,08:34
022 Clemenceau,1,11,12,2022,01-20,08:34
023 Les Arceaux,2,14,16,2022,01-20,08:34
024 Cit� Mion,3,5,8,2022,01-20,08:34
025 Nouveau Saint-Roch,4,4,8,2022,01-20,08:34
026 Renouvier,0,8,8,2022,01-20,08:34
027 Odysseum,0,8,8,2022,01-20,08:34
028 Saint-Denis,1,7,8,2022,01-20,08:34
029 Richter,14,2,16,2022,01-20,08:34
030 Charles Flahault,3,5,8,2022,01-20,08:34
031 Voltaire,2,6,8,2022,01-20,08:34
032 Pr�s d'Ar�nes,6,2,8,2022,01-20,08:34
033 Garcia Lorca,5,3,8,2022,01-20,08:34
034 Vert Bois,0,16,16,2022,01-20,08:34
035 Malbosc,3,5,8,2022,01-20,08:34
036 Occitanie,4,28,32,2022,01-20,08:34
037 FacdesSciences,6,18,24,2022,01-20,08:34
038 Fac de Lettres,2,14,16,2022,01-20,08:34
039 Aiguelongue,1,7,8,2022,01-20,08:34
040 Jeu de Mail des Abb�s,8,0,8,2022,01-20,08:34
041 Eurom�decine,0,8,8,2022,01-20,08:34
042 Marie Caizergues,0,8,8,2022,01-20,08:34
043 Sabines,4,4,8,2022,01-20,08:34
044 Celleneuve,2,6,8,2022,01-20,08:34
045 Jardin de la Lironde,0,8,8,2022,01-20,08:34
046 P�re Soulas,7,1,8,2022,01-20,08:34
047 Place Viala,2,6,8,2022,01-20,08:34
048 H�tel du D�partement,0,8,8,2022,01-20,08:34
049 Tonnelles,6,2,8,2022,01-20,08:34
050 Parvis Jules Ferry - Gare Saint-Roch,5,3,8,2022,01-20,08:34
051 Pont de Lattes - Gare Saint-Roch,2,10,12,2022,01-20,08:34
053 Deux Ponts - Gare Saint-Roch,1,7,8,2022,01-20,08:34
054 Providence - Ovalie,4,4,8,2022,01-20,08:34
055 P�rols Etang de l'Or,25,43,68,2022,01-20,08:34
056 Albert 1er - Cath�drale,1,11,12,2022,01-20,08:34
057 Saint-Guilhem - Courreau,5,3,8,2022,01-20,08:34
059 Sud De France,0,8,8,2022,01-20,08:34
001 Rue Jules Ferry - Gare Saint-Roch,5,7,12,2022,01-20,08:44
002 Com�die,17,7,24,2022,01-20,08:44
003 Esplanade,18,14,32,2022,01-20,08:44
004 H�tel de Ville,8,8,16,2022,01-20,08:44
005 Corum,11,1,12,2022,01-20,08:44
006 Place Albert 1er - St Charles,15,16,31,2022,01-20,08:44
007 Foch,4,4,8,2022,01-20,08:44
008 Halles Castellane,9,3,12,2022,01-20,08:44
009 Observatoire,7,1,8,2022,01-20,08:44
010 Rondelet,5,11,16,2022,01-20,08:44
011 Plan Cabanes,6,6,12,2022,01-20,08:44
012 Boutonnet,8,4,12,2022,01-20,08:44
013 Emile Combes,3,5,8,2022,01-20,08:44
014 Beaux-Arts,3,5,8,2022,01-20,08:44
015 Les Aubes,4,4,8,2022,01-20,08:44
016 Antigone centre,6,10,16,2022,01-20,08:44
017 M�diath�que Emile Zola,6,10,16,2022,01-20,08:44
018 Nombre d'Or,5,11,16,2022,01-20,08:44
019 Louis Blanc,10,6,16,2022,01-20,08:44
020 Gambetta,6,2,8,2022,01-20,08:44
021 Port Marianne,3,13,16,2022,01-20,08:44
022 Clemenceau,0,12,12,2022,01-20,08:44
023 Les Arceaux,1,15,16,2022,01-20,08:44
024 Cit� Mion,3,5,8,2022,01-20,08:44
025 Nouveau Saint-Roch,4,4,8,2022,01-20,08:44
026 Renouvier,0,8,8,2022,01-20,08:44
027 Odysseum,0,8,8,2022,01-20,08:44
028 Saint-Denis,1,7,8,2022,01-20,08:44
029 Richter,15,1,16,2022,01-20,08:44
030 Charles Flahault,3,5,8,2022,01-20,08:44
031 Voltaire,2,6,8,2022,01-20,08:44
032 Pr�s d'Ar�nes,6,2,8,2022,01-20,08:44
033 Garcia Lorca,5,3,8,2022,01-20,08:44
034 Vert Bois,0,16,16,2022,01-20,08:44
035 Malbosc,3,5,8,2022,01-20,08:44
036 Occitanie,4,28,32,2022,01-20,08:44
037 FacdesSciences,6,18,24,2022,01-20,08:44
038 Fac de Lettres,3,13,16,2022,01-20,08:44
039 Aiguelongue,1,7,8,2022,01-20,08:44
040 Jeu de Mail des Abb�s,8,0,8,2022,01-20,08:44
041 Eurom�decine,4,4,8,2022,01-20,08:44
042 Marie Caizergues,0,8,8,2022,01-20,08:44
043 Sabines,4,4,8,2022,01-20,08:44
044 Celleneuve,2,6,8,2022,01-20,08:44
045 Jardin de la Lironde,0,8,8,2022,01-20,08:44
046 P�re Soulas,7,1,8,2022,01-20,08:44
047 Place Viala,2,6,8,2022,01-20,08:44
048 H�tel du D�partement,0,8,8,2022,01-20,08:44
049 Tonnelles,6,2,8,2022,01-20,08:44
050 Parvis Jules Ferry - Gare Saint-Roch,5,3,8,2022,01-20,08:44
051 Pont de Lattes - Gare Saint-Roch,2,10,12,2022,01-20,08:44
053 Deux Ponts - Gare Saint-Roch,1,7,8,2022,01-20,08:44
054 Providence - Ovalie,4,4,8,2022,01-20,08:44
055 P�rols Etang de l'Or,25,43,68,2022,01-20,08:44
056 Albert 1er - Cath�drale,1,11,12,2022,01-20,08:44
057 Saint-Guilhem - Courreau,4,4,8,2022,01-20,08:44
059 Sud De France,0,8,8,2022,01-20,08:44
001 Rue Jules Ferry - Gare Saint-Roch,5,7,12,2022,01-20,08:54
002 Com�die,16,8,24,2022,01-20,08:54
003 Esplanade,18,14,32,2022,01-20,08:54
004 H�tel de Ville,8,8,16,2022,01-20,08:54
005 Corum,11,1,12,2022,01-20,08:54
006 Place Albert 1er - St Charles,13,18,31,2022,01-20,08:54
007 Foch,3,5,8,2022,01-20,08:54
008 Halles Castellane,9,3,12,2022,01-20,08:54
009 Observatoire,7,1,8,2022,01-20,08:54
010 Rondelet,5,11,16,2022,01-20,08:54
011 Plan Cabanes,5,7,12,2022,01-20,08:54
012 Boutonnet,8,4,12,2022,01-20,08:54
013 Emile Combes,3,5,8,2022,01-20,08:54
014 Beaux-Arts,4,4,8,2022,01-20,08:54
015 Les Aubes,4,4,8,2022,01-20,08:54
016 Antigone centre,6,10,16,2022,01-20,08:54
017 M�diath�que Emile Zola,7,9,16,2022,01-20,08:54
018 Nombre d'Or,6,10,16,2022,01-20,08:54
019 Louis Blanc,9,7,16,2022,01-20,08:54
020 Gambetta,6,2,8,2022,01-20,08:54
021 Port Marianne,3,13,16,2022,01-20,08:54
022 Clemenceau,0,12,12,2022,01-20,08:54
023 Les Arceaux,1,15,16,2022,01-20,08:54
024 Cit� Mion,3,5,8,2022,01-20,08:54
025 Nouveau Saint-Roch,4,4,8,2022,01-20,08:54
026 Renouvier,0,8,8,2022,01-20,08:54
027 Odysseum,0,8,8,2022,01-20,08:54
028 Saint-Denis,1,7,8,2022,01-20,08:54
029 Richter,15,1,16,2022,01-20,08:54
030 Charles Flahault,4,4,8,2022,01-20,08:54
031 Voltaire,2,6,8,2022,01-20,08:54
032 Pr�s d'Ar�nes,6,2,8,2022,01-20,08:54
033 Garcia Lorca,5,3,8,2022,01-20,08:54
034 Vert Bois,0,16,16,2022,01-20,08:54
035 Malbosc,3,5,8,2022,01-20,08:54
036 Occitanie,4,28,32,2022,01-20,08:54
037 FacdesSciences,6,18,24,2022,01-20,08:54
038 Fac de Lettres,3,13,16,2022,01-20,08:54
039 Aiguelongue,1,7,8,2022,01-20,08:54
040 Jeu de Mail des Abb�s,8,0,8,2022,01-20,08:54
041 Eurom�decine,4,4,8,2022,01-20,08:54
042 Marie Caizergues,0,8,8,2022,01-20,08:54
043 Sabines,4,4,8,2022,01-20,08:54
044 Celleneuve,2,6,8,2022,01-20,08:54
045 Jardin de la Lironde,2,6,8,2022,01-20,08:54
046 P�re Soulas,7,1,8,2022,01-20,08:54
047 Place Viala,2,6,8,2022,01-20,08:54
048 H�tel du D�partement,5,3,8,2022,01-20,08:54
049 Tonnelles,6,2,8,2022,01-20,08:54
050 Parvis Jules Ferry - Gare Saint-Roch,5,3,8,2022,01-20,08:54
051 Pont de Lattes - Gare Saint-Roch,2,10,12,2022,01-20,08:54
053 Deux Ponts - Gare Saint-Roch,1,7,8,2022,01-20,08:54
054 Providence - Ovalie,4,4,8,2022,01-20,08:54
055 P�rols Etang de l'Or,25,43,68,2022,01-20,08:54
056 Albert 1er - Cath�drale,1,11,12,2022,01-20,08:54
057 Saint-Guilhem - Courreau,4,4,8,2022,01-20,08:54
059 Sud De France,0,8,8,2022,01-20,08:54
001 Rue Jules Ferry - Gare Saint-Roch,5,7,12,2022,01-20,09:05
002 Com�die,16,8,24,2022,01-20,09:05
003 Esplanade,18,14,32,2022,01-20,09:05
004 H�tel de Ville,8,8,16,2022,01-20,09:05
005 Corum,11,1,12,2022,01-20,09:05
006 Place Albert 1er - St Charles,14,17,31,2022,01-20,09:05
007 Foch,3,5,8,2022,01-20,09:05
008 Halles Castellane,8,4,12,2022,01-20,09:05
009 Observatoire,7,1,8,2022,01-20,09:05
010 Rondelet,5,11,16,2022,01-20,09:05
011 Plan Cabanes,5,7,12,2022,01-20,09:05
012 Boutonnet,8,4,12,2022,01-20,09:05
013 Emile Combes,3,5,8,2022,01-20,09:05
014 Beaux-Arts,4,4,8,2022,01-20,09:05
015 Les Aubes,4,4,8,2022,01-20,09:05
016 Antigone centre,6,10,16,2022,01-20,09:05
017 M�diath�que Emile Zola,8,8,16,2022,01-20,09:05
018 Nombre d'Or,7,9,16,2022,01-20,09:05
019 Louis Blanc,9,7,16,2022,01-20,09:05
020 Gambetta,6,2,8,2022,01-20,09:05
021 Port Marianne,3,13,16,2022,01-20,09:05
022 Clemenceau,0,12,12,2022,01-20,09:05
023 Les Arceaux,1,15,16,2022,01-20,09:05
024 Cit� Mion,3,5,8,2022,01-20,09:05
025 Nouveau Saint-Roch,4,4,8,2022,01-20,09:05
026 Renouvier,0,8,8,2022,01-20,09:05
027 Odysseum,0,8,8,2022,01-20,09:05
028 Saint-Denis,1,7,8,2022,01-20,09:05
029 Richter,15,1,16,2022,01-20,09:05
030 Charles Flahault,4,4,8,2022,01-20,09:05
031 Voltaire,2,6,8,2022,01-20,09:05
032 Pr�s d'Ar�nes,6,2,8,2022,01-20,09:05
033 Garcia Lorca,5,3,8,2022,01-20,09:05
034 Vert Bois,0,16,16,2022,01-20,09:05
035 Malbosc,3,5,8,2022,01-20,09:05
036 Occitanie,5,27,32,2022,01-20,09:05
037 FacdesSciences,5,19,24,2022,01-20,09:05
038 Fac de Lettres,3,13,16,2022,01-20,09:05
039 Aiguelongue,1,7,8,2022,01-20,09:05
040 Jeu de Mail des Abb�s,8,0,8,2022,01-20,09:05
041 Eurom�decine,4,4,8,2022,01-20,09:05
042 Marie Caizergues,0,8,8,2022,01-20,09:05
043 Sabines,4,4,8,2022,01-20,09:05
044 Celleneuve,2,6,8,2022,01-20,09:05
045 Jardin de la Lironde,2,6,8,2022,01-20,09:05
046 P�re Soulas,7,1,8,2022,01-20,09:05
047 Place Viala,3,5,8,2022,01-20,09:05
048 H�tel du D�partement,5,3,8,2022,01-20,09:05
049 Tonnelles,6,2,8,2022,01-20,09:05
050 Parvis Jules Ferry - Gare Saint-Roch,6,2,8,2022,01-20,09:05
051 Pont de Lattes - Gare Saint-Roch,2,10,12,2022,01-20,09:05
053 Deux Ponts - Gare Saint-Roch,1,7,8,2022,01-20,09:05
054 Providence - Ovalie,4,4,8,2022,01-20,09:05
055 P�rols Etang de l'Or,25,43,68,2022,01-20,09:05
056 Albert 1er - Cath�drale,1,11,12,2022,01-20,09:05
057 Saint-Guilhem - Courreau,5,3,8,2022,01-20,09:05
059 Sud De France,0,8,8,2022,01-20,09:05
001 Rue Jules Ferry - Gare Saint-Roch,5,7,12,2022,01-20,09:15
002 Com�die,16,8,24,2022,01-20,09:15
003 Esplanade,18,14,32,2022,01-20,09:15
004 H�tel de Ville,8,8,16,2022,01-20,09:15
005 Corum,11,1,12,2022,01-20,09:15
006 Place Albert 1er - St Charles,14,17,31,2022,01-20,09:15
007 Foch,2,6,8,2022,01-20,09:15
008 Halles Castellane,8,4,12,2022,01-20,09:15
009 Observatoire,7,1,8,2022,01-20,09:15
010 Rondelet,5,11,16,2022,01-20,09:15
011 Plan Cabanes,5,7,12,2022,01-20,09:15
012 Boutonnet,8,4,12,2022,01-20,09:15
013 Emile Combes,3,5,8,2022,01-20,09:15
014 Beaux-Arts,3,5,8,2022,01-20,09:15
015 Les Aubes,4,4,8,2022,01-20,09:15
016 Antigone centre,6,10,16,2022,01-20,09:15
017 M�diath�que Emile Zola,7,9,16,2022,01-20,09:15
018 Nombre d'Or,7,9,16,2022,01-20,09:15
019 Louis Blanc,9,7,16,2022,01-20,09:15
020 Gambetta,6,2,8,2022,01-20,09:15
021 Port Marianne,3,13,16,2022,01-20,09:15
022 Clemenceau,0,12,12,2022,01-20,09:15
023 Les Arceaux,1,15,16,2022,01-20,09:15
024 Cit� Mion,3,5,8,2022,01-20,09:15
025 Nouveau Saint-Roch,4,4,8,2022,01-20,09:15
026 Renouvier,0,8,8,2022,01-20,09:15
027 Odysseum,0,8,8,2022,01-20,09:15
028 Saint-Denis,1,7,8,2022,01-20,09:15
029 Richter,15,1,16,2022,01-20,09:15
030 Charles Flahault,4,4,8,2022,01-20,09:15
031 Voltaire,2,6,8,2022,01-20,09:15
032 Pr�s d'Ar�nes,6,2,8,2022,01-20,09:15
033 Garcia Lorca,5,3,8,2022,01-20,09:15
034 Vert Bois,0,16,16,2022,01-20,09:15
035 Malbosc,3,5,8,2022,01-20,09:15
036 Occitanie,5,27,32,2022,01-20,09:15
037 FacdesSciences,5,19,24,2022,01-20,09:15
038 Fac de Lettres,3,13,16,2022,01-20,09:15
039 Aiguelongue,1,7,8,2022,01-20,09:15
040 Jeu de Mail des Abb�s,8,0,8,2022,01-20,09:15
041 Eurom�decine,4,4,8,2022,01-20,09:15
042 Marie Caizergues,0,8,8,2022,01-20,09:15
043 Sabines,4,4,8,2022,01-20,09:15
044 Celleneuve,2,6,8,2022,01-20,09:15
045 Jardin de la Lironde,2,6,8,2022,01-20,09:15
046 P�re Soulas,7,1,8,2022,01-20,09:15
047 Place Viala,3,5,8,2022,01-20,09:15
048 H�tel du D�partement,5,3,8,2022,01-20,09:15
049 Tonnelles,6,2,8,2022,01-20,09:15
050 Parvis Jules Ferry - Gare Saint-Roch,6,2,8,2022,01-20,09:15
051 Pont de Lattes - Gare Saint-Roch,2,10,12,2022,01-20,09:15
053 Deux Ponts - Gare Saint-Roch,1,7,8,2022,01-20,09:15
054 Providence - Ovalie,4,4,8,2022,01-20,09:15
055 P�rols Etang de l'Or,25,43,68,2022,01-20,09:15
056 Albert 1er - Cath�drale,1,11,12,2022,01-20,09:15
057 Saint-Guilhem - Courreau,5,3,8,2022,01-20,09:15
059 Sud De France,0,8,8,2022,01-20,09:15
001 Rue Jules Ferry - Gare Saint-Roch,5,7,12,2022,01-20,09:25
002 Com�die,17,7,24,2022,01-20,09:25
003 Esplanade,18,14,32,2022,01-20,09:25
004 H�tel de Ville,8,8,16,2022,01-20,09:25
005 Corum,11,1,12,2022,01-20,09:25
006 Place Albert 1er - St Charles,14,17,31,2022,01-20,09:25
007 Foch,2,6,8,2022,01-20,09:25
008 Halles Castellane,8,4,12,2022,01-20,09:25
009 Observatoire,7,1,8,2022,01-20,09:25
010 Rondelet,5,11,16,2022,01-20,09:25
011 Plan Cabanes,5,7,12,2022,01-20,09:25
012 Boutonnet,8,4,12,2022,01-20,09:25
013 Emile Combes,3,5,8,2022,01-20,09:25
014 Beaux-Arts,3,5,8,2022,01-20,09:25
015 Les Aubes,4,4,8,2022,01-20,09:25
016 Antigone centre,6,10,16,2022,01-20,09:25
017 M�diath�que Emile Zola,7,9,16,2022,01-20,09:25
018 Nombre d'Or,7,9,16,2022,01-20,09:25
019 Louis Blanc,9,7,16,2022,01-20,09:25
020 Gambetta,6,2,8,2022,01-20,09:25
021 Port Marianne,3,13,16,2022,01-20,09:25
022 Clemenceau,0,12,12,2022,01-20,09:25
023 Les Arceaux,1,15,16,2022,01-20,09:25
024 Cit� Mion,3,5,8,2022,01-20,09:25
025 Nouveau Saint-Roch,5,3,8,2022,01-20,09:25
026 Renouvier,0,8,8,2022,01-20,09:25
027 Odysseum,0,8,8,2022,01-20,09:25
028 Saint-Denis,1,7,8,2022,01-20,09:25
029 Richter,15,1,16,2022,01-20,09:25
030 Charles Flahault,4,4,8,2022,01-20,09:25
031 Voltaire,2,6,8,2022,01-20,09:25
032 Pr�s d'Ar�nes,6,2,8,2022,01-20,09:25
033 Garcia Lorca,5,3,8,2022,01-20,09:25
034 Vert Bois,0,16,16,2022,01-20,09:25
035 Malbosc,3,5,8,2022,01-20,09:25
036 Occitanie,5,27,32,2022,01-20,09:25
037 FacdesSciences,5,19,24,2022,01-20,09:25
038 Fac de Lettres,3,13,16,2022,01-20,09:25
039 Aiguelongue,1,7,8,2022,01-20,09:25
040 Jeu de Mail des Abb�s,8,0,8,2022,01-20,09:25
041 Eurom�decine,4,4,8,2022,01-20,09:25
042 Marie Caizergues,0,8,8,2022,01-20,09:25
043 Sabines,4,4,8,2022,01-20,09:25
044 Celleneuve,2,6,8,2022,01-20,09:25
045 Jardin de la Lironde,2,6,8,2022,01-20,09:25
046 P�re Soulas,7,1,8,2022,01-20,09:25
047 Place Viala,3,5,8,2022,01-20,09:25
048 H�tel du D�partement,5,3,8,2022,01-20,09:25
049 Tonnelles,6,2,8,2022,01-20,09:25
050 Parvis Jules Ferry - Gare Saint-Roch,7,1,8,2022,01-20,09:25
051 Pont de Lattes - Gare Saint-Roch,2,10,12,2022,01-20,09:25
053 Deux Ponts - Gare Saint-Roch,1,7,8,2022,01-20,09:25
054 Providence - Ovalie,4,4,8,2022,01-20,09:25
055 P�rols Etang de l'Or,25,43,68,2022,01-20,09:25
056 Albert 1er - Cath�drale,1,11,12,2022,01-20,09:25
057 Saint-Guilhem - Courreau,5,3,8,2022,01-20,09:25
059 Sud De France,0,8,8,2022,01-20,09:25
001 Rue Jules Ferry - Gare Saint-Roch,6,6,12,2022,01-20,09:35
002 Com�die,17,7,24,2022,01-20,09:35
003 Esplanade,18,14,32,2022,01-20,09:35
004 H�tel de Ville,8,8,16,2022,01-20,09:35
005 Corum,11,1,12,2022,01-20,09:35
006 Place Albert 1er - St Charles,14,17,31,2022,01-20,09:35
007 Foch,2,6,8,2022,01-20,09:35
008 Halles Castellane,8,4,12,2022,01-20,09:35
009 Observatoire,7,1,8,2022,01-20,09:35
010 Rondelet,5,11,16,2022,01-20,09:35
011 Plan Cabanes,5,7,12,2022,01-20,09:35
012 Boutonnet,8,4,12,2022,01-20,09:35
013 Emile Combes,3,5,8,2022,01-20,09:35
014 Beaux-Arts,3,5,8,2022,01-20,09:35
015 Les Aubes,4,4,8,2022,01-20,09:35
016 Antigone centre,6,10,16,2022,01-20,09:35
017 M�diath�que Emile Zola,7,9,16,2022,01-20,09:35
018 Nombre d'Or,7,9,16,2022,01-20,09:35
019 Louis Blanc,9,7,16,2022,01-20,09:35
020 Gambetta,6,2,8,2022,01-20,09:35
021 Port Marianne,3,13,16,2022,01-20,09:35
022 Clemenceau,5,7,12,2022,01-20,09:35
023 Les Arceaux,1,15,16,2022,01-20,09:35
024 Cit� Mion,3,5,8,2022,01-20,09:35
025 Nouveau Saint-Roch,5,3,8,2022,01-20,09:35
026 Renouvier,0,8,8,2022,01-20,09:35
027 Odysseum,0,8,8,2022,01-20,09:35
028 Saint-Denis,1,7,8,2022,01-20,09:35
029 Richter,15,1,16,2022,01-20,09:35
030 Charles Flahault,4,4,8,2022,01-20,09:35
031 Voltaire,2,6,8,2022,01-20,09:35
032 Pr�s d'Ar�nes,6,2,8,2022,01-20,09:35
033 Garcia Lorca,5,3,8,2022,01-20,09:35
034 Vert Bois,0,16,16,2022,01-20,09:35
035 Malbosc,3,5,8,2022,01-20,09:35
036 Occitanie,5,27,32,2022,01-20,09:35
037 FacdesSciences,6,18,24,2022,01-20,09:35
038 Fac de Lettres,3,13,16,2022,01-20,09:35
039 Aiguelongue,1,7,8,2022,01-20,09:35
040 Jeu de Mail des Abb�s,8,0,8,2022,01-20,09:35
041 Eurom�decine,4,4,8,2022,01-20,09:35
042 Marie Caizergues,0,8,8,2022,01-20,09:35
043 Sabines,4,4,8,2022,01-20,09:35
044 Celleneuve,2,6,8,2022,01-20,09:35
045 Jardin de la Lironde,2,6,8,2022,01-20,09:35
046 P�re Soulas,7,1,8,2022,01-20,09:35
047 Place Viala,3,5,8,2022,01-20,09:35
048 H�tel du D�partement,6,2,8,2022,01-20,09:35
049 Tonnelles,5,3,8,2022,01-20,09:35
050 Parvis Jules Ferry - Gare Saint-Roch,7,1,8,2022,01-20,09:35
051 Pont de Lattes - Gare Saint-Roch,2,10,12,2022,01-20,09:35
053 Deux Ponts - Gare Saint-Roch,1,7,8,2022,01-20,09:35
054 Providence - Ovalie,4,4,8,2022,01-20,09:35
055 P�rols Etang de l'Or,25,43,68,2022,01-20,09:35
056 Albert 1er - Cath�drale,1,11,12,2022,01-20,09:35
057 Saint-Guilhem - Courreau,5,3,8,2022,01-20,09:35
059 Sud De France,0,8,8,2022,01-20,09:35
001 Rue Jules Ferry - Gare Saint-Roch,5,7,12,2022,01-20,09:45
002 Com�die,17,7,24,2022,01-20,09:45
003 Esplanade,18,14,32,2022,01-20,09:45
004 H�tel de Ville,8,8,16,2022,01-20,09:45
005 Corum,11,1,12,2022,01-20,09:45
006 Place Albert 1er - St Charles,14,17,31,2022,01-20,09:45
007 Foch,2,6,8,2022,01-20,09:45
008 Halles Castellane,8,4,12,2022,01-20,09:45
009 Observatoire,7,1,8,2022,01-20,09:45
010 Rondelet,5,11,16,2022,01-20,09:45
011 Plan Cabanes,4,8,12,2022,01-20,09:45
012 Boutonnet,8,4,12,2022,01-20,09:45
013 Emile Combes,3,5,8,2022,01-20,09:45
014 Beaux-Arts,3,5,8,2022,01-20,09:45
015 Les Aubes,4,4,8,2022,01-20,09:45
016 Antigone centre,6,10,16,2022,01-20,09:45
017 M�diath�que Emile Zola,7,9,16,2022,01-20,09:45
018 Nombre d'Or,7,9,16,2022,01-20,09:45
019 Louis Blanc,9,7,16,2022,01-20,09:45
020 Gambetta,6,2,8,2022,01-20,09:45
021 Port Marianne,3,13,16,2022,01-20,09:45
022 Clemenceau,5,7,12,2022,01-20,09:45
023 Les Arceaux,1,15,16,2022,01-20,09:45
024 Cit� Mion,3,5,8,2022,01-20,09:45
025 Nouveau Saint-Roch,5,3,8,2022,01-20,09:45
026 Renouvier,0,8,8,2022,01-20,09:45
027 Odysseum,0,8,8,2022,01-20,09:45
028 Saint-Denis,1,7,8,2022,01-20,09:45
029 Richter,15,1,16,2022,01-20,09:45
030 Charles Flahault,4,4,8,2022,01-20,09:45
031 Voltaire,2,6,8,2022,01-20,09:45
032 Pr�s d'Ar�nes,6,2,8,2022,01-20,09:45
033 Garcia Lorca,5,3,8,2022,01-20,09:45
034 Vert Bois,0,16,16,2022,01-20,09:45
035 Malbosc,3,5,8,2022,01-20,09:45
036 Occitanie,4,28,32,2022,01-20,09:45
037 FacdesSciences,6,18,24,2022,01-20,09:45
038 Fac de Lettres,1,15,16,2022,01-20,09:45
039 Aiguelongue,1,7,8,2022,01-20,09:45
040 Jeu de Mail des Abb�s,8,0,8,2022,01-20,09:45
041 Eurom�decine,4,4,8,2022,01-20,09:45
042 Marie Caizergues,0,8,8,2022,01-20,09:45
043 Sabines,4,4,8,2022,01-20,09:45
044 Celleneuve,2,6,8,2022,01-20,09:45
045 Jardin de la Lironde,2,6,8,2022,01-20,09:45
046 P�re Soulas,7,1,8,2022,01-20,09:45
047 Place Viala,3,5,8,2022,01-20,09:45
048 H�tel du D�partement,6,2,8,2022,01-20,09:45
049 Tonnelles,5,3,8,2022,01-20,09:45
050 Parvis Jules Ferry - Gare Saint-Roch,7,1,8,2022,01-20,09:45
051 Pont de Lattes - Gare Saint-Roch,2,10,12,2022,01-20,09:45
053 Deux Ponts - Gare Saint-Roch,1,7,8,2022,01-20,09:45
054 Providence - Ovalie,4,4,8,2022,01-20,09:45
055 P�rols Etang de l'Or,25,43,68,2022,01-20,09:45
056 Albert 1er - Cath�drale,1,11,12,2022,01-20,09:45
057 Saint-Guilhem - Courreau,5,3,8,2022,01-20,09:45
059 Sud De France,0,8,8,2022,01-20,09:45
001 Rue Jules Ferry - Gare Saint-Roch,5,7,12,2022,01-20,09:55
002 Com�die,16,8,24,2022,01-20,09:55
003 Esplanade,17,15,32,2022,01-20,09:55
004 H�tel de Ville,8,8,16,2022,01-20,09:55
005 Corum,11,1,12,2022,01-20,09:55
006 Place Albert 1er - St Charles,13,18,31,2022,01-20,09:55
007 Foch,2,6,8,2022,01-20,09:55
008 Halles Castellane,8,4,12,2022,01-20,09:55
009 Observatoire,6,2,8,2022,01-20,09:55
010 Rondelet,5,11,16,2022,01-20,09:55
011 Plan Cabanes,4,8,12,2022,01-20,09:55
012 Boutonnet,9,3,12,2022,01-20,09:55
013 Emile Combes,3,5,8,2022,01-20,09:55
014 Beaux-Arts,3,5,8,2022,01-20,09:55
015 Les Aubes,4,4,8,2022,01-20,09:55
016 Antigone centre,6,10,16,2022,01-20,09:55
017 M�diath�que Emile Zola,7,9,16,2022,01-20,09:55
018 Nombre d'Or,7,9,16,2022,01-20,09:55
019 Louis Blanc,10,6,16,2022,01-20,09:55
020 Gambetta,6,2,8,2022,01-20,09:55
021 Port Marianne,3,13,16,2022,01-20,09:55
022 Clemenceau,4,8,12,2022,01-20,09:55
023 Les Arceaux,1,15,16,2022,01-20,09:55
024 Cit� Mion,3,5,8,2022,01-20,09:55
025 Nouveau Saint-Roch,5,3,8,2022,01-20,09:55
026 Renouvier,0,8,8,2022,01-20,09:55
027 Odysseum,0,8,8,2022,01-20,09:55
028 Saint-Denis,1,7,8,2022,01-20,09:55
029 Richter,15,1,16,2022,01-20,09:55
030 Charles Flahault,4,4,8,2022,01-20,09:55
031 Voltaire,1,7,8,2022,01-20,09:55
032 Pr�s d'Ar�nes,6,2,8,2022,01-20,09:55
033 Garcia Lorca,5,3,8,2022,01-20,09:55
034 Vert Bois,0,16,16,2022,01-20,09:55
035 Malbosc,3,5,8,2022,01-20,09:55
036 Occitanie,3,29,32,2022,01-20,09:55
037 FacdesSciences,6,18,24,2022,01-20,09:55
038 Fac de Lettres,1,15,16,2022,01-20,09:55
039 Aiguelongue,1,7,8,2022,01-20,09:55
040 Jeu de Mail des Abb�s,8,0,8,2022,01-20,09:55
041 Eurom�decine,4,4,8,2022,01-20,09:55
042 Marie Caizergues,0,8,8,2022,01-20,09:55
043 Sabines,4,4,8,2022,01-20,09:55
044 Celleneuve,2,6,8,2022,01-20,09:55
045 Jardin de la Lironde,2,6,8,2022,01-20,09:55
046 P�re Soulas,7,1,8,2022,01-20,09:55
047 Place Viala,3,5,8,2022,01-20,09:55
048 H�tel du D�partement,6,2,8,2022,01-20,09:55
049 Tonnelles,5,3,8,2022,01-20,09:55
050 Parvis Jules Ferry - Gare Saint-Roch,6,2,8,2022,01-20,09:55
051 Pont de Lattes - Gare Saint-Roch,2,10,12,2022,01-20,09:55
053 Deux Ponts - Gare Saint-Roch,1,7,8,2022,01-20,09:55
054 Providence - Ovalie,4,4,8,2022,01-20,09:55
055 P�rols Etang de l'Or,25,43,68,2022,01-20,09:55
056 Albert 1er - Cath�drale,1,11,12,2022,01-20,09:55
057 Saint-Guilhem - Courreau,5,3,8,2022,01-20,09:55
059 Sud De France,0,8,8,2022,01-20,09:55
001 Rue Jules Ferry - Gare Saint-Roch,5,7,12,2022,01-20,10:06
002 Com�die,18,6,24,2022,01-20,10:06
003 Esplanade,16,16,32,2022,01-20,10:06
004 H�tel de Ville,8,8,16,2022,01-20,10:06
005 Corum,11,1,12,2022,01-20,10:06
006 Place Albert 1er - St Charles,13,18,31,2022,01-20,10:06
007 Foch,2,6,8,2022,01-20,10:06
008 Halles Castellane,8,4,12,2022,01-20,10:06
009 Observatoire,5,3,8,2022,01-20,10:06
010 Rondelet,5,11,16,2022,01-20,10:06
011 Plan Cabanes,4,8,12,2022,01-20,10:06
012 Boutonnet,9,3,12,2022,01-20,10:06
013 Emile Combes,3,5,8,2022,01-20,10:06
014 Beaux-Arts,3,5,8,2022,01-20,10:06
015 Les Aubes,4,4,8,2022,01-20,10:06
016 Antigone centre,6,10,16,2022,01-20,10:06
017 M�diath�que Emile Zola,8,8,16,2022,01-20,10:06
018 Nombre d'Or,7,9,16,2022,01-20,10:06
019 Louis Blanc,10,6,16,2022,01-20,10:06
020 Gambetta,6,2,8,2022,01-20,10:06
021 Port Marianne,3,13,16,2022,01-20,10:06
022 Clemenceau,6,6,12,2022,01-20,10:06
023 Les Arceaux,1,15,16,2022,01-20,10:06
024 Cit� Mion,3,5,8,2022,01-20,10:06
025 Nouveau Saint-Roch,5,3,8,2022,01-20,10:06
026 Renouvier,0,8,8,2022,01-20,10:06
027 Odysseum,0,8,8,2022,01-20,10:06
028 Saint-Denis,1,7,8,2022,01-20,10:06
029 Richter,16,0,16,2022,01-20,10:06
030 Charles Flahault,3,5,8,2022,01-20,10:06
031 Voltaire,1,7,8,2022,01-20,10:06
032 Pr�s d'Ar�nes,7,1,8,2022,01-20,10:06
033 Garcia Lorca,5,3,8,2022,01-20,10:06
034 Vert Bois,0,16,16,2022,01-20,10:06
035 Malbosc,3,5,8,2022,01-20,10:06
036 Occitanie,3,29,32,2022,01-20,10:06
037 FacdesSciences,6,18,24,2022,01-20,10:06
038 Fac de Lettres,1,15,16,2022,01-20,10:06
039 Aiguelongue,1,7,8,2022,01-20,10:06
040 Jeu de Mail des Abb�s,8,0,8,2022,01-20,10:06
041 Eurom�decine,3,5,8,2022,01-20,10:06
042 Marie Caizergues,0,8,8,2022,01-20,10:06
043 Sabines,4,4,8,2022,01-20,10:06
044 Celleneuve,2,6,8,2022,01-20,10:06
045 Jardin de la Lironde,3,5,8,2022,01-20,10:06
046 P�re Soulas,7,1,8,2022,01-20,10:06
047 Place Viala,3,5,8,2022,01-20,10:06
048 H�tel du D�partement,6,2,8,2022,01-20,10:06
049 Tonnelles,5,3,8,2022,01-20,10:06
050 Parvis Jules Ferry - Gare Saint-Roch,6,2,8,2022,01-20,10:06
051 Pont de Lattes - Gare Saint-Roch,2,10,12,2022,01-20,10:06
053 Deux Ponts - Gare Saint-Roch,1,7,8,2022,01-20,10:06
054 Providence - Ovalie,4,4,8,2022,01-20,10:06
055 P�rols Etang de l'Or,25,43,68,2022,01-20,10:06
056 Albert 1er - Cath�drale,1,11,12,2022,01-20,10:06
057 Saint-Guilhem - Courreau,5,3,8,2022,01-20,10:06
059 Sud De France,0,8,8,2022,01-20,10:06
001 Rue Jules Ferry - Gare Saint-Roch,5,7,12,2022,01-20,10:16
002 Com�die,19,5,24,2022,01-20,10:16
003 Esplanade,16,16,32,2022,01-20,10:16
004 H�tel de Ville,8,8,16,2022,01-20,10:16
005 Corum,11,1,12,2022,01-20,10:16
006 Place Albert 1er - St Charles,13,18,31,2022,01-20,10:16
007 Foch,2,6,8,2022,01-20,10:16
008 Halles Castellane,8,4,12,2022,01-20,10:16
009 Observatoire,4,4,8,2022,01-20,10:16
010 Rondelet,5,11,16,2022,01-20,10:16
011 Plan Cabanes,3,9,12,2022,01-20,10:16
012 Boutonnet,9,3,12,2022,01-20,10:16
013 Emile Combes,3,5,8,2022,01-20,10:16
014 Beaux-Arts,3,5,8,2022,01-20,10:16
015 Les Aubes,4,4,8,2022,01-20,10:16
016 Antigone centre,6,10,16,2022,01-20,10:16
017 M�diath�que Emile Zola,8,8,16,2022,01-20,10:16
018 Nombre d'Or,7,9,16,2022,01-20,10:16
019 Louis Blanc,10,6,16,2022,01-20,10:16
020 Gambetta,6,2,8,2022,01-20,10:16
021 Port Marianne,3,13,16,2022,01-20,10:16
022 Clemenceau,7,5,12,2022,01-20,10:16
023 Les Arceaux,5,11,16,2022,01-20,10:16
024 Cit� Mion,3,5,8,2022,01-20,10:16
025 Nouveau Saint-Roch,5,3,8,2022,01-20,10:16
026 Renouvier,0,8,8,2022,01-20,10:16
027 Odysseum,0,8,8,2022,01-20,10:16
028 Saint-Denis,1,7,8,2022,01-20,10:16
029 Richter,16,0,16,2022,01-20,10:16
030 Charles Flahault,3,5,8,2022,01-20,10:16
031 Voltaire,1,7,8,2022,01-20,10:16
032 Pr�s d'Ar�nes,7,1,8,2022,01-20,10:16
033 Garcia Lorca,5,3,8,2022,01-20,10:16
034 Vert Bois,0,16,16,2022,01-20,10:16
035 Malbosc,3,5,8,2022,01-20,10:16
036 Occitanie,3,29,32,2022,01-20,10:16
037 FacdesSciences,6,18,24,2022,01-20,10:16
038 Fac de Lettres,1,15,16,2022,01-20,10:16
039 Aiguelongue,1,7,8,2022,01-20,10:16
040 Jeu de Mail des Abb�s,3,5,8,2022,01-20,10:16
041 Eurom�decine,3,5,8,2022,01-20,10:16
042 Marie Caizergues,0,8,8,2022,01-20,10:16
043 Sabines,4,4,8,2022,01-20,10:16
044 Celleneuve,2,6,8,2022,01-20,10:16
045 Jardin de la Lironde,3,5,8,2022,01-20,10:16
046 P�re Soulas,7,1,8,2022,01-20,10:16
047 Place Viala,3,5,8,2022,01-20,10:16
048 H�tel du D�partement,6,2,8,2022,01-20,10:16
049 Tonnelles,5,3,8,2022,01-20,10:16
050 Parvis Jules Ferry - Gare Saint-Roch,6,2,8,2022,01-20,10:16
051 Pont de Lattes - Gare Saint-Roch,2,10,12,2022,01-20,10:16
053 Deux Ponts - Gare Saint-Roch,1,7,8,2022,01-20,10:16
054 Providence - Ovalie,4,4,8,2022,01-20,10:16
055 P�rols Etang de l'Or,25,43,68,2022,01-20,10:16
056 Albert 1er - Cath�drale,1,11,12,2022,01-20,10:16
057 Saint-Guilhem - Courreau,5,3,8,2022,01-20,10:16
059 Sud De France,0,8,8,2022,01-20,10:16
001 Rue Jules Ferry - Gare Saint-Roch,5,7,12,2022,01-20,10:26
002 Com�die,19,5,24,2022,01-20,10:26
003 Esplanade,15,17,32,2022,01-20,10:26
004 H�tel de Ville,8,8,16,2022,01-20,10:26
005 Corum,6,6,12,2022,01-20,10:26
006 Place Albert 1er - St Charles,13,18,31,2022,01-20,10:26
007 Foch,2,6,8,2022,01-20,10:26
008 Halles Castellane,8,4,12,2022,01-20,10:26
009 Observatoire,4,4,8,2022,01-20,10:26
010 Rondelet,5,11,16,2022,01-20,10:26
011 Plan Cabanes,3,9,12,2022,01-20,10:26
012 Boutonnet,9,3,12,2022,01-20,10:26
013 Emile Combes,3,5,8,2022,01-20,10:26
014 Beaux-Arts,2,6,8,2022,01-20,10:26
015 Les Aubes,4,4,8,2022,01-20,10:26
016 Antigone centre,6,10,16,2022,01-20,10:26
017 M�diath�que Emile Zola,8,8,16,2022,01-20,10:26
018 Nombre d'Or,7,9,16,2022,01-20,10:26
019 Louis Blanc,10,6,16,2022,01-20,10:26
020 Gambetta,6,2,8,2022,01-20,10:26
021 Port Marianne,3,13,16,2022,01-20,10:26
022 Clemenceau,7,5,12,2022,01-20,10:26
023 Les Arceaux,5,11,16,2022,01-20,10:26
024 Cit� Mion,3,5,8,2022,01-20,10:26
025 Nouveau Saint-Roch,5,3,8,2022,01-20,10:26
026 Renouvier,0,8,8,2022,01-20,10:26
027 Odysseum,0,8,8,2022,01-20,10:26
028 Saint-Denis,1,7,8,2022,01-20,10:26
029 Richter,16,0,16,2022,01-20,10:26
030 Charles Flahault,3,5,8,2022,01-20,10:26
031 Voltaire,1,7,8,2022,01-20,10:26
032 Pr�s d'Ar�nes,7,1,8,2022,01-20,10:26
033 Garcia Lorca,5,3,8,2022,01-20,10:26
034 Vert Bois,0,16,16,2022,01-20,10:26
035 Malbosc,3,5,8,2022,01-20,10:26
036 Occitanie,3,29,32,2022,01-20,10:26
037 FacdesSciences,6,18,24,2022,01-20,10:26
038 Fac de Lettres,1,15,16,2022,01-20,10:26
039 Aiguelongue,1,7,8,2022,01-20,10:26
040 Jeu de Mail des Abb�s,3,5,8,2022,01-20,10:26
041 Eurom�decine,3,5,8,2022,01-20,10:26
042 Marie Caizergues,0,8,8,2022,01-20,10:26
043 Sabines,4,4,8,2022,01-20,10:26
044 Celleneuve,2,6,8,2022,01-20,10:26
045 Jardin de la Lironde,3,5,8,2022,01-20,10:26
046 P�re Soulas,7,1,8,2022,01-20,10:26
047 Place Viala,3,5,8,2022,01-20,10:26
048 H�tel du D�partement,6,2,8,2022,01-20,10:26
049 Tonnelles,5,3,8,2022,01-20,10:26
050 Parvis Jules Ferry - Gare Saint-Roch,6,2,8,2022,01-20,10:26
051 Pont de Lattes - Gare Saint-Roch,2,10,12,2022,01-20,10:26
053 Deux Ponts - Gare Saint-Roch,1,7,8,2022,01-20,10:26
054 Providence - Ovalie,4,4,8,2022,01-20,10:26
055 P�rols Etang de l'Or,25,43,68,2022,01-20,10:26
056 Albert 1er - Cath�drale,1,11,12,2022,01-20,10:26
057 Saint-Guilhem - Courreau,5,3,8,2022,01-20,10:26
059 Sud De France,0,8,8,2022,01-20,10:26
001 Rue Jules Ferry - Gare Saint-Roch,5,7,12,2022,01-20,10:36
002 Com�die,19,5,24,2022,01-20,10:36
003 Esplanade,15,17,32,2022,01-20,10:36
004 H�tel de Ville,9,7,16,2022,01-20,10:36
005 Corum,3,9,12,2022,01-20,10:36
006 Place Albert 1er - St Charles,13,18,31,2022,01-20,10:36
007 Foch,2,6,8,2022,01-20,10:36
008 Halles Castellane,8,4,12,2022,01-20,10:36
009 Observatoire,4,4,8,2022,01-20,10:36
010 Rondelet,5,11,16,2022,01-20,10:36
011 Plan Cabanes,3,9,12,2022,01-20,10:36
012 Boutonnet,10,2,12,2022,01-20,10:36
013 Emile Combes,3,5,8,2022,01-20,10:36
014 Beaux-Arts,2,6,8,2022,01-20,10:36
015 Les Aubes,4,4,8,2022,01-20,10:36
016 Antigone centre,6,10,16,2022,01-20,10:36
017 M�diath�que Emile Zola,8,8,16,2022,01-20,10:36
018 Nombre d'Or,7,9,16,2022,01-20,10:36
019 Louis Blanc,10,6,16,2022,01-20,10:36
020 Gambetta,6,2,8,2022,01-20,10:36
021 Port Marianne,3,13,16,2022,01-20,10:36
022 Clemenceau,7,5,12,2022,01-20,10:36
023 Les Arceaux,5,11,16,2022,01-20,10:36
024 Cit� Mion,3,5,8,2022,01-20,10:36
025 Nouveau Saint-Roch,5,3,8,2022,01-20,10:36
026 Renouvier,0,8,8,2022,01-20,10:36
027 Odysseum,0,8,8,2022,01-20,10:36
028 Saint-Denis,1,7,8,2022,01-20,10:36
029 Richter,16,0,16,2022,01-20,10:36
030 Charles Flahault,3,5,8,2022,01-20,10:36
031 Voltaire,1,7,8,2022,01-20,10:36
032 Pr�s d'Ar�nes,7,1,8,2022,01-20,10:36
033 Garcia Lorca,5,3,8,2022,01-20,10:36
034 Vert Bois,0,16,16,2022,01-20,10:36
035 Malbosc,3,5,8,2022,01-20,10:36
036 Occitanie,4,28,32,2022,01-20,10:36
037 FacdesSciences,6,18,24,2022,01-20,10:36
038 Fac de Lettres,1,15,16,2022,01-20,10:36
039 Aiguelongue,1,7,8,2022,01-20,10:36
040 Jeu de Mail des Abb�s,3,5,8,2022,01-20,10:36
041 Eurom�decine,2,6,8,2022,01-20,10:36
042 Marie Caizergues,0,8,8,2022,01-20,10:36
043 Sabines,4,4,8,2022,01-20,10:36
044 Celleneuve,2,6,8,2022,01-20,10:36
045 Jardin de la Lironde,3,5,8,2022,01-20,10:36
046 P�re Soulas,7,1,8,2022,01-20,10:36
047 Place Viala,2,6,8,2022,01-20,10:36
048 H�tel du D�partement,6,2,8,2022,01-20,10:36
049 Tonnelles,6,2,8,2022,01-20,10:36
050 Parvis Jules Ferry - Gare Saint-Roch,6,2,8,2022,01-20,10:36
051 Pont de Lattes - Gare Saint-Roch,2,10,12,2022,01-20,10:36
053 Deux Ponts - Gare Saint-Roch,1,7,8,2022,01-20,10:36
054 Providence - Ovalie,4,4,8,2022,01-20,10:36
055 P�rols Etang de l'Or,25,43,68,2022,01-20,10:36
056 Albert 1er - Cath�drale,1,11,12,2022,01-20,10:36
057 Saint-Guilhem - Courreau,5,3,8,2022,01-20,10:36
059 Sud De France,0,8,8,2022,01-20,10:36
001 Rue Jules Ferry - Gare Saint-Roch,5,7,12,2022,01-20,10:46
002 Com�die,19,5,24,2022,01-20,10:46
003 Esplanade,15,17,32,2022,01-20,10:46
004 H�tel de Ville,9,7,16,2022,01-20,10:46
005 Corum,3,9,12,2022,01-20,10:46
006 Place Albert 1er - St Charles,13,18,31,2022,01-20,10:46
007 Foch,2,6,8,2022,01-20,10:46
008 Halles Castellane,8,4,12,2022,01-20,10:46
009 Observatoire,4,4,8,2022,01-20,10:46
010 Rondelet,5,11,16,2022,01-20,10:46
011 Plan Cabanes,2,10,12,2022,01-20,10:46
012 Boutonnet,10,2,12,2022,01-20,10:46
013 Emile Combes,3,5,8,2022,01-20,10:46
014 Beaux-Arts,2,6,8,2022,01-20,10:46
015 Les Aubes,4,4,8,2022,01-20,10:46
016 Antigone centre,6,10,16,2022,01-20,10:46
017 M�diath�que Emile Zola,8,8,16,2022,01-20,10:46
018 Nombre d'Or,7,9,16,2022,01-20,10:46
019 Louis Blanc,10,6,16,2022,01-20,10:46
020 Gambetta,6,2,8,2022,01-20,10:46
021 Port Marianne,4,12,16,2022,01-20,10:46
022 Clemenceau,8,4,12,2022,01-20,10:46
023 Les Arceaux,5,11,16,2022,01-20,10:46
024 Cit� Mion,3,5,8,2022,01-20,10:46
025 Nouveau Saint-Roch,5,3,8,2022,01-20,10:46
026 Renouvier,0,8,8,2022,01-20,10:46
027 Odysseum,0,8,8,2022,01-20,10:46
028 Saint-Denis,1,7,8,2022,01-20,10:46
029 Richter,16,0,16,2022,01-20,10:46
030 Charles Flahault,3,5,8,2022,01-20,10:46
031 Voltaire,1,7,8,2022,01-20,10:46
032 Pr�s d'Ar�nes,7,1,8,2022,01-20,10:46
033 Garcia Lorca,5,3,8,2022,01-20,10:46
034 Vert Bois,0,16,16,2022,01-20,10:46
035 Malbosc,3,5,8,2022,01-20,10:46
036 Occitanie,4,28,32,2022,01-20,10:46
037 FacdesSciences,6,18,24,2022,01-20,10:46
038 Fac de Lettres,1,15,16,2022,01-20,10:46
039 Aiguelongue,1,7,8,2022,01-20,10:46
040 Jeu de Mail des Abb�s,3,5,8,2022,01-20,10:46
041 Eurom�decine,2,6,8,2022,01-20,10:46
042 Marie Caizergues,4,4,8,2022,01-20,10:46
043 Sabines,4,4,8,2022,01-20,10:46
044 Celleneuve,2,6,8,2022,01-20,10:46
045 Jardin de la Lironde,3,5,8,2022,01-20,10:46
046 P�re Soulas,7,1,8,2022,01-20,10:46
047 Place Viala,2,6,8,2022,01-20,10:46
048 H�tel du D�partement,6,2,8,2022,01-20,10:46
049 Tonnelles,6,2,8,2022,01-20,10:46
050 Parvis Jules Ferry - Gare Saint-Roch,6,2,8,2022,01-20,10:46
051 Pont de Lattes - Gare Saint-Roch,2,10,12,2022,01-20,10:46
053 Deux Ponts - Gare Saint-Roch,1,7,8,2022,01-20,10:46
054 Providence - Ovalie,4,4,8,2022,01-20,10:46
055 P�rols Etang de l'Or,25,43,68,2022,01-20,10:46
056 Albert 1er - Cath�drale,1,11,12,2022,01-20,10:46
057 Saint-Guilhem - Courreau,4,4,8,2022,01-20,10:46
059 Sud De France,0,8,8,2022,01-20,10:46
001 Rue Jules Ferry - Gare Saint-Roch,5,7,12,2022,01-20,10:56
002 Com�die,19,5,24,2022,01-20,10:56
003 Esplanade,15,17,32,2022,01-20,10:56
004 H�tel de Ville,8,8,16,2022,01-20,10:56
005 Corum,3,9,12,2022,01-20,10:56
006 Place Albert 1er - St Charles,13,18,31,2022,01-20,10:56
007 Foch,3,5,8,2022,01-20,10:56
008 Halles Castellane,8,4,12,2022,01-20,10:56
009 Observatoire,4,4,8,2022,01-20,10:56
010 Rondelet,5,11,16,2022,01-20,10:56
011 Plan Cabanes,2,10,12,2022,01-20,10:56
012 Boutonnet,10,2,12,2022,01-20,10:56
013 Emile Combes,3,5,8,2022,01-20,10:56
014 Beaux-Arts,2,6,8,2022,01-20,10:56
015 Les Aubes,4,4,8,2022,01-20,10:56
016 Antigone centre,6,10,16,2022,01-20,10:56
017 M�diath�que Emile Zola,8,8,16,2022,01-20,10:56
018 Nombre d'Or,7,9,16,2022,01-20,10:56
019 Louis Blanc,10,6,16,2022,01-20,10:56
020 Gambetta,6,2,8,2022,01-20,10:56
021 Port Marianne,4,12,16,2022,01-20,10:56
022 Clemenceau,8,4,12,2022,01-20,10:56
023 Les Arceaux,5,11,16,2022,01-20,10:56
024 Cit� Mion,3,5,8,2022,01-20,10:56
025 Nouveau Saint-Roch,5,3,8,2022,01-20,10:56
026 Renouvier,0,8,8,2022,01-20,10:56
027 Odysseum,0,8,8,2022,01-20,10:56
028 Saint-Denis,1,7,8,2022,01-20,10:56
029 Richter,16,0,16,2022,01-20,10:56
030 Charles Flahault,3,5,8,2022,01-20,10:56
031 Voltaire,1,7,8,2022,01-20,10:56
032 Pr�s d'Ar�nes,7,1,8,2022,01-20,10:56
033 Garcia Lorca,5,3,8,2022,01-20,10:56
034 Vert Bois,0,16,16,2022,01-20,10:56
035 Malbosc,3,5,8,2022,01-20,10:56
036 Occitanie,4,28,32,2022,01-20,10:56
037 FacdesSciences,6,18,24,2022,01-20,10:56
038 Fac de Lettres,2,14,16,2022,01-20,10:56
039 Aiguelongue,1,7,8,2022,01-20,10:56
040 Jeu de Mail des Abb�s,3,5,8,2022,01-20,10:56
041 Eurom�decine,2,6,8,2022,01-20,10:56
042 Marie Caizergues,4,4,8,2022,01-20,10:56
043 Sabines,4,4,8,2022,01-20,10:56
044 Celleneuve,2,6,8,2022,01-20,10:56
045 Jardin de la Lironde,3,5,8,2022,01-20,10:56
046 P�re Soulas,7,1,8,2022,01-20,10:56
047 Place Viala,2,6,8,2022,01-20,10:56
048 H�tel du D�partement,6,2,8,2022,01-20,10:56
049 Tonnelles,6,2,8,2022,01-20,10:56
050 Parvis Jules Ferry - Gare Saint-Roch,6,2,8,2022,01-20,10:56
051 Pont de Lattes - Gare Saint-Roch,2,10,12,2022,01-20,10:56
053 Deux Ponts - Gare Saint-Roch,1,7,8,2022,01-20,10:56
054 Providence - Ovalie,4,4,8,2022,01-20,10:56
055 P�rols Etang de l'Or,25,43,68,2022,01-20,10:56
056 Albert 1er - Cath�drale,1,11,12,2022,01-20,10:56
057 Saint-Guilhem - Courreau,4,4,8,2022,01-20,10:56
059 Sud De France,0,8,8,2022,01-20,10:56
001 Rue Jules Ferry - Gare Saint-Roch,5,7,12,2022,01-20,11:07
002 Com�die,19,5,24,2022,01-20,11:07
003 Esplanade,16,16,32,2022,01-20,11:07
004 H�tel de Ville,7,9,16,2022,01-20,11:07
005 Corum,3,9,12,2022,01-20,11:07
006 Place Albert 1er - St Charles,13,18,31,2022,01-20,11:07
007 Foch,3,5,8,2022,01-20,11:07
008 Halles Castellane,8,4,12,2022,01-20,11:07
009 Observatoire,4,4,8,2022,01-20,11:07
010 Rondelet,5,11,16,2022,01-20,11:07
011 Plan Cabanes,1,11,12,2022,01-20,11:07
012 Boutonnet,10,2,12,2022,01-20,11:07
013 Emile Combes,3,5,8,2022,01-20,11:07
014 Beaux-Arts,2,6,8,2022,01-20,11:07
015 Les Aubes,4,4,8,2022,01-20,11:07
016 Antigone centre,6,10,16,2022,01-20,11:07
017 M�diath�que Emile Zola,8,8,16,2022,01-20,11:07
018 Nombre d'Or,7,9,16,2022,01-20,11:07
019 Louis Blanc,10,6,16,2022,01-20,11:07
020 Gambetta,6,2,8,2022,01-20,11:07
021 Port Marianne,4,12,16,2022,01-20,11:07
022 Clemenceau,8,4,12,2022,01-20,11:07
023 Les Arceaux,5,11,16,2022,01-20,11:07
024 Cit� Mion,4,4,8,2022,01-20,11:07
025 Nouveau Saint-Roch,5,3,8,2022,01-20,11:07
026 Renouvier,2,6,8,2022,01-20,11:07
027 Odysseum,0,8,8,2022,01-20,11:07
028 Saint-Denis,1,7,8,2022,01-20,11:07
029 Richter,16,0,16,2022,01-20,11:07
030 Charles Flahault,3,5,8,2022,01-20,11:07
031 Voltaire,1,7,8,2022,01-20,11:07
032 Pr�s d'Ar�nes,7,1,8,2022,01-20,11:07
033 Garcia Lorca,6,2,8,2022,01-20,11:07
034 Vert Bois,0,16,16,2022,01-20,11:07
035 Malbosc,3,5,8,2022,01-20,11:07
036 Occitanie,4,28,32,2022,01-20,11:07
037 FacdesSciences,6,18,24,2022,01-20,11:07
038 Fac de Lettres,2,14,16,2022,01-20,11:07
039 Aiguelongue,1,7,8,2022,01-20,11:07
040 Jeu de Mail des Abb�s,3,5,8,2022,01-20,11:07
041 Eurom�decine,2,6,8,2022,01-20,11:07
042 Marie Caizergues,4,4,8,2022,01-20,11:07
043 Sabines,4,4,8,2022,01-20,11:07
044 Celleneuve,2,6,8,2022,01-20,11:07
045 Jardin de la Lironde,3,5,8,2022,01-20,11:07
046 P�re Soulas,7,1,8,2022,01-20,11:07
047 Place Viala,2,6,8,2022,01-20,11:07
048 H�tel du D�partement,6,2,8,2022,01-20,11:07
049 Tonnelles,6,2,8,2022,01-20,11:07
050 Parvis Jules Ferry - Gare Saint-Roch,6,2,8,2022,01-20,11:07
051 Pont de Lattes - Gare Saint-Roch,2,10,12,2022,01-20,11:07
053 Deux Ponts - Gare Saint-Roch,1,7,8,2022,01-20,11:07
054 Providence - Ovalie,4,4,8,2022,01-20,11:07
055 P�rols Etang de l'Or,25,43,68,2022,01-20,11:07
056 Albert 1er - Cath�drale,6,6,12,2022,01-20,11:07
057 Saint-Guilhem - Courreau,4,4,8,2022,01-20,11:07
059 Sud De France,0,8,8,2022,01-20,11:07
001 Rue Jules Ferry - Gare Saint-Roch,5,7,12,2022,01-20,11:17
002 Com�die,19,5,24,2022,01-20,11:17
003 Esplanade,16,16,32,2022,01-20,11:17
004 H�tel de Ville,7,9,16,2022,01-20,11:17
005 Corum,4,8,12,2022,01-20,11:17
006 Place Albert 1er - St Charles,13,18,31,2022,01-20,11:17
007 Foch,3,5,8,2022,01-20,11:17
008 Halles Castellane,7,5,12,2022,01-20,11:17
009 Observatoire,4,4,8,2022,01-20,11:17
010 Rondelet,5,11,16,2022,01-20,11:17
011 Plan Cabanes,1,11,12,2022,01-20,11:17
012 Boutonnet,10,2,12,2022,01-20,11:17
013 Emile Combes,3,5,8,2022,01-20,11:17
014 Beaux-Arts,2,6,8,2022,01-20,11:17
015 Les Aubes,4,4,8,2022,01-20,11:17
016 Antigone centre,6,10,16,2022,01-20,11:17
017 M�diath�que Emile Zola,8,8,16,2022,01-20,11:17
018 Nombre d'Or,7,9,16,2022,01-20,11:17
019 Louis Blanc,9,7,16,2022,01-20,11:17
020 Gambetta,5,3,8,2022,01-20,11:17
021 Port Marianne,4,12,16,2022,01-20,11:17
022 Clemenceau,8,4,12,2022,01-20,11:17
023 Les Arceaux,5,11,16,2022,01-20,11:17
024 Cit� Mion,4,4,8,2022,01-20,11:17
025 Nouveau Saint-Roch,5,3,8,2022,01-20,11:17
026 Renouvier,4,4,8,2022,01-20,11:17
027 Odysseum,0,8,8,2022,01-20,11:17
028 Saint-Denis,1,7,8,2022,01-20,11:17
029 Richter,16,0,16,2022,01-20,11:17
030 Charles Flahault,3,5,8,2022,01-20,11:17
031 Voltaire,1,7,8,2022,01-20,11:17
032 Pr�s d'Ar�nes,7,1,8,2022,01-20,11:17
033 Garcia Lorca,6,2,8,2022,01-20,11:17
034 Vert Bois,0,16,16,2022,01-20,11:17
035 Malbosc,3,5,8,2022,01-20,11:17
036 Occitanie,4,28,32,2022,01-20,11:17
037 FacdesSciences,6,18,24,2022,01-20,11:17
038 Fac de Lettres,2,14,16,2022,01-20,11:17
039 Aiguelongue,1,7,8,2022,01-20,11:17
040 Jeu de Mail des Abb�s,3,5,8,2022,01-20,11:17
041 Eurom�decine,2,6,8,2022,01-20,11:17
042 Marie Caizergues,4,4,8,2022,01-20,11:17
043 Sabines,4,4,8,2022,01-20,11:17
044 Celleneuve,2,6,8,2022,01-20,11:17
045 Jardin de la Lironde,3,5,8,2022,01-20,11:17
046 P�re Soulas,7,1,8,2022,01-20,11:17
047 Place Viala,2,6,8,2022,01-20,11:17
048 H�tel du D�partement,6,2,8,2022,01-20,11:17
049 Tonnelles,6,2,8,2022,01-20,11:17
050 Parvis Jules Ferry - Gare Saint-Roch,6,2,8,2022,01-20,11:17
051 Pont de Lattes - Gare Saint-Roch,2,10,12,2022,01-20,11:17
053 Deux Ponts - Gare Saint-Roch,1,7,8,2022,01-20,11:17
054 Providence - Ovalie,4,4,8,2022,01-20,11:17
055 P�rols Etang de l'Or,25,43,68,2022,01-20,11:17
056 Albert 1er - Cath�drale,6,6,12,2022,01-20,11:17
057 Saint-Guilhem - Courreau,4,4,8,2022,01-20,11:17
059 Sud De France,0,8,8,2022,01-20,11:17
001 Rue Jules Ferry - Gare Saint-Roch,5,7,12,2022,01-20,11:27
002 Com�die,19,5,24,2022,01-20,11:27
003 Esplanade,16,16,32,2022,01-20,11:27
004 H�tel de Ville,7,9,16,2022,01-20,11:27
005 Corum,4,8,12,2022,01-20,11:27
006 Place Albert 1er - St Charles,13,18,31,2022,01-20,11:27
007 Foch,3,5,8,2022,01-20,11:27
008 Halles Castellane,7,5,12,2022,01-20,11:27
009 Observatoire,5,3,8,2022,01-20,11:27
010 Rondelet,5,11,16,2022,01-20,11:27
011 Plan Cabanes,1,11,12,2022,01-20,11:27
012 Boutonnet,10,2,12,2022,01-20,11:27
013 Emile Combes,3,5,8,2022,01-20,11:27
014 Beaux-Arts,2,6,8,2022,01-20,11:27
015 Les Aubes,4,4,8,2022,01-20,11:27
016 Antigone centre,7,9,16,2022,01-20,11:27
017 M�diath�que Emile Zola,8,8,16,2022,01-20,11:27
018 Nombre d'Or,7,9,16,2022,01-20,11:27
019 Louis Blanc,9,7,16,2022,01-20,11:27
020 Gambetta,5,3,8,2022,01-20,11:27
021 Port Marianne,4,12,16,2022,01-20,11:27
022 Clemenceau,8,4,12,2022,01-20,11:27
023 Les Arceaux,5,11,16,2022,01-20,11:27
024 Cit� Mion,4,4,8,2022,01-20,11:27
025 Nouveau Saint-Roch,5,3,8,2022,01-20,11:27
026 Renouvier,4,4,8,2022,01-20,11:27
027 Odysseum,0,8,8,2022,01-20,11:27
028 Saint-Denis,1,7,8,2022,01-20,11:27
029 Richter,16,0,16,2022,01-20,11:27
030 Charles Flahault,3,5,8,2022,01-20,11:27
031 Voltaire,1,7,8,2022,01-20,11:27
032 Pr�s d'Ar�nes,7,1,8,2022,01-20,11:27
033 Garcia Lorca,6,2,8,2022,01-20,11:27
034 Vert Bois,0,16,16,2022,01-20,11:27
035 Malbosc,3,5,8,2022,01-20,11:27
036 Occitanie,4,28,32,2022,01-20,11:27
037 FacdesSciences,5,19,24,2022,01-20,11:27
038 Fac de Lettres,3,13,16,2022,01-20,11:27
039 Aiguelongue,1,7,8,2022,01-20,11:27
040 Jeu de Mail des Abb�s,3,5,8,2022,01-20,11:27
041 Eurom�decine,2,6,8,2022,01-20,11:27
042 Marie Caizergues,4,4,8,2022,01-20,11:27
043 Sabines,4,4,8,2022,01-20,11:27
044 Celleneuve,2,6,8,2022,01-20,11:27
045 Jardin de la Lironde,3,5,8,2022,01-20,11:27
046 P�re Soulas,7,1,8,2022,01-20,11:27
047 Place Viala,2,6,8,2022,01-20,11:27
048 H�tel du D�partement,6,2,8,2022,01-20,11:27
049 Tonnelles,6,2,8,2022,01-20,11:27
050 Parvis Jules Ferry - Gare Saint-Roch,6,2,8,2022,01-20,11:27
051 Pont de Lattes - Gare Saint-Roch,2,10,12,2022,01-20,11:27
053 Deux Ponts - Gare Saint-Roch,1,7,8,2022,01-20,11:27
054 Providence - Ovalie,4,4,8,2022,01-20,11:27
055 P�rols Etang de l'Or,25,43,68,2022,01-20,11:27
056 Albert 1er - Cath�drale,6,6,12,2022,01-20,11:27
057 Saint-Guilhem - Courreau,4,4,8,2022,01-20,11:27
059 Sud De France,0,8,8,2022,01-20,11:27
001 Rue Jules Ferry - Gare Saint-Roch,5,7,12,2022,01-20,11:37
002 Com�die,19,5,24,2022,01-20,11:37
003 Esplanade,16,16,32,2022,01-20,11:37
004 H�tel de Ville,7,9,16,2022,01-20,11:37
005 Corum,3,9,12,2022,01-20,11:37
006 Place Albert 1er - St Charles,13,18,31,2022,01-20,11:37
007 Foch,3,5,8,2022,01-20,11:37
008 Halles Castellane,7,5,12,2022,01-20,11:37
009 Observatoire,5,3,8,2022,01-20,11:37
010 Rondelet,5,11,16,2022,01-20,11:37
011 Plan Cabanes,1,11,12,2022,01-20,11:37
012 Boutonnet,10,2,12,2022,01-20,11:37
013 Emile Combes,3,5,8,2022,01-20,11:37
014 Beaux-Arts,2,6,8,2022,01-20,11:37
015 Les Aubes,4,4,8,2022,01-20,11:37
016 Antigone centre,7,9,16,2022,01-20,11:37
017 M�diath�que Emile Zola,8,8,16,2022,01-20,11:37
018 Nombre d'Or,7,9,16,2022,01-20,11:37
019 Louis Blanc,9,7,16,2022,01-20,11:37
020 Gambetta,5,3,8,2022,01-20,11:37
021 Port Marianne,5,11,16,2022,01-20,11:37
022 Clemenceau,8,4,12,2022,01-20,11:37
023 Les Arceaux,5,11,16,2022,01-20,11:37
024 Cit� Mion,4,4,8,2022,01-20,11:37
025 Nouveau Saint-Roch,5,3,8,2022,01-20,11:37
026 Renouvier,4,4,8,2022,01-20,11:37
027 Odysseum,0,8,8,2022,01-20,11:37
028 Saint-Denis,1,7,8,2022,01-20,11:37
029 Richter,15,1,16,2022,01-20,11:37
030 Charles Flahault,3,5,8,2022,01-20,11:37
031 Voltaire,1,7,8,2022,01-20,11:37
032 Pr�s d'Ar�nes,7,1,8,2022,01-20,11:37
033 Garcia Lorca,6,2,8,2022,01-20,11:37
034 Vert Bois,0,16,16,2022,01-20,11:37
035 Malbosc,3,5,8,2022,01-20,11:37
036 Occitanie,4,28,32,2022,01-20,11:37
037 FacdesSciences,5,19,24,2022,01-20,11:37
038 Fac de Lettres,3,13,16,2022,01-20,11:37
039 Aiguelongue,1,7,8,2022,01-20,11:37
040 Jeu de Mail des Abb�s,3,5,8,2022,01-20,11:37
041 Eurom�decine,2,6,8,2022,01-20,11:37
042 Marie Caizergues,3,5,8,2022,01-20,11:37
043 Sabines,4,4,8,2022,01-20,11:37
044 Celleneuve,2,6,8,2022,01-20,11:37
045 Jardin de la Lironde,3,5,8,2022,01-20,11:37
046 P�re Soulas,7,1,8,2022,01-20,11:37
047 Place Viala,2,6,8,2022,01-20,11:37
048 H�tel du D�partement,6,2,8,2022,01-20,11:37
049 Tonnelles,6,2,8,2022,01-20,11:37
050 Parvis Jules Ferry - Gare Saint-Roch,6,2,8,2022,01-20,11:37
051 Pont de Lattes - Gare Saint-Roch,2,10,12,2022,01-20,11:37
053 Deux Ponts - Gare Saint-Roch,1,7,8,2022,01-20,11:37
054 Providence - Ovalie,4,4,8,2022,01-20,11:37
055 P�rols Etang de l'Or,25,43,68,2022,01-20,11:37
056 Albert 1er - Cath�drale,6,6,12,2022,01-20,11:37
057 Saint-Guilhem - Courreau,4,4,8,2022,01-20,11:37
059 Sud De France,0,8,8,2022,01-20,11:37
001 Rue Jules Ferry - Gare Saint-Roch,5,7,12,2022,01-20,11:47
002 Com�die,19,5,24,2022,01-20,11:47
003 Esplanade,16,16,32,2022,01-20,11:47
004 H�tel de Ville,7,9,16,2022,01-20,11:47
005 Corum,3,9,12,2022,01-20,11:47
006 Place Albert 1er - St Charles,13,18,31,2022,01-20,11:47
007 Foch,3,5,8,2022,01-20,11:47
008 Halles Castellane,7,5,12,2022,01-20,11:47
009 Observatoire,5,3,8,2022,01-20,11:47
010 Rondelet,5,11,16,2022,01-20,11:47
011 Plan Cabanes,1,11,12,2022,01-20,11:47
012 Boutonnet,10,2,12,2022,01-20,11:47
013 Emile Combes,3,5,8,2022,01-20,11:47
014 Beaux-Arts,2,6,8,2022,01-20,11:47
015 Les Aubes,4,4,8,2022,01-20,11:47
016 Antigone centre,7,9,16,2022,01-20,11:47
017 M�diath�que Emile Zola,8,8,16,2022,01-20,11:47
018 Nombre d'Or,7,9,16,2022,01-20,11:47
019 Louis Blanc,9,7,16,2022,01-20,11:47
020 Gambetta,5,3,8,2022,01-20,11:47
021 Port Marianne,5,11,16,2022,01-20,11:47
022 Clemenceau,8,4,12,2022,01-20,11:47
023 Les Arceaux,5,11,16,2022,01-20,11:47
024 Cit� Mion,4,4,8,2022,01-20,11:47
025 Nouveau Saint-Roch,5,3,8,2022,01-20,11:47
026 Renouvier,4,4,8,2022,01-20,11:47
027 Odysseum,0,8,8,2022,01-20,11:47
028 Saint-Denis,1,7,8,2022,01-20,11:47
029 Richter,14,2,16,2022,01-20,11:47
030 Charles Flahault,3,5,8,2022,01-20,11:47
031 Voltaire,1,7,8,2022,01-20,11:47
032 Pr�s d'Ar�nes,7,1,8,2022,01-20,11:47
033 Garcia Lorca,6,2,8,2022,01-20,11:47
034 Vert Bois,0,16,16,2022,01-20,11:47
035 Malbosc,3,5,8,2022,01-20,11:47
036 Occitanie,3,29,32,2022,01-20,11:47
037 FacdesSciences,5,19,24,2022,01-20,11:47
038 Fac de Lettres,3,13,16,2022,01-20,11:47
039 Aiguelongue,1,7,8,2022,01-20,11:47
040 Jeu de Mail des Abb�s,3,5,8,2022,01-20,11:47
041 Eurom�decine,3,5,8,2022,01-20,11:47
042 Marie Caizergues,4,4,8,2022,01-20,11:47
043 Sabines,4,4,8,2022,01-20,11:47
044 Celleneuve,2,6,8,2022,01-20,11:47
045 Jardin de la Lironde,3,5,8,2022,01-20,11:47
046 P�re Soulas,7,1,8,2022,01-20,11:47
047 Place Viala,2,6,8,2022,01-20,11:47
048 H�tel du D�partement,6,2,8,2022,01-20,11:47
049 Tonnelles,6,2,8,2022,01-20,11:47
050 Parvis Jules Ferry - Gare Saint-Roch,6,2,8,2022,01-20,11:47
051 Pont de Lattes - Gare Saint-Roch,2,10,12,2022,01-20,11:47
053 Deux Ponts - Gare Saint-Roch,1,7,8,2022,01-20,11:47
054 Providence - Ovalie,4,4,8,2022,01-20,11:47
055 P�rols Etang de l'Or,25,43,68,2022,01-20,11:47
056 Albert 1er - Cath�drale,6,6,12,2022,01-20,11:47
057 Saint-Guilhem - Courreau,4,4,8,2022,01-20,11:47
059 Sud De France,0,8,8,2022,01-20,11:47
001 Rue Jules Ferry - Gare Saint-Roch,5,7,12,2022,01-20,11:57
002 Com�die,19,5,24,2022,01-20,11:57
003 Esplanade,15,17,32,2022,01-20,11:57
004 H�tel de Ville,7,9,16,2022,01-20,11:57
005 Corum,3,9,12,2022,01-20,11:57
006 Place Albert 1er - St Charles,13,18,31,2022,01-20,11:57
007 Foch,3,5,8,2022,01-20,11:57
008 Halles Castellane,7,5,12,2022,01-20,11:57
009 Observatoire,5,3,8,2022,01-20,11:57
010 Rondelet,5,11,16,2022,01-20,11:57
011 Plan Cabanes,1,11,12,2022,01-20,11:57
012 Boutonnet,10,2,12,2022,01-20,11:57
013 Emile Combes,4,4,8,2022,01-20,11:57
014 Beaux-Arts,2,6,8,2022,01-20,11:57
015 Les Aubes,4,4,8,2022,01-20,11:57
016 Antigone centre,7,9,16,2022,01-20,11:57
017 M�diath�que Emile Zola,8,8,16,2022,01-20,11:57
018 Nombre d'Or,7,9,16,2022,01-20,11:57
019 Louis Blanc,9,7,16,2022,01-20,11:57
020 Gambetta,5,3,8,2022,01-20,11:57
021 Port Marianne,5,11,16,2022,01-20,11:57
022 Clemenceau,8,4,12,2022,01-20,11:57
023 Les Arceaux,5,11,16,2022,01-20,11:57
024 Cit� Mion,4,4,8,2022,01-20,11:57
025 Nouveau Saint-Roch,5,3,8,2022,01-20,11:57
026 Renouvier,4,4,8,2022,01-20,11:57
027 Odysseum,0,8,8,2022,01-20,11:57
028 Saint-Denis,1,7,8,2022,01-20,11:57
029 Richter,10,6,16,2022,01-20,11:57
030 Charles Flahault,3,5,8,2022,01-20,11:57
031 Voltaire,1,7,8,2022,01-20,11:57
032 Pr�s d'Ar�nes,7,1,8,2022,01-20,11:57
033 Garcia Lorca,7,1,8,2022,01-20,11:57
034 Vert Bois,0,16,16,2022,01-20,11:57
035 Malbosc,3,5,8,2022,01-20,11:57
036 Occitanie,2,30,32,2022,01-20,11:57
037 FacdesSciences,5,19,24,2022,01-20,11:57
038 Fac de Lettres,3,13,16,2022,01-20,11:57
039 Aiguelongue,1,7,8,2022,01-20,11:57
040 Jeu de Mail des Abb�s,2,6,8,2022,01-20,11:57
041 Eurom�decine,3,5,8,2022,01-20,11:57
042 Marie Caizergues,4,4,8,2022,01-20,11:57
043 Sabines,4,4,8,2022,01-20,11:57
044 Celleneuve,2,6,8,2022,01-20,11:57
045 Jardin de la Lironde,3,5,8,2022,01-20,11:57
046 P�re Soulas,7,1,8,2022,01-20,11:57
047 Place Viala,2,6,8,2022,01-20,11:57
048 H�tel du D�partement,6,2,8,2022,01-20,11:57
049 Tonnelles,6,2,8,2022,01-20,11:57
050 Parvis Jules Ferry - Gare Saint-Roch,6,2,8,2022,01-20,11:57
051 Pont de Lattes - Gare Saint-Roch,2,10,12,2022,01-20,11:57
053 Deux Ponts - Gare Saint-Roch,1,7,8,2022,01-20,11:57
054 Providence - Ovalie,4,4,8,2022,01-20,11:57
055 P�rols Etang de l'Or,25,43,68,2022,01-20,11:57
056 Albert 1er - Cath�drale,6,6,12,2022,01-20,11:57
057 Saint-Guilhem - Courreau,4,4,8,2022,01-20,11:57
059 Sud De France,0,8,8,2022,01-20,11:57
001 Rue Jules Ferry - Gare Saint-Roch,5,7,12,2022,01-20,12:07
002 Com�die,19,5,24,2022,01-20,12:07
003 Esplanade,15,17,32,2022,01-20,12:07
004 H�tel de Ville,7,9,16,2022,01-20,12:07
005 Corum,3,9,12,2022,01-20,12:07
006 Place Albert 1er - St Charles,13,18,31,2022,01-20,12:07
007 Foch,2,6,8,2022,01-20,12:07
008 Halles Castellane,7,5,12,2022,01-20,12:07
009 Observatoire,5,3,8,2022,01-20,12:07
010 Rondelet,5,11,16,2022,01-20,12:07
011 Plan Cabanes,1,11,12,2022,01-20,12:07
012 Boutonnet,10,2,12,2022,01-20,12:07
013 Emile Combes,4,4,8,2022,01-20,12:07
014 Beaux-Arts,2,6,8,2022,01-20,12:07
015 Les Aubes,4,4,8,2022,01-20,12:07
016 Antigone centre,8,8,16,2022,01-20,12:07
017 M�diath�que Emile Zola,8,8,16,2022,01-20,12:07
018 Nombre d'Or,7,9,16,2022,01-20,12:07
019 Louis Blanc,9,7,16,2022,01-20,12:07
020 Gambetta,4,4,8,2022,01-20,12:07
021 Port Marianne,5,11,16,2022,01-20,12:07
022 Clemenceau,8,4,12,2022,01-20,12:07
023 Les Arceaux,5,11,16,2022,01-20,12:07
024 Cit� Mion,4,4,8,2022,01-20,12:07
025 Nouveau Saint-Roch,4,4,8,2022,01-20,12:07
026 Renouvier,4,4,8,2022,01-20,12:07
027 Odysseum,0,8,8,2022,01-20,12:07
028 Saint-Denis,1,7,8,2022,01-20,12:07
029 Richter,7,9,16,2022,01-20,12:07
030 Charles Flahault,3,5,8,2022,01-20,12:07
031 Voltaire,1,7,8,2022,01-20,12:07
032 Pr�s d'Ar�nes,8,0,8,2022,01-20,12:07
033 Garcia Lorca,7,1,8,2022,01-20,12:07
034 Vert Bois,0,16,16,2022,01-20,12:07
035 Malbosc,2,6,8,2022,01-20,12:07
036 Occitanie,2,30,32,2022,01-20,12:07
037 FacdesSciences,5,19,24,2022,01-20,12:07
038 Fac de Lettres,3,13,16,2022,01-20,12:07
039 Aiguelongue,1,7,8,2022,01-20,12:07
040 Jeu de Mail des Abb�s,2,6,8,2022,01-20,12:07
041 Eurom�decine,3,5,8,2022,01-20,12:07
042 Marie Caizergues,4,4,8,2022,01-20,12:07
043 Sabines,4,4,8,2022,01-20,12:07
044 Celleneuve,2,6,8,2022,01-20,12:07
045 Jardin de la Lironde,3,5,8,2022,01-20,12:07
046 P�re Soulas,7,1,8,2022,01-20,12:07
047 Place Viala,2,6,8,2022,01-20,12:07
048 H�tel du D�partement,6,2,8,2022,01-20,12:07
049 Tonnelles,6,2,8,2022,01-20,12:07
050 Parvis Jules Ferry - Gare Saint-Roch,6,2,8,2022,01-20,12:07
051 Pont de Lattes - Gare Saint-Roch,2,10,12,2022,01-20,12:07
053 Deux Ponts - Gare Saint-Roch,1,7,8,2022,01-20,12:07
054 Providence - Ovalie,4,4,8,2022,01-20,12:07
055 P�rols Etang de l'Or,25,43,68,2022,01-20,12:07
056 Albert 1er - Cath�drale,6,6,12,2022,01-20,12:07
057 Saint-Guilhem - Courreau,4,4,8,2022,01-20,12:07
059 Sud De France,0,8,8,2022,01-20,12:07
001 Rue Jules Ferry - Gare Saint-Roch,6,6,12,2022,01-20,12:18
002 Com�die,19,5,24,2022,01-20,12:18
003 Esplanade,15,17,32,2022,01-20,12:18
004 H�tel de Ville,7,9,16,2022,01-20,12:18
005 Corum,3,9,12,2022,01-20,12:18
006 Place Albert 1er - St Charles,13,18,31,2022,01-20,12:18
007 Foch,2,6,8,2022,01-20,12:18
008 Halles Castellane,7,5,12,2022,01-20,12:18
009 Observatoire,5,3,8,2022,01-20,12:18
010 Rondelet,5,11,16,2022,01-20,12:18
011 Plan Cabanes,1,11,12,2022,01-20,12:18
012 Boutonnet,9,3,12,2022,01-20,12:18
013 Emile Combes,4,4,8,2022,01-20,12:18
014 Beaux-Arts,2,6,8,2022,01-20,12:18
015 Les Aubes,4,4,8,2022,01-20,12:18
016 Antigone centre,8,8,16,2022,01-20,12:18
017 M�diath�que Emile Zola,8,8,16,2022,01-20,12:18
018 Nombre d'Or,7,9,16,2022,01-20,12:18
019 Louis Blanc,9,7,16,2022,01-20,12:18
020 Gambetta,4,4,8,2022,01-20,12:18
021 Port Marianne,5,11,16,2022,01-20,12:18
022 Clemenceau,7,5,12,2022,01-20,12:18
023 Les Arceaux,5,11,16,2022,01-20,12:18
024 Cit� Mion,4,4,8,2022,01-20,12:18
025 Nouveau Saint-Roch,4,4,8,2022,01-20,12:18
026 Renouvier,4,4,8,2022,01-20,12:18
027 Odysseum,3,5,8,2022,01-20,12:18
028 Saint-Denis,1,7,8,2022,01-20,12:18
029 Richter,7,9,16,2022,01-20,12:18
030 Charles Flahault,3,5,8,2022,01-20,12:18
031 Voltaire,2,6,8,2022,01-20,12:18
032 Pr�s d'Ar�nes,8,0,8,2022,01-20,12:18
033 Garcia Lorca,7,1,8,2022,01-20,12:18
034 Vert Bois,0,16,16,2022,01-20,12:18
035 Malbosc,1,7,8,2022,01-20,12:18
036 Occitanie,2,30,32,2022,01-20,12:18
037 FacdesSciences,5,19,24,2022,01-20,12:18
038 Fac de Lettres,3,13,16,2022,01-20,12:18
039 Aiguelongue,1,7,8,2022,01-20,12:18
040 Jeu de Mail des Abb�s,2,6,8,2022,01-20,12:18
041 Eurom�decine,3,5,8,2022,01-20,12:18
042 Marie Caizergues,4,4,8,2022,01-20,12:18
043 Sabines,4,4,8,2022,01-20,12:18
044 Celleneuve,2,6,8,2022,01-20,12:18
045 Jardin de la Lironde,3,5,8,2022,01-20,12:18
046 P�re Soulas,8,0,8,2022,01-20,12:18
047 Place Viala,2,6,8,2022,01-20,12:18
048 H�tel du D�partement,6,2,8,2022,01-20,12:18
049 Tonnelles,6,2,8,2022,01-20,12:18
050 Parvis Jules Ferry - Gare Saint-Roch,6,2,8,2022,01-20,12:18
051 Pont de Lattes - Gare Saint-Roch,2,10,12,2022,01-20,12:18
053 Deux Ponts - Gare Saint-Roch,1,7,8,2022,01-20,12:18
054 Providence - Ovalie,4,4,8,2022,01-20,12:18
055 P�rols Etang de l'Or,22,46,68,2022,01-20,12:18
056 Albert 1er - Cath�drale,6,6,12,2022,01-20,12:18
057 Saint-Guilhem - Courreau,4,4,8,2022,01-20,12:18
059 Sud De France,4,4,8,2022,01-20,12:18
001 Rue Jules Ferry - Gare Saint-Roch,6,6,12,2022,01-20,12:28
002 Com�die,18,6,24,2022,01-20,12:28
003 Esplanade,15,17,32,2022,01-20,12:28
004 H�tel de Ville,7,9,16,2022,01-20,12:28
005 Corum,3,9,12,2022,01-20,12:28
006 Place Albert 1er - St Charles,13,18,31,2022,01-20,12:28
007 Foch,2,6,8,2022,01-20,12:28
008 Halles Castellane,7,5,12,2022,01-20,12:28
009 Observatoire,5,3,8,2022,01-20,12:28
010 Rondelet,5,11,16,2022,01-20,12:28
011 Plan Cabanes,2,10,12,2022,01-20,12:28
012 Boutonnet,9,3,12,2022,01-20,12:28
013 Emile Combes,4,4,8,2022,01-20,12:28
014 Beaux-Arts,2,6,8,2022,01-20,12:28
015 Les Aubes,4,4,8,2022,01-20,12:28
016 Antigone centre,8,8,16,2022,01-20,12:28
017 M�diath�que Emile Zola,8,8,16,2022,01-20,12:28
018 Nombre d'Or,7,9,16,2022,01-20,12:28
019 Louis Blanc,10,6,16,2022,01-20,12:28
020 Gambetta,4,4,8,2022,01-20,12:28
021 Port Marianne,7,9,16,2022,01-20,12:28
022 Clemenceau,7,5,12,2022,01-20,12:28
023 Les Arceaux,5,11,16,2022,01-20,12:28
024 Cit� Mion,3,5,8,2022,01-20,12:28
025 Nouveau Saint-Roch,4,4,8,2022,01-20,12:28
026 Renouvier,4,4,8,2022,01-20,12:28
027 Odysseum,3,5,8,2022,01-20,12:28
028 Saint-Denis,1,7,8,2022,01-20,12:28
029 Richter,7,9,16,2022,01-20,12:28
030 Charles Flahault,2,6,8,2022,01-20,12:28
031 Voltaire,2,6,8,2022,01-20,12:28
032 Pr�s d'Ar�nes,8,0,8,2022,01-20,12:28
033 Garcia Lorca,7,1,8,2022,01-20,12:28
034 Vert Bois,0,16,16,2022,01-20,12:28
035 Malbosc,1,7,8,2022,01-20,12:28
036 Occitanie,2,30,32,2022,01-20,12:28
037 FacdesSciences,5,19,24,2022,01-20,12:28
038 Fac de Lettres,3,13,16,2022,01-20,12:28
039 Aiguelongue,1,7,8,2022,01-20,12:28
040 Jeu de Mail des Abb�s,2,6,8,2022,01-20,12:28
041 Eurom�decine,3,5,8,2022,01-20,12:28
042 Marie Caizergues,4,4,8,2022,01-20,12:28
043 Sabines,4,4,8,2022,01-20,12:28
044 Celleneuve,2,6,8,2022,01-20,12:28
045 Jardin de la Lironde,3,5,8,2022,01-20,12:28
046 P�re Soulas,8,0,8,2022,01-20,12:28
047 Place Viala,2,6,8,2022,01-20,12:28
048 H�tel du D�partement,6,2,8,2022,01-20,12:28
049 Tonnelles,6,2,8,2022,01-20,12:28
050 Parvis Jules Ferry - Gare Saint-Roch,6,2,8,2022,01-20,12:28
051 Pont de Lattes - Gare Saint-Roch,2,10,12,2022,01-20,12:28
053 Deux Ponts - Gare Saint-Roch,1,7,8,2022,01-20,12:28
054 Providence - Ovalie,4,4,8,2022,01-20,12:28
055 P�rols Etang de l'Or,22,46,68,2022,01-20,12:28
056 Albert 1er - Cath�drale,6,6,12,2022,01-20,12:28
057 Saint-Guilhem - Courreau,4,4,8,2022,01-20,12:28
059 Sud De France,4,4,8,2022,01-20,12:28
001 Rue Jules Ferry - Gare Saint-Roch,6,6,12,2022,01-20,12:38
002 Com�die,18,6,24,2022,01-20,12:38
003 Esplanade,15,17,32,2022,01-20,12:38
004 H�tel de Ville,7,9,16,2022,01-20,12:38
005 Corum,3,9,12,2022,01-20,12:38
006 Place Albert 1er - St Charles,13,18,31,2022,01-20,12:38
007 Foch,2,6,8,2022,01-20,12:38
008 Halles Castellane,8,4,12,2022,01-20,12:38
009 Observatoire,5,3,8,2022,01-20,12:38
010 Rondelet,5,11,16,2022,01-20,12:38
011 Plan Cabanes,2,10,12,2022,01-20,12:38
012 Boutonnet,8,4,12,2022,01-20,12:38
013 Emile Combes,4,4,8,2022,01-20,12:38
014 Beaux-Arts,2,6,8,2022,01-20,12:38
015 Les Aubes,4,4,8,2022,01-20,12:38
016 Antigone centre,8,8,16,2022,01-20,12:38
017 M�diath�que Emile Zola,8,8,16,2022,01-20,12:38
018 Nombre d'Or,7,9,16,2022,01-20,12:38
019 Louis Blanc,10,6,16,2022,01-20,12:38
020 Gambetta,4,4,8,2022,01-20,12:38
021 Port Marianne,7,9,16,2022,01-20,12:38
022 Clemenceau,7,5,12,2022,01-20,12:38
023 Les Arceaux,5,11,16,2022,01-20,12:38
024 Cit� Mion,3,5,8,2022,01-20,12:38
025 Nouveau Saint-Roch,3,5,8,2022,01-20,12:38
026 Renouvier,4,4,8,2022,01-20,12:38
027 Odysseum,3,5,8,2022,01-20,12:38
028 Saint-Denis,1,7,8,2022,01-20,12:38
029 Richter,8,8,16,2022,01-20,12:38
030 Charles Flahault,2,6,8,2022,01-20,12:38
031 Voltaire,1,7,8,2022,01-20,12:38
032 Pr�s d'Ar�nes,8,0,8,2022,01-20,12:38
033 Garcia Lorca,7,1,8,2022,01-20,12:38
034 Vert Bois,0,16,16,2022,01-20,12:38
035 Malbosc,1,7,8,2022,01-20,12:38
036 Occitanie,2,30,32,2022,01-20,12:38
037 FacdesSciences,5,19,24,2022,01-20,12:38
038 Fac de Lettres,3,13,16,2022,01-20,12:38
039 Aiguelongue,1,7,8,2022,01-20,12:38
040 Jeu de Mail des Abb�s,2,6,8,2022,01-20,12:38
041 Eurom�decine,3,5,8,2022,01-20,12:38
042 Marie Caizergues,4,4,8,2022,01-20,12:38
043 Sabines,4,4,8,2022,01-20,12:38
044 Celleneuve,2,6,8,2022,01-20,12:38
045 Jardin de la Lironde,3,5,8,2022,01-20,12:38
046 P�re Soulas,8,0,8,2022,01-20,12:38
047 Place Viala,2,6,8,2022,01-20,12:38
048 H�tel du D�partement,6,2,8,2022,01-20,12:38
049 Tonnelles,6,2,8,2022,01-20,12:38
050 Parvis Jules Ferry - Gare Saint-Roch,6,2,8,2022,01-20,12:38
051 Pont de Lattes - Gare Saint-Roch,1,11,12,2022,01-20,12:38
053 Deux Ponts - Gare Saint-Roch,1,7,8,2022,01-20,12:38
054 Providence - Ovalie,5,3,8,2022,01-20,12:38
055 P�rols Etang de l'Or,22,46,68,2022,01-20,12:38
056 Albert 1er - Cath�drale,6,6,12,2022,01-20,12:38
057 Saint-Guilhem - Courreau,4,4,8,2022,01-20,12:38
059 Sud De France,4,4,8,2022,01-20,12:38
001 Rue Jules Ferry - Gare Saint-Roch,6,6,12,2022,01-20,12:48
002 Com�die,18,6,24,2022,01-20,12:48
003 Esplanade,15,17,32,2022,01-20,12:48
004 H�tel de Ville,7,9,16,2022,01-20,12:48
005 Corum,3,9,12,2022,01-20,12:48
006 Place Albert 1er - St Charles,14,17,31,2022,01-20,12:48
007 Foch,2,6,8,2022,01-20,12:48
008 Halles Castellane,8,4,12,2022,01-20,12:48
009 Observatoire,6,2,8,2022,01-20,12:48
010 Rondelet,4,12,16,2022,01-20,12:48
011 Plan Cabanes,3,9,12,2022,01-20,12:48
012 Boutonnet,7,5,12,2022,01-20,12:48
013 Emile Combes,5,3,8,2022,01-20,12:48
014 Beaux-Arts,2,6,8,2022,01-20,12:48
015 Les Aubes,4,4,8,2022,01-20,12:48
016 Antigone centre,7,9,16,2022,01-20,12:48
017 M�diath�que Emile Zola,8,8,16,2022,01-20,12:48
018 Nombre d'Or,7,9,16,2022,01-20,12:48
019 Louis Blanc,10,6,16,2022,01-20,12:48
020 Gambetta,4,4,8,2022,01-20,12:48
021 Port Marianne,6,10,16,2022,01-20,12:48
022 Clemenceau,7,5,12,2022,01-20,12:48
023 Les Arceaux,5,11,16,2022,01-20,12:48
024 Cit� Mion,3,5,8,2022,01-20,12:48
025 Nouveau Saint-Roch,3,5,8,2022,01-20,12:48
026 Renouvier,4,4,8,2022,01-20,12:48
027 Odysseum,3,5,8,2022,01-20,12:48
028 Saint-Denis,1,7,8,2022,01-20,12:48
029 Richter,8,8,16,2022,01-20,12:48
030 Charles Flahault,2,6,8,2022,01-20,12:48
031 Voltaire,1,7,8,2022,01-20,12:48
032 Pr�s d'Ar�nes,8,0,8,2022,01-20,12:48
033 Garcia Lorca,6,2,8,2022,01-20,12:48
034 Vert Bois,0,16,16,2022,01-20,12:48
035 Malbosc,1,7,8,2022,01-20,12:48
036 Occitanie,1,31,32,2022,01-20,12:48
037 FacdesSciences,3,21,24,2022,01-20,12:48
038 Fac de Lettres,2,14,16,2022,01-20,12:48
039 Aiguelongue,1,7,8,2022,01-20,12:48
040 Jeu de Mail des Abb�s,2,6,8,2022,01-20,12:48
041 Eurom�decine,3,5,8,2022,01-20,12:48
042 Marie Caizergues,4,4,8,2022,01-20,12:48
043 Sabines,4,4,8,2022,01-20,12:48
044 Celleneuve,2,6,8,2022,01-20,12:48
045 Jardin de la Lironde,3,5,8,2022,01-20,12:48
046 P�re Soulas,6,2,8,2022,01-20,12:48
047 Place Viala,2,6,8,2022,01-20,12:48
048 H�tel du D�partement,6,2,8,2022,01-20,12:48
049 Tonnelles,6,2,8,2022,01-20,12:48
050 Parvis Jules Ferry - Gare Saint-Roch,6,2,8,2022,01-20,12:48
051 Pont de Lattes - Gare Saint-Roch,1,11,12,2022,01-20,12:48
053 Deux Ponts - Gare Saint-Roch,1,7,8,2022,01-20,12:48
054 Providence - Ovalie,5,3,8,2022,01-20,12:48
055 P�rols Etang de l'Or,22,46,68,2022,01-20,12:48
056 Albert 1er - Cath�drale,6,6,12,2022,01-20,12:48
057 Saint-Guilhem - Courreau,4,4,8,2022,01-20,12:48
059 Sud De France,3,5,8,2022,01-20,12:48
001 Rue Jules Ferry - Gare Saint-Roch,6,6,12,2022,01-20,12:58
002 Com�die,18,6,24,2022,01-20,12:58
003 Esplanade,15,17,32,2022,01-20,12:58
004 H�tel de Ville,7,9,16,2022,01-20,12:58
005 Corum,2,10,12,2022,01-20,12:58
006 Place Albert 1er - St Charles,14,17,31,2022,01-20,12:58
007 Foch,4,4,8,2022,01-20,12:58
008 Halles Castellane,8,4,12,2022,01-20,12:58
009 Observatoire,6,2,8,2022,01-20,12:58
010 Rondelet,4,12,16,2022,01-20,12:58
011 Plan Cabanes,3,9,12,2022,01-20,12:58
012 Boutonnet,7,5,12,2022,01-20,12:58
013 Emile Combes,5,3,8,2022,01-20,12:58
014 Beaux-Arts,2,6,8,2022,01-20,12:58
015 Les Aubes,3,5,8,2022,01-20,12:58
016 Antigone centre,7,9,16,2022,01-20,12:58
017 M�diath�que Emile Zola,8,8,16,2022,01-20,12:58
018 Nombre d'Or,8,8,16,2022,01-20,12:58
019 Louis Blanc,9,7,16,2022,01-20,12:58
020 Gambetta,4,4,8,2022,01-20,12:58
021 Port Marianne,6,10,16,2022,01-20,12:58
022 Clemenceau,7,5,12,2022,01-20,12:58
023 Les Arceaux,3,13,16,2022,01-20,12:58
024 Cit� Mion,3,5,8,2022,01-20,12:58
025 Nouveau Saint-Roch,3,5,8,2022,01-20,12:58
026 Renouvier,3,5,8,2022,01-20,12:58
027 Odysseum,3,5,8,2022,01-20,12:58
028 Saint-Denis,1,7,8,2022,01-20,12:58
029 Richter,7,9,16,2022,01-20,12:58
030 Charles Flahault,2,6,8,2022,01-20,12:58
031 Voltaire,1,7,8,2022,01-20,12:58
032 Pr�s d'Ar�nes,8,0,8,2022,01-20,12:58
033 Garcia Lorca,6,2,8,2022,01-20,12:58
034 Vert Bois,0,16,16,2022,01-20,12:58
035 Malbosc,1,7,8,2022,01-20,12:58
036 Occitanie,0,32,32,2022,01-20,12:58
037 FacdesSciences,4,20,24,2022,01-20,12:58
038 Fac de Lettres,2,14,16,2022,01-20,12:58
039 Aiguelongue,1,7,8,2022,01-20,12:58
040 Jeu de Mail des Abb�s,2,6,8,2022,01-20,12:58
041 Eurom�decine,3,5,8,2022,01-20,12:58
042 Marie Caizergues,4,4,8,2022,01-20,12:58
043 Sabines,4,4,8,2022,01-20,12:58
044 Celleneuve,2,6,8,2022,01-20,12:58
045 Jardin de la Lironde,3,5,8,2022,01-20,12:58
046 P�re Soulas,6,2,8,2022,01-20,12:58
047 Place Viala,2,6,8,2022,01-20,12:58
048 H�tel du D�partement,6,2,8,2022,01-20,12:58
049 Tonnelles,6,2,8,2022,01-20,12:58
050 Parvis Jules Ferry - Gare Saint-Roch,6,2,8,2022,01-20,12:58
051 Pont de Lattes - Gare Saint-Roch,1,11,12,2022,01-20,12:58
053 Deux Ponts - Gare Saint-Roch,1,7,8,2022,01-20,12:58
054 Providence - Ovalie,5,3,8,2022,01-20,12:58
055 P�rols Etang de l'Or,22,46,68,2022,01-20,12:58
056 Albert 1er - Cath�drale,6,6,12,2022,01-20,12:58
057 Saint-Guilhem - Courreau,5,3,8,2022,01-20,12:58
059 Sud De France,3,5,8,2022,01-20,12:58
001 Rue Jules Ferry - Gare Saint-Roch,6,6,12,2022,01-20,13:08
002 Com�die,18,6,24,2022,01-20,13:08
003 Esplanade,14,18,32,2022,01-20,13:08
004 H�tel de Ville,7,9,16,2022,01-20,13:08
005 Corum,2,10,12,2022,01-20,13:08
006 Place Albert 1er - St Charles,15,16,31,2022,01-20,13:08
007 Foch,4,4,8,2022,01-20,13:08
008 Halles Castellane,8,4,12,2022,01-20,13:08
009 Observatoire,7,1,8,2022,01-20,13:08
010 Rondelet,4,12,16,2022,01-20,13:08
011 Plan Cabanes,3,9,12,2022,01-20,13:08
012 Boutonnet,8,4,12,2022,01-20,13:08
013 Emile Combes,6,2,8,2022,01-20,13:08
014 Beaux-Arts,2,6,8,2022,01-20,13:08
015 Les Aubes,3,5,8,2022,01-20,13:08
016 Antigone centre,7,9,16,2022,01-20,13:08
017 M�diath�que Emile Zola,8,8,16,2022,01-20,13:08
018 Nombre d'Or,9,7,16,2022,01-20,13:08
019 Louis Blanc,9,7,16,2022,01-20,13:08
020 Gambetta,4,4,8,2022,01-20,13:08
021 Port Marianne,6,10,16,2022,01-20,13:08
022 Clemenceau,7,5,12,2022,01-20,13:08
023 Les Arceaux,3,13,16,2022,01-20,13:08
024 Cit� Mion,3,5,8,2022,01-20,13:08
025 Nouveau Saint-Roch,3,5,8,2022,01-20,13:08
026 Renouvier,3,5,8,2022,01-20,13:08
027 Odysseum,3,5,8,2022,01-20,13:08
028 Saint-Denis,1,7,8,2022,01-20,13:08
029 Richter,8,8,16,2022,01-20,13:08
030 Charles Flahault,2,6,8,2022,01-20,13:08
031 Voltaire,1,7,8,2022,01-20,13:08
032 Pr�s d'Ar�nes,8,0,8,2022,01-20,13:08
033 Garcia Lorca,6,2,8,2022,01-20,13:08
034 Vert Bois,0,16,16,2022,01-20,13:08
035 Malbosc,1,7,8,2022,01-20,13:08
036 Occitanie,1,31,32,2022,01-20,13:08
037 FacdesSciences,5,19,24,2022,01-20,13:08
038 Fac de Lettres,2,14,16,2022,01-20,13:08
039 Aiguelongue,1,7,8,2022,01-20,13:08
040 Jeu de Mail des Abb�s,2,6,8,2022,01-20,13:08
041 Eurom�decine,3,5,8,2022,01-20,13:08
042 Marie Caizergues,4,4,8,2022,01-20,13:08
043 Sabines,4,4,8,2022,01-20,13:08
044 Celleneuve,2,6,8,2022,01-20,13:08
045 Jardin de la Lironde,3,5,8,2022,01-20,13:08
046 P�re Soulas,6,2,8,2022,01-20,13:08
047 Place Viala,2,6,8,2022,01-20,13:08
048 H�tel du D�partement,6,2,8,2022,01-20,13:08
049 Tonnelles,6,2,8,2022,01-20,13:08
050 Parvis Jules Ferry - Gare Saint-Roch,6,2,8,2022,01-20,13:08
051 Pont de Lattes - Gare Saint-Roch,1,11,12,2022,01-20,13:08
053 Deux Ponts - Gare Saint-Roch,2,6,8,2022,01-20,13:08
054 Providence - Ovalie,5,3,8,2022,01-20,13:08
055 P�rols Etang de l'Or,22,46,68,2022,01-20,13:08
056 Albert 1er - Cath�drale,6,6,12,2022,01-20,13:08
057 Saint-Guilhem - Courreau,5,3,8,2022,01-20,13:08
059 Sud De France,3,5,8,2022,01-20,13:08
001 Rue Jules Ferry - Gare Saint-Roch,6,6,12,2022,01-20,13:19
002 Com�die,17,7,24,2022,01-20,13:19
003 Esplanade,14,18,32,2022,01-20,13:19
004 H�tel de Ville,6,10,16,2022,01-20,13:19
005 Corum,2,10,12,2022,01-20,13:19
006 Place Albert 1er - St Charles,15,16,31,2022,01-20,13:19
007 Foch,4,4,8,2022,01-20,13:19
008 Halles Castellane,8,4,12,2022,01-20,13:19
009 Observatoire,7,1,8,2022,01-20,13:19
010 Rondelet,4,12,16,2022,01-20,13:19
011 Plan Cabanes,4,8,12,2022,01-20,13:19
012 Boutonnet,8,4,12,2022,01-20,13:19
013 Emile Combes,6,2,8,2022,01-20,13:19
014 Beaux-Arts,2,6,8,2022,01-20,13:19
015 Les Aubes,3,5,8,2022,01-20,13:19
016 Antigone centre,7,9,16,2022,01-20,13:19
017 M�diath�que Emile Zola,8,8,16,2022,01-20,13:19
018 Nombre d'Or,9,7,16,2022,01-20,13:19
019 Louis Blanc,9,7,16,2022,01-20,13:19
020 Gambetta,4,4,8,2022,01-20,13:19
021 Port Marianne,6,10,16,2022,01-20,13:19
022 Clemenceau,7,5,12,2022,01-20,13:19
023 Les Arceaux,3,13,16,2022,01-20,13:19
024 Cit� Mion,3,5,8,2022,01-20,13:19
025 Nouveau Saint-Roch,3,5,8,2022,01-20,13:19
026 Renouvier,3,5,8,2022,01-20,13:19
027 Odysseum,3,5,8,2022,01-20,13:19
028 Saint-Denis,1,7,8,2022,01-20,13:19
029 Richter,9,7,16,2022,01-20,13:19
030 Charles Flahault,2,6,8,2022,01-20,13:19
031 Voltaire,1,7,8,2022,01-20,13:19
032 Pr�s d'Ar�nes,8,0,8,2022,01-20,13:19
033 Garcia Lorca,6,2,8,2022,01-20,13:19
034 Vert Bois,0,16,16,2022,01-20,13:19
035 Malbosc,1,7,8,2022,01-20,13:19
036 Occitanie,1,31,32,2022,01-20,13:19
037 FacdesSciences,4,20,24,2022,01-20,13:19
038 Fac de Lettres,2,14,16,2022,01-20,13:19
039 Aiguelongue,1,7,8,2022,01-20,13:19
040 Jeu de Mail des Abb�s,2,6,8,2022,01-20,13:19
041 Eurom�decine,3,5,8,2022,01-20,13:19
042 Marie Caizergues,3,5,8,2022,01-20,13:19
043 Sabines,4,4,8,2022,01-20,13:19
044 Celleneuve,2,6,8,2022,01-20,13:19
045 Jardin de la Lironde,3,5,8,2022,01-20,13:19
046 P�re Soulas,6,2,8,2022,01-20,13:19
047 Place Viala,2,6,8,2022,01-20,13:19
048 H�tel du D�partement,6,2,8,2022,01-20,13:19
049 Tonnelles,6,2,8,2022,01-20,13:19
050 Parvis Jules Ferry - Gare Saint-Roch,6,2,8,2022,01-20,13:19
051 Pont de Lattes - Gare Saint-Roch,1,11,12,2022,01-20,13:19
053 Deux Ponts - Gare Saint-Roch,2,6,8,2022,01-20,13:19
054 Providence - Ovalie,5,3,8,2022,01-20,13:19
055 P�rols Etang de l'Or,22,46,68,2022,01-20,13:19
056 Albert 1er - Cath�drale,6,6,12,2022,01-20,13:19
057 Saint-Guilhem - Courreau,5,3,8,2022,01-20,13:19
059 Sud De France,3,5,8,2022,01-20,13:19
001 Rue Jules Ferry - Gare Saint-Roch,6,6,12,2022,01-20,13:29
002 Com�die,17,7,24,2022,01-20,13:29
003 Esplanade,13,19,32,2022,01-20,13:29
004 H�tel de Ville,6,10,16,2022,01-20,13:29
005 Corum,2,10,12,2022,01-20,13:29
006 Place Albert 1er - St Charles,15,16,31,2022,01-20,13:29
007 Foch,4,4,8,2022,01-20,13:29
008 Halles Castellane,8,4,12,2022,01-20,13:29
009 Observatoire,6,2,8,2022,01-20,13:29
010 Rondelet,4,12,16,2022,01-20,13:29
011 Plan Cabanes,4,8,12,2022,01-20,13:29
012 Boutonnet,8,4,12,2022,01-20,13:29
013 Emile Combes,7,1,8,2022,01-20,13:29
014 Beaux-Arts,2,6,8,2022,01-20,13:29
015 Les Aubes,3,5,8,2022,01-20,13:29
016 Antigone centre,7,9,16,2022,01-20,13:29
017 M�diath�que Emile Zola,7,9,16,2022,01-20,13:29
018 Nombre d'Or,10,6,16,2022,01-20,13:29
019 Louis Blanc,7,9,16,2022,01-20,13:29
020 Gambetta,3,5,8,2022,01-20,13:29
021 Port Marianne,6,10,16,2022,01-20,13:29
022 Clemenceau,7,5,12,2022,01-20,13:29
023 Les Arceaux,3,13,16,2022,01-20,13:29
024 Cit� Mion,3,5,8,2022,01-20,13:29
025 Nouveau Saint-Roch,3,5,8,2022,01-20,13:29
026 Renouvier,3,5,8,2022,01-20,13:29
027 Odysseum,3,5,8,2022,01-20,13:29
028 Saint-Denis,2,6,8,2022,01-20,13:29
029 Richter,10,6,16,2022,01-20,13:29
030 Charles Flahault,2,6,8,2022,01-20,13:29
031 Voltaire,1,7,8,2022,01-20,13:29
032 Pr�s d'Ar�nes,7,1,8,2022,01-20,13:29
033 Garcia Lorca,6,2,8,2022,01-20,13:29
034 Vert Bois,0,16,16,2022,01-20,13:29
035 Malbosc,1,7,8,2022,01-20,13:29
036 Occitanie,1,31,32,2022,01-20,13:29
037 FacdesSciences,4,20,24,2022,01-20,13:29
038 Fac de Lettres,2,14,16,2022,01-20,13:29
039 Aiguelongue,2,6,8,2022,01-20,13:29
040 Jeu de Mail des Abb�s,3,5,8,2022,01-20,13:29
041 Eurom�decine,3,5,8,2022,01-20,13:29
042 Marie Caizergues,3,5,8,2022,01-20,13:29
043 Sabines,4,4,8,2022,01-20,13:29
044 Celleneuve,2,6,8,2022,01-20,13:29
045 Jardin de la Lironde,3,5,8,2022,01-20,13:29
046 P�re Soulas,6,2,8,2022,01-20,13:29
047 Place Viala,2,6,8,2022,01-20,13:29
048 H�tel du D�partement,6,2,8,2022,01-20,13:29
049 Tonnelles,6,2,8,2022,01-20,13:29
050 Parvis Jules Ferry - Gare Saint-Roch,6,2,8,2022,01-20,13:29
051 Pont de Lattes - Gare Saint-Roch,1,11,12,2022,01-20,13:29
053 Deux Ponts - Gare Saint-Roch,2,6,8,2022,01-20,13:29
054 Providence - Ovalie,5,3,8,2022,01-20,13:29
055 P�rols Etang de l'Or,22,46,68,2022,01-20,13:29
056 Albert 1er - Cath�drale,6,6,12,2022,01-20,13:29
057 Saint-Guilhem - Courreau,5,3,8,2022,01-20,13:29
059 Sud De France,3,5,8,2022,01-20,13:29
001 Rue Jules Ferry - Gare Saint-Roch,5,7,12,2022,01-20,13:39
002 Com�die,18,6,24,2022,01-20,13:39
003 Esplanade,12,20,32,2022,01-20,13:39
004 H�tel de Ville,6,10,16,2022,01-20,13:39
005 Corum,3,9,12,2022,01-20,13:39
006 Place Albert 1er - St Charles,15,16,31,2022,01-20,13:39
007 Foch,4,4,8,2022,01-20,13:39
008 Halles Castellane,8,4,12,2022,01-20,13:39
009 Observatoire,5,3,8,2022,01-20,13:39
010 Rondelet,4,12,16,2022,01-20,13:39
011 Plan Cabanes,4,8,12,2022,01-20,13:39
012 Boutonnet,8,4,12,2022,01-20,13:39
013 Emile Combes,7,1,8,2022,01-20,13:39
014 Beaux-Arts,2,6,8,2022,01-20,13:39
015 Les Aubes,2,6,8,2022,01-20,13:39
016 Antigone centre,7,9,16,2022,01-20,13:39
017 M�diath�que Emile Zola,7,9,16,2022,01-20,13:39
018 Nombre d'Or,10,6,16,2022,01-20,13:39
019 Louis Blanc,7,9,16,2022,01-20,13:39
020 Gambetta,3,5,8,2022,01-20,13:39
021 Port Marianne,7,9,16,2022,01-20,13:39
022 Clemenceau,6,6,12,2022,01-20,13:39
023 Les Arceaux,3,13,16,2022,01-20,13:39
024 Cit� Mion,3,5,8,2022,01-20,13:39
025 Nouveau Saint-Roch,1,7,8,2022,01-20,13:39
026 Renouvier,3,5,8,2022,01-20,13:39
027 Odysseum,3,5,8,2022,01-20,13:39
028 Saint-Denis,2,6,8,2022,01-20,13:39
029 Richter,10,6,16,2022,01-20,13:39
030 Charles Flahault,2,6,8,2022,01-20,13:39
031 Voltaire,1,7,8,2022,01-20,13:39
032 Pr�s d'Ar�nes,7,1,8,2022,01-20,13:39
033 Garcia Lorca,6,2,8,2022,01-20,13:39
034 Vert Bois,0,16,16,2022,01-20,13:39
035 Malbosc,1,7,8,2022,01-20,13:39
036 Occitanie,1,31,32,2022,01-20,13:39
037 FacdesSciences,4,20,24,2022,01-20,13:39
038 Fac de Lettres,2,14,16,2022,01-20,13:39
039 Aiguelongue,2,6,8,2022,01-20,13:39
040 Jeu de Mail des Abb�s,2,6,8,2022,01-20,13:39
041 Eurom�decine,3,5,8,2022,01-20,13:39
042 Marie Caizergues,3,5,8,2022,01-20,13:39
043 Sabines,4,4,8,2022,01-20,13:39
044 Celleneuve,2,6,8,2022,01-20,13:39
045 Jardin de la Lironde,3,5,8,2022,01-20,13:39
046 P�re Soulas,6,2,8,2022,01-20,13:39
047 Place Viala,3,5,8,2022,01-20,13:39
048 H�tel du D�partement,6,2,8,2022,01-20,13:39
049 Tonnelles,6,2,8,2022,01-20,13:39
050 Parvis Jules Ferry - Gare Saint-Roch,6,2,8,2022,01-20,13:39
051 Pont de Lattes - Gare Saint-Roch,1,11,12,2022,01-20,13:39
053 Deux Ponts - Gare Saint-Roch,2,6,8,2022,01-20,13:39
054 Providence - Ovalie,5,3,8,2022,01-20,13:39
055 P�rols Etang de l'Or,22,46,68,2022,01-20,13:39
056 Albert 1er - Cath�drale,6,6,12,2022,01-20,13:39
057 Saint-Guilhem - Courreau,5,3,8,2022,01-20,13:39
059 Sud De France,3,5,8,2022,01-20,13:39
001 Rue Jules Ferry - Gare Saint-Roch,5,7,12,2022,01-20,13:49
002 Com�die,18,6,24,2022,01-20,13:49
003 Esplanade,12,20,32,2022,01-20,13:49
004 H�tel de Ville,6,10,16,2022,01-20,13:49
005 Corum,4,8,12,2022,01-20,13:49
006 Place Albert 1er - St Charles,16,15,31,2022,01-20,13:49
007 Foch,4,4,8,2022,01-20,13:49
008 Halles Castellane,8,4,12,2022,01-20,13:49
009 Observatoire,5,3,8,2022,01-20,13:49
010 Rondelet,4,12,16,2022,01-20,13:49
011 Plan Cabanes,4,8,12,2022,01-20,13:49
012 Boutonnet,8,4,12,2022,01-20,13:49
013 Emile Combes,6,2,8,2022,01-20,13:49
014 Beaux-Arts,2,6,8,2022,01-20,13:49
015 Les Aubes,2,6,8,2022,01-20,13:49
016 Antigone centre,7,9,16,2022,01-20,13:49
017 M�diath�que Emile Zola,7,9,16,2022,01-20,13:49
018 Nombre d'Or,11,5,16,2022,01-20,13:49
019 Louis Blanc,7,9,16,2022,01-20,13:49
020 Gambetta,3,5,8,2022,01-20,13:49
021 Port Marianne,6,10,16,2022,01-20,13:49
022 Clemenceau,7,5,12,2022,01-20,13:49
023 Les Arceaux,2,14,16,2022,01-20,13:49
024 Cit� Mion,3,5,8,2022,01-20,13:49
025 Nouveau Saint-Roch,1,7,8,2022,01-20,13:49
026 Renouvier,3,5,8,2022,01-20,13:49
027 Odysseum,3,5,8,2022,01-20,13:49
028 Saint-Denis,2,6,8,2022,01-20,13:49
029 Richter,9,7,16,2022,01-20,13:49
030 Charles Flahault,2,6,8,2022,01-20,13:49
031 Voltaire,1,7,8,2022,01-20,13:49
032 Pr�s d'Ar�nes,7,1,8,2022,01-20,13:49
033 Garcia Lorca,6,2,8,2022,01-20,13:49
034 Vert Bois,0,16,16,2022,01-20,13:49
035 Malbosc,1,7,8,2022,01-20,13:49
036 Occitanie,1,31,32,2022,01-20,13:49
037 FacdesSciences,4,20,24,2022,01-20,13:49
038 Fac de Lettres,2,14,16,2022,01-20,13:49
039 Aiguelongue,2,6,8,2022,01-20,13:49
040 Jeu de Mail des Abb�s,2,6,8,2022,01-20,13:49
041 Eurom�decine,3,5,8,2022,01-20,13:49
042 Marie Caizergues,3,5,8,2022,01-20,13:49
043 Sabines,4,4,8,2022,01-20,13:49
044 Celleneuve,2,6,8,2022,01-20,13:49
045 Jardin de la Lironde,3,5,8,2022,01-20,13:49
046 P�re Soulas,6,2,8,2022,01-20,13:49
047 Place Viala,3,5,8,2022,01-20,13:49
048 H�tel du D�partement,6,2,8,2022,01-20,13:49
049 Tonnelles,6,2,8,2022,01-20,13:49
050 Parvis Jules Ferry - Gare Saint-Roch,6,2,8,2022,01-20,13:49
051 Pont de Lattes - Gare Saint-Roch,1,11,12,2022,01-20,13:49
053 Deux Ponts - Gare Saint-Roch,2,6,8,2022,01-20,13:49
054 Providence - Ovalie,5,3,8,2022,01-20,13:49
055 P�rols Etang de l'Or,22,46,68,2022,01-20,13:49
056 Albert 1er - Cath�drale,6,6,12,2022,01-20,13:49
057 Saint-Guilhem - Courreau,5,3,8,2022,01-20,13:49
059 Sud De France,3,5,8,2022,01-20,13:49
001 Rue Jules Ferry - Gare Saint-Roch,5,7,12,2022,01-20,13:59
002 Com�die,18,6,24,2022,01-20,13:59
003 Esplanade,13,19,32,2022,01-20,13:59
004 H�tel de Ville,6,10,16,2022,01-20,13:59
005 Corum,4,8,12,2022,01-20,13:59
006 Place Albert 1er - St Charles,16,15,31,2022,01-20,13:59
007 Foch,4,4,8,2022,01-20,13:59
008 Halles Castellane,8,4,12,2022,01-20,13:59
009 Observatoire,5,3,8,2022,01-20,13:59
010 Rondelet,4,12,16,2022,01-20,13:59
011 Plan Cabanes,4,8,12,2022,01-20,13:59
012 Boutonnet,8,4,12,2022,01-20,13:59
013 Emile Combes,6,2,8,2022,01-20,13:59
014 Beaux-Arts,1,7,8,2022,01-20,13:59
015 Les Aubes,2,6,8,2022,01-20,13:59
016 Antigone centre,7,9,16,2022,01-20,13:59
017 M�diath�que Emile Zola,7,9,16,2022,01-20,13:59
018 Nombre d'Or,11,5,16,2022,01-20,13:59
019 Louis Blanc,7,9,16,2022,01-20,13:59
020 Gambetta,1,7,8,2022,01-20,13:59
021 Port Marianne,7,9,16,2022,01-20,13:59
022 Clemenceau,7,5,12,2022,01-20,13:59
023 Les Arceaux,2,14,16,2022,01-20,13:59
024 Cit� Mion,3,5,8,2022,01-20,13:59
025 Nouveau Saint-Roch,1,7,8,2022,01-20,13:59
026 Renouvier,3,5,8,2022,01-20,13:59
027 Odysseum,3,5,8,2022,01-20,13:59
028 Saint-Denis,2,6,8,2022,01-20,13:59
029 Richter,9,7,16,2022,01-20,13:59
030 Charles Flahault,2,6,8,2022,01-20,13:59
031 Voltaire,1,7,8,2022,01-20,13:59
032 Pr�s d'Ar�nes,7,1,8,2022,01-20,13:59
033 Garcia Lorca,6,2,8,2022,01-20,13:59
034 Vert Bois,0,16,16,2022,01-20,13:59
035 Malbosc,2,6,8,2022,01-20,13:59
036 Occitanie,2,30,32,2022,01-20,13:59
037 FacdesSciences,3,21,24,2022,01-20,13:59
038 Fac de Lettres,2,14,16,2022,01-20,13:59
039 Aiguelongue,2,6,8,2022,01-20,13:59
040 Jeu de Mail des Abb�s,3,5,8,2022,01-20,13:59
041 Eurom�decine,3,5,8,2022,01-20,13:59
042 Marie Caizergues,3,5,8,2022,01-20,13:59
043 Sabines,4,4,8,2022,01-20,13:59
044 Celleneuve,2,6,8,2022,01-20,13:59
045 Jardin de la Lironde,3,5,8,2022,01-20,13:59
046 P�re Soulas,6,2,8,2022,01-20,13:59
047 Place Viala,3,5,8,2022,01-20,13:59
048 H�tel du D�partement,6,2,8,2022,01-20,13:59
049 Tonnelles,6,2,8,2022,01-20,13:59
050 Parvis Jules Ferry - Gare Saint-Roch,7,1,8,2022,01-20,13:59
051 Pont de Lattes - Gare Saint-Roch,1,11,12,2022,01-20,13:59
053 Deux Ponts - Gare Saint-Roch,2,6,8,2022,01-20,13:59
054 Providence - Ovalie,5,3,8,2022,01-20,13:59
055 P�rols Etang de l'Or,22,46,68,2022,01-20,13:59
056 Albert 1er - Cath�drale,6,6,12,2022,01-20,13:59
057 Saint-Guilhem - Courreau,5,3,8,2022,01-20,13:59
059 Sud De France,3,5,8,2022,01-20,13:59
001 Rue Jules Ferry - Gare Saint-Roch,5,7,12,2022,01-20,14:09
002 Com�die,18,6,24,2022,01-20,14:09
003 Esplanade,13,19,32,2022,01-20,14:09
004 H�tel de Ville,5,11,16,2022,01-20,14:09
005 Corum,4,8,12,2022,01-20,14:09
006 Place Albert 1er - St Charles,17,14,31,2022,01-20,14:09
007 Foch,4,4,8,2022,01-20,14:09
008 Halles Castellane,7,5,12,2022,01-20,14:09
009 Observatoire,5,3,8,2022,01-20,14:09
010 Rondelet,4,12,16,2022,01-20,14:09
011 Plan Cabanes,4,8,12,2022,01-20,14:09
012 Boutonnet,8,4,12,2022,01-20,14:09
013 Emile Combes,6,2,8,2022,01-20,14:09
014 Beaux-Arts,1,7,8,2022,01-20,14:09
015 Les Aubes,2,6,8,2022,01-20,14:09
016 Antigone centre,7,9,16,2022,01-20,14:09
017 M�diath�que Emile Zola,8,8,16,2022,01-20,14:09
018 Nombre d'Or,11,5,16,2022,01-20,14:09
019 Louis Blanc,7,9,16,2022,01-20,14:09
020 Gambetta,1,7,8,2022,01-20,14:09
021 Port Marianne,7,9,16,2022,01-20,14:09
022 Clemenceau,7,5,12,2022,01-20,14:09
023 Les Arceaux,2,14,16,2022,01-20,14:09
024 Cit� Mion,3,5,8,2022,01-20,14:09
025 Nouveau Saint-Roch,2,6,8,2022,01-20,14:09
026 Renouvier,3,5,8,2022,01-20,14:09
027 Odysseum,3,5,8,2022,01-20,14:09
028 Saint-Denis,2,6,8,2022,01-20,14:09
029 Richter,9,7,16,2022,01-20,14:09
030 Charles Flahault,1,7,8,2022,01-20,14:09
031 Voltaire,1,7,8,2022,01-20,14:09
032 Pr�s d'Ar�nes,7,1,8,2022,01-20,14:09
033 Garcia Lorca,6,2,8,2022,01-20,14:09
034 Vert Bois,0,16,16,2022,01-20,14:09
035 Malbosc,2,6,8,2022,01-20,14:09
036 Occitanie,2,30,32,2022,01-20,14:09
037 FacdesSciences,4,20,24,2022,01-20,14:09
038 Fac de Lettres,1,15,16,2022,01-20,14:09
039 Aiguelongue,3,5,8,2022,01-20,14:09
040 Jeu de Mail des Abb�s,3,5,8,2022,01-20,14:09
041 Eurom�decine,3,5,8,2022,01-20,14:09
042 Marie Caizergues,3,5,8,2022,01-20,14:09
043 Sabines,4,4,8,2022,01-20,14:09
044 Celleneuve,2,6,8,2022,01-20,14:09
045 Jardin de la Lironde,3,5,8,2022,01-20,14:09
046 P�re Soulas,6,2,8,2022,01-20,14:09
047 Place Viala,3,5,8,2022,01-20,14:09
048 H�tel du D�partement,6,2,8,2022,01-20,14:09
049 Tonnelles,6,2,8,2022,01-20,14:09
050 Parvis Jules Ferry - Gare Saint-Roch,7,1,8,2022,01-20,14:09
051 Pont de Lattes - Gare Saint-Roch,1,11,12,2022,01-20,14:09
053 Deux Ponts - Gare Saint-Roch,2,6,8,2022,01-20,14:09
054 Providence - Ovalie,5,3,8,2022,01-20,14:09
055 P�rols Etang de l'Or,22,46,68,2022,01-20,14:09
056 Albert 1er - Cath�drale,6,6,12,2022,01-20,14:09
057 Saint-Guilhem - Courreau,5,3,8,2022,01-20,14:09
059 Sud De France,3,5,8,2022,01-20,14:09
001 Rue Jules Ferry - Gare Saint-Roch,5,7,12,2022,01-20,14:20
002 Com�die,18,6,24,2022,01-20,14:20
003 Esplanade,13,19,32,2022,01-20,14:20
004 H�tel de Ville,5,11,16,2022,01-20,14:20
005 Corum,4,8,12,2022,01-20,14:20
006 Place Albert 1er - St Charles,17,14,31,2022,01-20,14:20
007 Foch,4,4,8,2022,01-20,14:20
008 Halles Castellane,7,5,12,2022,01-20,14:20
009 Observatoire,5,3,8,2022,01-20,14:20
010 Rondelet,4,12,16,2022,01-20,14:20
011 Plan Cabanes,4,8,12,2022,01-20,14:20
012 Boutonnet,9,3,12,2022,01-20,14:20
013 Emile Combes,6,2,8,2022,01-20,14:20
014 Beaux-Arts,1,7,8,2022,01-20,14:20
015 Les Aubes,2,6,8,2022,01-20,14:20
016 Antigone centre,7,9,16,2022,01-20,14:20
017 M�diath�que Emile Zola,8,8,16,2022,01-20,14:20
018 Nombre d'Or,11,5,16,2022,01-20,14:20
019 Louis Blanc,7,9,16,2022,01-20,14:20
020 Gambetta,1,7,8,2022,01-20,14:20
021 Port Marianne,7,9,16,2022,01-20,14:20
022 Clemenceau,7,5,12,2022,01-20,14:20
023 Les Arceaux,3,13,16,2022,01-20,14:20
024 Cit� Mion,3,5,8,2022,01-20,14:20
025 Nouveau Saint-Roch,2,6,8,2022,01-20,14:20
026 Renouvier,3,5,8,2022,01-20,14:20
027 Odysseum,3,5,8,2022,01-20,14:20
028 Saint-Denis,2,6,8,2022,01-20,14:20
029 Richter,9,7,16,2022,01-20,14:20
030 Charles Flahault,1,7,8,2022,01-20,14:20
031 Voltaire,1,7,8,2022,01-20,14:20
032 Pr�s d'Ar�nes,4,4,8,2022,01-20,14:20
033 Garcia Lorca,7,1,8,2022,01-20,14:20
034 Vert Bois,0,16,16,2022,01-20,14:20
035 Malbosc,2,6,8,2022,01-20,14:20
036 Occitanie,2,30,32,2022,01-20,14:20
037 FacdesSciences,4,20,24,2022,01-20,14:20
038 Fac de Lettres,0,16,16,2022,01-20,14:20
039 Aiguelongue,4,4,8,2022,01-20,14:20
040 Jeu de Mail des Abb�s,3,5,8,2022,01-20,14:20
041 Eurom�decine,3,5,8,2022,01-20,14:20
042 Marie Caizergues,3,5,8,2022,01-20,14:20
043 Sabines,4,4,8,2022,01-20,14:20
044 Celleneuve,2,6,8,2022,01-20,14:20
045 Jardin de la Lironde,3,5,8,2022,01-20,14:20
046 P�re Soulas,6,2,8,2022,01-20,14:20
047 Place Viala,3,5,8,2022,01-20,14:20
048 H�tel du D�partement,6,2,8,2022,01-20,14:20
049 Tonnelles,6,2,8,2022,01-20,14:20
050 Parvis Jules Ferry - Gare Saint-Roch,7,1,8,2022,01-20,14:20
051 Pont de Lattes - Gare Saint-Roch,1,11,12,2022,01-20,14:20
053 Deux Ponts - Gare Saint-Roch,2,6,8,2022,01-20,14:20
054 Providence - Ovalie,5,3,8,2022,01-20,14:20
055 P�rols Etang de l'Or,22,46,68,2022,01-20,14:20
056 Albert 1er - Cath�drale,6,6,12,2022,01-20,14:20
057 Saint-Guilhem - Courreau,5,3,8,2022,01-20,14:20
059 Sud De France,3,5,8,2022,01-20,14:20
001 Rue Jules Ferry - Gare Saint-Roch,5,7,12,2022,01-20,14:30
002 Com�die,18,6,24,2022,01-20,14:30
003 Esplanade,13,19,32,2022,01-20,14:30
004 H�tel de Ville,5,11,16,2022,01-20,14:30
005 Corum,4,8,12,2022,01-20,14:30
006 Place Albert 1er - St Charles,17,14,31,2022,01-20,14:30
007 Foch,6,2,8,2022,01-20,14:30
008 Halles Castellane,7,5,12,2022,01-20,14:30
009 Observatoire,5,3,8,2022,01-20,14:30
010 Rondelet,4,12,16,2022,01-20,14:30
011 Plan Cabanes,4,8,12,2022,01-20,14:30
012 Boutonnet,10,2,12,2022,01-20,14:30
013 Emile Combes,6,2,8,2022,01-20,14:30
014 Beaux-Arts,1,7,8,2022,01-20,14:30
015 Les Aubes,2,6,8,2022,01-20,14:30
016 Antigone centre,7,9,16,2022,01-20,14:30
017 M�diath�que Emile Zola,8,8,16,2022,01-20,14:30
018 Nombre d'Or,11,5,16,2022,01-20,14:30
019 Louis Blanc,7,9,16,2022,01-20,14:30
020 Gambetta,1,7,8,2022,01-20,14:30
021 Port Marianne,7,9,16,2022,01-20,14:30
022 Clemenceau,7,5,12,2022,01-20,14:30
023 Les Arceaux,3,13,16,2022,01-20,14:30
024 Cit� Mion,3,5,8,2022,01-20,14:30
025 Nouveau Saint-Roch,2,6,8,2022,01-20,14:30
026 Renouvier,3,5,8,2022,01-20,14:30
027 Odysseum,4,4,8,2022,01-20,14:30
028 Saint-Denis,2,6,8,2022,01-20,14:30
029 Richter,9,7,16,2022,01-20,14:30
030 Charles Flahault,1,7,8,2022,01-20,14:30
031 Voltaire,1,7,8,2022,01-20,14:30
032 Pr�s d'Ar�nes,4,4,8,2022,01-20,14:30
033 Garcia Lorca,7,1,8,2022,01-20,14:30
034 Vert Bois,0,16,16,2022,01-20,14:30
035 Malbosc,2,6,8,2022,01-20,14:30
036 Occitanie,3,29,32,2022,01-20,14:30
037 FacdesSciences,4,20,24,2022,01-20,14:30
038 Fac de Lettres,0,16,16,2022,01-20,14:30
039 Aiguelongue,4,4,8,2022,01-20,14:30
040 Jeu de Mail des Abb�s,3,5,8,2022,01-20,14:30
041 Eurom�decine,3,5,8,2022,01-20,14:30
042 Marie Caizergues,3,5,8,2022,01-20,14:30
043 Sabines,4,4,8,2022,01-20,14:30
044 Celleneuve,2,6,8,2022,01-20,14:30
045 Jardin de la Lironde,3,5,8,2022,01-20,14:30
046 P�re Soulas,6,2,8,2022,01-20,14:30
047 Place Viala,3,5,8,2022,01-20,14:30
048 H�tel du D�partement,6,2,8,2022,01-20,14:30
049 Tonnelles,6,2,8,2022,01-20,14:30
050 Parvis Jules Ferry - Gare Saint-Roch,7,1,8,2022,01-20,14:30
051 Pont de Lattes - Gare Saint-Roch,1,11,12,2022,01-20,14:30
053 Deux Ponts - Gare Saint-Roch,2,6,8,2022,01-20,14:30
054 Providence - Ovalie,5,3,8,2022,01-20,14:30
055 P�rols Etang de l'Or,22,46,68,2022,01-20,14:30
056 Albert 1er - Cath�drale,6,6,12,2022,01-20,14:30
057 Saint-Guilhem - Courreau,5,3,8,2022,01-20,14:30
059 Sud De France,3,5,8,2022,01-20,14:30
001 Rue Jules Ferry - Gare Saint-Roch,5,7,12,2022,01-20,14:40
002 Com�die,18,6,24,2022,01-20,14:40
003 Esplanade,13,19,32,2022,01-20,14:40
004 H�tel de Ville,6,10,16,2022,01-20,14:40
005 Corum,4,8,12,2022,01-20,14:40
006 Place Albert 1er - St Charles,17,14,31,2022,01-20,14:40
007 Foch,6,2,8,2022,01-20,14:40
008 Halles Castellane,6,6,12,2022,01-20,14:40
009 Observatoire,6,2,8,2022,01-20,14:40
010 Rondelet,4,12,16,2022,01-20,14:40
011 Plan Cabanes,5,7,12,2022,01-20,14:40
012 Boutonnet,10,2,12,2022,01-20,14:40
013 Emile Combes,6,2,8,2022,01-20,14:40
014 Beaux-Arts,1,7,8,2022,01-20,14:40
015 Les Aubes,1,7,8,2022,01-20,14:40
016 Antigone centre,7,9,16,2022,01-20,14:40
017 M�diath�que Emile Zola,9,7,16,2022,01-20,14:40
018 Nombre d'Or,10,6,16,2022,01-20,14:40
019 Louis Blanc,8,8,16,2022,01-20,14:40
020 Gambetta,1,7,8,2022,01-20,14:40
021 Port Marianne,7,9,16,2022,01-20,14:40
022 Clemenceau,7,5,12,2022,01-20,14:40
023 Les Arceaux,3,13,16,2022,01-20,14:40
024 Cit� Mion,3,5,8,2022,01-20,14:40
025 Nouveau Saint-Roch,2,6,8,2022,01-20,14:40
026 Renouvier,3,5,8,2022,01-20,14:40
027 Odysseum,4,4,8,2022,01-20,14:40
028 Saint-Denis,2,6,8,2022,01-20,14:40
029 Richter,9,7,16,2022,01-20,14:40
030 Charles Flahault,0,8,8,2022,01-20,14:40
031 Voltaire,1,7,8,2022,01-20,14:40
032 Pr�s d'Ar�nes,4,4,8,2022,01-20,14:40
033 Garcia Lorca,7,1,8,2022,01-20,14:40
034 Vert Bois,0,16,16,2022,01-20,14:40
035 Malbosc,2,6,8,2022,01-20,14:40
036 Occitanie,4,28,32,2022,01-20,14:40
037 FacdesSciences,4,20,24,2022,01-20,14:40
038 Fac de Lettres,0,16,16,2022,01-20,14:40
039 Aiguelongue,4,4,8,2022,01-20,14:40
040 Jeu de Mail des Abb�s,3,5,8,2022,01-20,14:40
041 Eurom�decine,3,5,8,2022,01-20,14:40
042 Marie Caizergues,3,5,8,2022,01-20,14:40
043 Sabines,4,4,8,2022,01-20,14:40
044 Celleneuve,2,6,8,2022,01-20,14:40
045 Jardin de la Lironde,3,5,8,2022,01-20,14:40
046 P�re Soulas,6,2,8,2022,01-20,14:40
047 Place Viala,2,6,8,2022,01-20,14:40
048 H�tel du D�partement,6,2,8,2022,01-20,14:40
049 Tonnelles,6,2,8,2022,01-20,14:40
050 Parvis Jules Ferry - Gare Saint-Roch,8,0,8,2022,01-20,14:40
051 Pont de Lattes - Gare Saint-Roch,1,11,12,2022,01-20,14:40
053 Deux Ponts - Gare Saint-Roch,2,6,8,2022,01-20,14:40
054 Providence - Ovalie,5,3,8,2022,01-20,14:40
055 P�rols Etang de l'Or,22,46,68,2022,01-20,14:40
056 Albert 1er - Cath�drale,6,6,12,2022,01-20,14:40
057 Saint-Guilhem - Courreau,5,3,8,2022,01-20,14:40
059 Sud De France,3,5,8,2022,01-20,14:40
001 Rue Jules Ferry - Gare Saint-Roch,5,7,12,2022,01-20,14:50
002 Com�die,18,6,24,2022,01-20,14:50
003 Esplanade,13,19,32,2022,01-20,14:50
004 H�tel de Ville,6,10,16,2022,01-20,14:50
005 Corum,4,8,12,2022,01-20,14:50
006 Place Albert 1er - St Charles,17,14,31,2022,01-20,14:50
007 Foch,6,2,8,2022,01-20,14:50
008 Halles Castellane,5,7,12,2022,01-20,14:50
009 Observatoire,6,2,8,2022,01-20,14:50
010 Rondelet,4,12,16,2022,01-20,14:50
011 Plan Cabanes,4,8,12,2022,01-20,14:50
012 Boutonnet,10,2,12,2022,01-20,14:50
013 Emile Combes,6,2,8,2022,01-20,14:50
014 Beaux-Arts,1,7,8,2022,01-20,14:50
015 Les Aubes,1,7,8,2022,01-20,14:50
016 Antigone centre,7,9,16,2022,01-20,14:50
017 M�diath�que Emile Zola,9,7,16,2022,01-20,14:50
018 Nombre d'Or,11,5,16,2022,01-20,14:50
019 Louis Blanc,8,8,16,2022,01-20,14:50
020 Gambetta,1,7,8,2022,01-20,14:50
021 Port Marianne,7,9,16,2022,01-20,14:50
022 Clemenceau,7,5,12,2022,01-20,14:50
023 Les Arceaux,3,13,16,2022,01-20,14:50
024 Cit� Mion,3,5,8,2022,01-20,14:50
025 Nouveau Saint-Roch,2,6,8,2022,01-20,14:50
026 Renouvier,3,5,8,2022,01-20,14:50
027 Odysseum,4,4,8,2022,01-20,14:50
028 Saint-Denis,2,6,8,2022,01-20,14:50
029 Richter,9,7,16,2022,01-20,14:50
030 Charles Flahault,0,8,8,2022,01-20,14:50
031 Voltaire,1,7,8,2022,01-20,14:50
032 Pr�s d'Ar�nes,4,4,8,2022,01-20,14:50
033 Garcia Lorca,7,1,8,2022,01-20,14:50
034 Vert Bois,0,16,16,2022,01-20,14:50
035 Malbosc,2,6,8,2022,01-20,14:50
036 Occitanie,4,28,32,2022,01-20,14:50
037 FacdesSciences,1,23,24,2022,01-20,14:50
038 Fac de Lettres,0,16,16,2022,01-20,14:50
039 Aiguelongue,4,4,8,2022,01-20,14:50
040 Jeu de Mail des Abb�s,3,5,8,2022,01-20,14:50
041 Eurom�decine,3,5,8,2022,01-20,14:50
042 Marie Caizergues,3,5,8,2022,01-20,14:50
043 Sabines,4,4,8,2022,01-20,14:50
044 Celleneuve,2,6,8,2022,01-20,14:50
045 Jardin de la Lironde,3,5,8,2022,01-20,14:50
046 P�re Soulas,6,2,8,2022,01-20,14:50
047 Place Viala,2,6,8,2022,01-20,14:50
048 H�tel du D�partement,6,2,8,2022,01-20,14:50
049 Tonnelles,6,2,8,2022,01-20,14:50
050 Parvis Jules Ferry - Gare Saint-Roch,8,0,8,2022,01-20,14:50
051 Pont de Lattes - Gare Saint-Roch,1,11,12,2022,01-20,14:50
053 Deux Ponts - Gare Saint-Roch,2,6,8,2022,01-20,14:50
054 Providence - Ovalie,5,3,8,2022,01-20,14:50
055 P�rols Etang de l'Or,22,46,68,2022,01-20,14:50
056 Albert 1er - Cath�drale,7,5,12,2022,01-20,14:50
057 Saint-Guilhem - Courreau,5,3,8,2022,01-20,14:50
059 Sud De France,3,5,8,2022,01-20,14:50
001 Rue Jules Ferry - Gare Saint-Roch,5,7,12,2022,01-20,15:00
002 Com�die,19,5,24,2022,01-20,15:00
003 Esplanade,13,19,32,2022,01-20,15:00
004 H�tel de Ville,6,10,16,2022,01-20,15:00
005 Corum,4,8,12,2022,01-20,15:00
006 Place Albert 1er - St Charles,17,14,31,2022,01-20,15:00
007 Foch,6,2,8,2022,01-20,15:00
008 Halles Castellane,5,7,12,2022,01-20,15:00
009 Observatoire,6,2,8,2022,01-20,15:00
010 Rondelet,4,12,16,2022,01-20,15:00
011 Plan Cabanes,4,8,12,2022,01-20,15:00
012 Boutonnet,9,3,12,2022,01-20,15:00
013 Emile Combes,6,2,8,2022,01-20,15:00
014 Beaux-Arts,1,7,8,2022,01-20,15:00
015 Les Aubes,1,7,8,2022,01-20,15:00
016 Antigone centre,7,9,16,2022,01-20,15:00
017 M�diath�que Emile Zola,10,6,16,2022,01-20,15:00
018 Nombre d'Or,12,4,16,2022,01-20,15:00
019 Louis Blanc,8,8,16,2022,01-20,15:00
020 Gambetta,1,7,8,2022,01-20,15:00
021 Port Marianne,7,9,16,2022,01-20,15:00
022 Clemenceau,7,5,12,2022,01-20,15:00
023 Les Arceaux,3,13,16,2022,01-20,15:00
024 Cit� Mion,3,5,8,2022,01-20,15:00
025 Nouveau Saint-Roch,1,7,8,2022,01-20,15:00
026 Renouvier,3,5,8,2022,01-20,15:00
027 Odysseum,4,4,8,2022,01-20,15:00
028 Saint-Denis,2,6,8,2022,01-20,15:00
029 Richter,9,7,16,2022,01-20,15:00
030 Charles Flahault,0,8,8,2022,01-20,15:00
031 Voltaire,1,7,8,2022,01-20,15:00
032 Pr�s d'Ar�nes,4,4,8,2022,01-20,15:00
033 Garcia Lorca,7,1,8,2022,01-20,15:00
034 Vert Bois,0,16,16,2022,01-20,15:00
035 Malbosc,2,6,8,2022,01-20,15:00
036 Occitanie,4,28,32,2022,01-20,15:00
037 FacdesSciences,1,23,24,2022,01-20,15:00
038 Fac de Lettres,2,14,16,2022,01-20,15:00
039 Aiguelongue,4,4,8,2022,01-20,15:00
040 Jeu de Mail des Abb�s,3,5,8,2022,01-20,15:00
041 Eurom�decine,3,5,8,2022,01-20,15:00
042 Marie Caizergues,3,5,8,2022,01-20,15:00
043 Sabines,4,4,8,2022,01-20,15:00
044 Celleneuve,2,6,8,2022,01-20,15:00
045 Jardin de la Lironde,3,5,8,2022,01-20,15:00
046 P�re Soulas,7,1,8,2022,01-20,15:00
047 Place Viala,2,6,8,2022,01-20,15:00
048 H�tel du D�partement,6,2,8,2022,01-20,15:00
049 Tonnelles,6,2,8,2022,01-20,15:00
050 Parvis Jules Ferry - Gare Saint-Roch,8,0,8,2022,01-20,15:00
051 Pont de Lattes - Gare Saint-Roch,1,11,12,2022,01-20,15:00
053 Deux Ponts - Gare Saint-Roch,2,6,8,2022,01-20,15:00
054 Providence - Ovalie,5,3,8,2022,01-20,15:00
055 P�rols Etang de l'Or,22,46,68,2022,01-20,15:00
056 Albert 1er - Cath�drale,6,6,12,2022,01-20,15:00
057 Saint-Guilhem - Courreau,4,4,8,2022,01-20,15:00
059 Sud De France,3,5,8,2022,01-20,15:00
001 Rue Jules Ferry - Gare Saint-Roch,5,7,12,2022,01-20,15:10
002 Com�die,19,5,24,2022,01-20,15:10
003 Esplanade,12,20,32,2022,01-20,15:10
004 H�tel de Ville,6,10,16,2022,01-20,15:10
005 Corum,4,8,12,2022,01-20,15:10
006 Place Albert 1er - St Charles,17,14,31,2022,01-20,15:10
007 Foch,6,2,8,2022,01-20,15:10
008 Halles Castellane,5,7,12,2022,01-20,15:10
009 Observatoire,6,2,8,2022,01-20,15:10
010 Rondelet,4,12,16,2022,01-20,15:10
011 Plan Cabanes,4,8,12,2022,01-20,15:10
012 Boutonnet,10,2,12,2022,01-20,15:10
013 Emile Combes,6,2,8,2022,01-20,15:10
014 Beaux-Arts,1,7,8,2022,01-20,15:10
015 Les Aubes,1,7,8,2022,01-20,15:10
016 Antigone centre,7,9,16,2022,01-20,15:10
017 M�diath�que Emile Zola,10,6,16,2022,01-20,15:10
018 Nombre d'Or,12,4,16,2022,01-20,15:10
019 Louis Blanc,8,8,16,2022,01-20,15:10
020 Gambetta,1,7,8,2022,01-20,15:10
021 Port Marianne,8,8,16,2022,01-20,15:10
022 Clemenceau,7,5,12,2022,01-20,15:10
023 Les Arceaux,2,14,16,2022,01-20,15:10
024 Cit� Mion,3,5,8,2022,01-20,15:10
025 Nouveau Saint-Roch,1,7,8,2022,01-20,15:10
026 Renouvier,3,5,8,2022,01-20,15:10
027 Odysseum,4,4,8,2022,01-20,15:10
028 Saint-Denis,2,6,8,2022,01-20,15:10
029 Richter,9,7,16,2022,01-20,15:10
030 Charles Flahault,0,8,8,2022,01-20,15:10
031 Voltaire,1,7,8,2022,01-20,15:10
032 Pr�s d'Ar�nes,4,4,8,2022,01-20,15:10
033 Garcia Lorca,7,1,8,2022,01-20,15:10
034 Vert Bois,0,16,16,2022,01-20,15:10
035 Malbosc,2,6,8,2022,01-20,15:10
036 Occitanie,3,29,32,2022,01-20,15:10
037 FacdesSciences,3,21,24,2022,01-20,15:10
038 Fac de Lettres,3,13,16,2022,01-20,15:10
039 Aiguelongue,4,4,8,2022,01-20,15:10
040 Jeu de Mail des Abb�s,3,5,8,2022,01-20,15:10
041 Eurom�decine,3,5,8,2022,01-20,15:10
042 Marie Caizergues,3,5,8,2022,01-20,15:10
043 Sabines,4,4,8,2022,01-20,15:10
044 Celleneuve,2,6,8,2022,01-20,15:10
045 Jardin de la Lironde,3,5,8,2022,01-20,15:10
046 P�re Soulas,7,1,8,2022,01-20,15:10
047 Place Viala,2,6,8,2022,01-20,15:10
048 H�tel du D�partement,6,2,8,2022,01-20,15:10
049 Tonnelles,5,3,8,2022,01-20,15:10
050 Parvis Jules Ferry - Gare Saint-Roch,8,0,8,2022,01-20,15:10
051 Pont de Lattes - Gare Saint-Roch,1,11,12,2022,01-20,15:10
053 Deux Ponts - Gare Saint-Roch,2,6,8,2022,01-20,15:10
054 Providence - Ovalie,5,3,8,2022,01-20,15:10
055 P�rols Etang de l'Or,22,46,68,2022,01-20,15:10
056 Albert 1er - Cath�drale,6,6,12,2022,01-20,15:10
057 Saint-Guilhem - Courreau,4,4,8,2022,01-20,15:10
059 Sud De France,3,5,8,2022,01-20,15:10
001 Rue Jules Ferry - Gare Saint-Roch,5,7,12,2022,01-20,15:21
002 Com�die,19,5,24,2022,01-20,15:21
003 Esplanade,12,20,32,2022,01-20,15:21
004 H�tel de Ville,6,10,16,2022,01-20,15:21
005 Corum,4,8,12,2022,01-20,15:21
006 Place Albert 1er - St Charles,18,13,31,2022,01-20,15:21
007 Foch,6,2,8,2022,01-20,15:21
008 Halles Castellane,5,7,12,2022,01-20,15:21
009 Observatoire,6,2,8,2022,01-20,15:21
010 Rondelet,4,12,16,2022,01-20,15:21
011 Plan Cabanes,4,8,12,2022,01-20,15:21
012 Boutonnet,10,2,12,2022,01-20,15:21
013 Emile Combes,6,2,8,2022,01-20,15:21
014 Beaux-Arts,1,7,8,2022,01-20,15:21
015 Les Aubes,1,7,8,2022,01-20,15:21
016 Antigone centre,6,10,16,2022,01-20,15:21
017 M�diath�que Emile Zola,10,6,16,2022,01-20,15:21
018 Nombre d'Or,12,4,16,2022,01-20,15:21
019 Louis Blanc,9,7,16,2022,01-20,15:21
020 Gambetta,1,7,8,2022,01-20,15:21
021 Port Marianne,8,8,16,2022,01-20,15:21
022 Clemenceau,7,5,12,2022,01-20,15:21
023 Les Arceaux,2,14,16,2022,01-20,15:21
024 Cit� Mion,3,5,8,2022,01-20,15:21
025 Nouveau Saint-Roch,1,7,8,2022,01-20,15:21
026 Renouvier,3,5,8,2022,01-20,15:21
027 Odysseum,4,4,8,2022,01-20,15:21
028 Saint-Denis,2,6,8,2022,01-20,15:21
029 Richter,9,7,16,2022,01-20,15:21
030 Charles Flahault,0,8,8,2022,01-20,15:21
031 Voltaire,1,7,8,2022,01-20,15:21
032 Pr�s d'Ar�nes,4,4,8,2022,01-20,15:21
033 Garcia Lorca,7,1,8,2022,01-20,15:21
034 Vert Bois,0,16,16,2022,01-20,15:21
035 Malbosc,3,5,8,2022,01-20,15:21
036 Occitanie,3,29,32,2022,01-20,15:21
037 FacdesSciences,3,21,24,2022,01-20,15:21
038 Fac de Lettres,5,11,16,2022,01-20,15:21
039 Aiguelongue,4,4,8,2022,01-20,15:21
040 Jeu de Mail des Abb�s,3,5,8,2022,01-20,15:21
041 Eurom�decine,3,5,8,2022,01-20,15:21
042 Marie Caizergues,3,5,8,2022,01-20,15:21
043 Sabines,4,4,8,2022,01-20,15:21
044 Celleneuve,2,6,8,2022,01-20,15:21
045 Jardin de la Lironde,3,5,8,2022,01-20,15:21
046 P�re Soulas,7,1,8,2022,01-20,15:21
047 Place Viala,2,6,8,2022,01-20,15:21
048 H�tel du D�partement,6,2,8,2022,01-20,15:21
049 Tonnelles,5,3,8,2022,01-20,15:21
050 Parvis Jules Ferry - Gare Saint-Roch,8,0,8,2022,01-20,15:21
051 Pont de Lattes - Gare Saint-Roch,0,12,12,2022,01-20,15:21
053 Deux Ponts - Gare Saint-Roch,2,6,8,2022,01-20,15:21
054 Providence - Ovalie,5,3,8,2022,01-20,15:21
055 P�rols Etang de l'Or,20,48,68,2022,01-20,15:21
056 Albert 1er - Cath�drale,6,6,12,2022,01-20,15:21
057 Saint-Guilhem - Courreau,4,4,8,2022,01-20,15:21
059 Sud De France,3,5,8,2022,01-20,15:21
001 Rue Jules Ferry - Gare Saint-Roch,5,7,12,2022,01-20,15:31
002 Com�die,19,5,24,2022,01-20,15:31
003 Esplanade,12,20,32,2022,01-20,15:31
004 H�tel de Ville,6,10,16,2022,01-20,15:31
005 Corum,4,8,12,2022,01-20,15:31
006 Place Albert 1er - St Charles,18,13,31,2022,01-20,15:31
007 Foch,6,2,8,2022,01-20,15:31
008 Halles Castellane,5,7,12,2022,01-20,15:31
009 Observatoire,6,2,8,2022,01-20,15:31
010 Rondelet,4,12,16,2022,01-20,15:31
011 Plan Cabanes,4,8,12,2022,01-20,15:31
012 Boutonnet,10,2,12,2022,01-20,15:31
013 Emile Combes,6,2,8,2022,01-20,15:31
014 Beaux-Arts,1,7,8,2022,01-20,15:31
015 Les Aubes,1,7,8,2022,01-20,15:31
016 Antigone centre,5,11,16,2022,01-20,15:31
017 M�diath�que Emile Zola,10,6,16,2022,01-20,15:31
018 Nombre d'Or,12,4,16,2022,01-20,15:31
019 Louis Blanc,9,7,16,2022,01-20,15:31
020 Gambetta,1,7,8,2022,01-20,15:31
021 Port Marianne,9,7,16,2022,01-20,15:31
022 Clemenceau,8,4,12,2022,01-20,15:31
023 Les Arceaux,2,14,16,2022,01-20,15:31
024 Cit� Mion,3,5,8,2022,01-20,15:31
025 Nouveau Saint-Roch,1,7,8,2022,01-20,15:31
026 Renouvier,2,6,8,2022,01-20,15:31
027 Odysseum,4,4,8,2022,01-20,15:31
028 Saint-Denis,2,6,8,2022,01-20,15:31
029 Richter,9,7,16,2022,01-20,15:31
030 Charles Flahault,0,8,8,2022,01-20,15:31
031 Voltaire,1,7,8,2022,01-20,15:31
032 Pr�s d'Ar�nes,4,4,8,2022,01-20,15:31
033 Garcia Lorca,7,1,8,2022,01-20,15:31
034 Vert Bois,0,16,16,2022,01-20,15:31
035 Malbosc,3,5,8,2022,01-20,15:31
036 Occitanie,3,29,32,2022,01-20,15:31
037 FacdesSciences,4,20,24,2022,01-20,15:31
038 Fac de Lettres,5,11,16,2022,01-20,15:31
039 Aiguelongue,4,4,8,2022,01-20,15:31
040 Jeu de Mail des Abb�s,3,5,8,2022,01-20,15:31
041 Eurom�decine,3,5,8,2022,01-20,15:31
042 Marie Caizergues,3,5,8,2022,01-20,15:31
043 Sabines,4,4,8,2022,01-20,15:31
044 Celleneuve,2,6,8,2022,01-20,15:31
045 Jardin de la Lironde,3,5,8,2022,01-20,15:31
046 P�re Soulas,5,3,8,2022,01-20,15:31
047 Place Viala,2,6,8,2022,01-20,15:31
048 H�tel du D�partement,6,2,8,2022,01-20,15:31
049 Tonnelles,4,4,8,2022,01-20,15:31
050 Parvis Jules Ferry - Gare Saint-Roch,8,0,8,2022,01-20,15:31
051 Pont de Lattes - Gare Saint-Roch,0,12,12,2022,01-20,15:31
053 Deux Ponts - Gare Saint-Roch,2,6,8,2022,01-20,15:31
054 Providence - Ovalie,4,4,8,2022,01-20,15:31
055 P�rols Etang de l'Or,20,48,68,2022,01-20,15:31
056 Albert 1er - Cath�drale,6,6,12,2022,01-20,15:31
057 Saint-Guilhem - Courreau,4,4,8,2022,01-20,15:31
059 Sud De France,3,5,8,2022,01-20,15:31
001 Rue Jules Ferry - Gare Saint-Roch,5,7,12,2022,01-20,15:41
002 Com�die,19,5,24,2022,01-20,15:41
003 Esplanade,12,20,32,2022,01-20,15:41
004 H�tel de Ville,4,12,16,2022,01-20,15:41
005 Corum,4,8,12,2022,01-20,15:41
006 Place Albert 1er - St Charles,18,13,31,2022,01-20,15:41
007 Foch,6,2,8,2022,01-20,15:41
008 Halles Castellane,5,7,12,2022,01-20,15:41
009 Observatoire,6,2,8,2022,01-20,15:41
010 Rondelet,4,12,16,2022,01-20,15:41
011 Plan Cabanes,4,8,12,2022,01-20,15:41
012 Boutonnet,10,2,12,2022,01-20,15:41
013 Emile Combes,6,2,8,2022,01-20,15:41
014 Beaux-Arts,1,7,8,2022,01-20,15:41
015 Les Aubes,1,7,8,2022,01-20,15:41
016 Antigone centre,5,11,16,2022,01-20,15:41
017 M�diath�que Emile Zola,10,6,16,2022,01-20,15:41
018 Nombre d'Or,12,4,16,2022,01-20,15:41
019 Louis Blanc,9,7,16,2022,01-20,15:41
020 Gambetta,1,7,8,2022,01-20,15:41
021 Port Marianne,9,7,16,2022,01-20,15:41
022 Clemenceau,8,4,12,2022,01-20,15:41
023 Les Arceaux,5,11,16,2022,01-20,15:41
024 Cit� Mion,3,5,8,2022,01-20,15:41
025 Nouveau Saint-Roch,2,6,8,2022,01-20,15:41
026 Renouvier,2,6,8,2022,01-20,15:41
027 Odysseum,5,3,8,2022,01-20,15:41
028 Saint-Denis,2,6,8,2022,01-20,15:41
029 Richter,8,8,16,2022,01-20,15:41
030 Charles Flahault,0,8,8,2022,01-20,15:41
031 Voltaire,1,7,8,2022,01-20,15:41
032 Pr�s d'Ar�nes,4,4,8,2022,01-20,15:41
033 Garcia Lorca,7,1,8,2022,01-20,15:41
034 Vert Bois,0,16,16,2022,01-20,15:41
035 Malbosc,3,5,8,2022,01-20,15:41
036 Occitanie,3,29,32,2022,01-20,15:41
037 FacdesSciences,4,20,24,2022,01-20,15:41
038 Fac de Lettres,4,12,16,2022,01-20,15:41
039 Aiguelongue,4,4,8,2022,01-20,15:41
040 Jeu de Mail des Abb�s,3,5,8,2022,01-20,15:41
041 Eurom�decine,3,5,8,2022,01-20,15:41
042 Marie Caizergues,3,5,8,2022,01-20,15:41
043 Sabines,4,4,8,2022,01-20,15:41
044 Celleneuve,2,6,8,2022,01-20,15:41
045 Jardin de la Lironde,3,5,8,2022,01-20,15:41
046 P�re Soulas,5,3,8,2022,01-20,15:41
047 Place Viala,2,6,8,2022,01-20,15:41
048 H�tel du D�partement,6,2,8,2022,01-20,15:41
049 Tonnelles,4,4,8,2022,01-20,15:41
050 Parvis Jules Ferry - Gare Saint-Roch,8,0,8,2022,01-20,15:41
051 Pont de Lattes - Gare Saint-Roch,0,12,12,2022,01-20,15:41
053 Deux Ponts - Gare Saint-Roch,2,6,8,2022,01-20,15:41
054 Providence - Ovalie,4,4,8,2022,01-20,15:41
055 P�rols Etang de l'Or,21,47,68,2022,01-20,15:41
056 Albert 1er - Cath�drale,5,7,12,2022,01-20,15:41
057 Saint-Guilhem - Courreau,4,4,8,2022,01-20,15:41
059 Sud De France,3,5,8,2022,01-20,15:41
001 Rue Jules Ferry - Gare Saint-Roch,5,7,12,2022,01-20,15:51
002 Com�die,19,5,24,2022,01-20,15:51
003 Esplanade,13,19,32,2022,01-20,15:51
004 H�tel de Ville,4,12,16,2022,01-20,15:51
005 Corum,4,8,12,2022,01-20,15:51
006 Place Albert 1er - St Charles,18,13,31,2022,01-20,15:51
007 Foch,6,2,8,2022,01-20,15:51
008 Halles Castellane,5,7,12,2022,01-20,15:51
009 Observatoire,6,2,8,2022,01-20,15:51
010 Rondelet,3,13,16,2022,01-20,15:51
011 Plan Cabanes,3,9,12,2022,01-20,15:51
012 Boutonnet,10,2,12,2022,01-20,15:51
013 Emile Combes,6,2,8,2022,01-20,15:51
014 Beaux-Arts,1,7,8,2022,01-20,15:51
015 Les Aubes,2,6,8,2022,01-20,15:51
016 Antigone centre,5,11,16,2022,01-20,15:51
017 M�diath�que Emile Zola,10,6,16,2022,01-20,15:51
018 Nombre d'Or,12,4,16,2022,01-20,15:51
019 Louis Blanc,9,7,16,2022,01-20,15:51
020 Gambetta,1,7,8,2022,01-20,15:51
021 Port Marianne,8,8,16,2022,01-20,15:51
022 Clemenceau,8,4,12,2022,01-20,15:51
023 Les Arceaux,5,11,16,2022,01-20,15:51
024 Cit� Mion,3,5,8,2022,01-20,15:51
025 Nouveau Saint-Roch,2,6,8,2022,01-20,15:51
026 Renouvier,2,6,8,2022,01-20,15:51
027 Odysseum,5,3,8,2022,01-20,15:51
028 Saint-Denis,2,6,8,2022,01-20,15:51
029 Richter,7,9,16,2022,01-20,15:51
030 Charles Flahault,0,8,8,2022,01-20,15:51
031 Voltaire,1,7,8,2022,01-20,15:51
032 Pr�s d'Ar�nes,4,4,8,2022,01-20,15:51
033 Garcia Lorca,8,0,8,2022,01-20,15:51
034 Vert Bois,0,16,16,2022,01-20,15:51
035 Malbosc,3,5,8,2022,01-20,15:51
036 Occitanie,3,29,32,2022,01-20,15:51
037 FacdesSciences,4,20,24,2022,01-20,15:51
038 Fac de Lettres,4,12,16,2022,01-20,15:51
039 Aiguelongue,4,4,8,2022,01-20,15:51
040 Jeu de Mail des Abb�s,3,5,8,2022,01-20,15:51
041 Eurom�decine,3,5,8,2022,01-20,15:51
042 Marie Caizergues,3,5,8,2022,01-20,15:51
043 Sabines,4,4,8,2022,01-20,15:51
044 Celleneuve,1,7,8,2022,01-20,15:51
045 Jardin de la Lironde,3,5,8,2022,01-20,15:51
046 P�re Soulas,5,3,8,2022,01-20,15:51
047 Place Viala,2,6,8,2022,01-20,15:51
048 H�tel du D�partement,6,2,8,2022,01-20,15:51
049 Tonnelles,4,4,8,2022,01-20,15:51
050 Parvis Jules Ferry - Gare Saint-Roch,8,0,8,2022,01-20,15:51
051 Pont de Lattes - Gare Saint-Roch,0,12,12,2022,01-20,15:51
053 Deux Ponts - Gare Saint-Roch,2,6,8,2022,01-20,15:51
054 Providence - Ovalie,4,4,8,2022,01-20,15:51
055 P�rols Etang de l'Or,21,47,68,2022,01-20,15:51
056 Albert 1er - Cath�drale,5,7,12,2022,01-20,15:51
057 Saint-Guilhem - Courreau,5,3,8,2022,01-20,15:51
059 Sud De France,3,5,8,2022,01-20,15:51
001 Rue Jules Ferry - Gare Saint-Roch,5,7,12,2022,01-20,16:01
002 Com�die,19,5,24,2022,01-20,16:01
003 Esplanade,13,19,32,2022,01-20,16:01
004 H�tel de Ville,5,11,16,2022,01-20,16:01
005 Corum,4,8,12,2022,01-20,16:01
006 Place Albert 1er - St Charles,18,13,31,2022,01-20,16:01
007 Foch,6,2,8,2022,01-20,16:01
008 Halles Castellane,5,7,12,2022,01-20,16:01
009 Observatoire,6,2,8,2022,01-20,16:01
010 Rondelet,3,13,16,2022,01-20,16:01
011 Plan Cabanes,4,8,12,2022,01-20,16:01
012 Boutonnet,9,3,12,2022,01-20,16:01
013 Emile Combes,6,2,8,2022,01-20,16:01
014 Beaux-Arts,1,7,8,2022,01-20,16:01
015 Les Aubes,2,6,8,2022,01-20,16:01
016 Antigone centre,5,11,16,2022,01-20,16:01
017 M�diath�que Emile Zola,10,6,16,2022,01-20,16:01
018 Nombre d'Or,13,3,16,2022,01-20,16:01
019 Louis Blanc,9,7,16,2022,01-20,16:01
020 Gambetta,1,7,8,2022,01-20,16:01
021 Port Marianne,9,7,16,2022,01-20,16:01
022 Clemenceau,8,4,12,2022,01-20,16:01
023 Les Arceaux,5,11,16,2022,01-20,16:01
024 Cit� Mion,3,5,8,2022,01-20,16:01
025 Nouveau Saint-Roch,2,6,8,2022,01-20,16:01
026 Renouvier,2,6,8,2022,01-20,16:01
027 Odysseum,5,3,8,2022,01-20,16:01
028 Saint-Denis,2,6,8,2022,01-20,16:01
029 Richter,7,9,16,2022,01-20,16:01
030 Charles Flahault,0,8,8,2022,01-20,16:01
031 Voltaire,1,7,8,2022,01-20,16:01
032 Pr�s d'Ar�nes,4,4,8,2022,01-20,16:01
033 Garcia Lorca,8,0,8,2022,01-20,16:01
034 Vert Bois,0,16,16,2022,01-20,16:01
035 Malbosc,3,5,8,2022,01-20,16:01
036 Occitanie,3,29,32,2022,01-20,16:01
037 FacdesSciences,4,20,24,2022,01-20,16:01
038 Fac de Lettres,4,12,16,2022,01-20,16:01
039 Aiguelongue,4,4,8,2022,01-20,16:01
040 Jeu de Mail des Abb�s,3,5,8,2022,01-20,16:01
041 Eurom�decine,3,5,8,2022,01-20,16:01
042 Marie Caizergues,3,5,8,2022,01-20,16:01
043 Sabines,4,4,8,2022,01-20,16:01
044 Celleneuve,1,7,8,2022,01-20,16:01
045 Jardin de la Lironde,3,5,8,2022,01-20,16:01
046 P�re Soulas,5,3,8,2022,01-20,16:01
047 Place Viala,2,6,8,2022,01-20,16:01
048 H�tel du D�partement,6,2,8,2022,01-20,16:01
049 Tonnelles,4,4,8,2022,01-20,16:01
050 Parvis Jules Ferry - Gare Saint-Roch,8,0,8,2022,01-20,16:01
051 Pont de Lattes - Gare Saint-Roch,0,12,12,2022,01-20,16:01
053 Deux Ponts - Gare Saint-Roch,2,6,8,2022,01-20,16:01
054 Providence - Ovalie,4,4,8,2022,01-20,16:01
055 P�rols Etang de l'Or,15,53,68,2022,01-20,16:01
056 Albert 1er - Cath�drale,5,7,12,2022,01-20,16:01
057 Saint-Guilhem - Courreau,5,3,8,2022,01-20,16:01
059 Sud De France,3,5,8,2022,01-20,16:01
001 Rue Jules Ferry - Gare Saint-Roch,5,7,12,2022,01-20,16:11
002 Com�die,15,9,24,2022,01-20,16:11
003 Esplanade,12,20,32,2022,01-20,16:11
004 H�tel de Ville,5,11,16,2022,01-20,16:11
005 Corum,4,8,12,2022,01-20,16:11
006 Place Albert 1er - St Charles,18,13,31,2022,01-20,16:11
007 Foch,6,2,8,2022,01-20,16:11
008 Halles Castellane,2,10,12,2022,01-20,16:11
009 Observatoire,6,2,8,2022,01-20,16:11
010 Rondelet,3,13,16,2022,01-20,16:11
011 Plan Cabanes,3,9,12,2022,01-20,16:11
012 Boutonnet,8,4,12,2022,01-20,16:11
013 Emile Combes,6,2,8,2022,01-20,16:11
014 Beaux-Arts,1,7,8,2022,01-20,16:11
015 Les Aubes,2,6,8,2022,01-20,16:11
016 Antigone centre,5,11,16,2022,01-20,16:11
017 M�diath�que Emile Zola,10,6,16,2022,01-20,16:11
018 Nombre d'Or,13,3,16,2022,01-20,16:11
019 Louis Blanc,9,7,16,2022,01-20,16:11
020 Gambetta,1,7,8,2022,01-20,16:11
021 Port Marianne,9,7,16,2022,01-20,16:11
022 Clemenceau,8,4,12,2022,01-20,16:11
023 Les Arceaux,5,11,16,2022,01-20,16:11
024 Cit� Mion,3,5,8,2022,01-20,16:11
025 Nouveau Saint-Roch,1,7,8,2022,01-20,16:11
026 Renouvier,2,6,8,2022,01-20,16:11
027 Odysseum,3,5,8,2022,01-20,16:11
028 Saint-Denis,3,5,8,2022,01-20,16:11
029 Richter,7,9,16,2022,01-20,16:11
030 Charles Flahault,0,8,8,2022,01-20,16:11
031 Voltaire,1,7,8,2022,01-20,16:11
032 Pr�s d'Ar�nes,4,4,8,2022,01-20,16:11
033 Garcia Lorca,7,1,8,2022,01-20,16:11
034 Vert Bois,0,16,16,2022,01-20,16:11
035 Malbosc,3,5,8,2022,01-20,16:11
036 Occitanie,3,29,32,2022,01-20,16:11
037 FacdesSciences,4,20,24,2022,01-20,16:11
038 Fac de Lettres,4,12,16,2022,01-20,16:11
039 Aiguelongue,4,4,8,2022,01-20,16:11
040 Jeu de Mail des Abb�s,2,6,8,2022,01-20,16:11
041 Eurom�decine,3,5,8,2022,01-20,16:11
042 Marie Caizergues,3,5,8,2022,01-20,16:11
043 Sabines,4,4,8,2022,01-20,16:11
044 Celleneuve,1,7,8,2022,01-20,16:11
045 Jardin de la Lironde,3,5,8,2022,01-20,16:11
046 P�re Soulas,5,3,8,2022,01-20,16:11
047 Place Viala,2,6,8,2022,01-20,16:11
048 H�tel du D�partement,6,2,8,2022,01-20,16:11
049 Tonnelles,4,4,8,2022,01-20,16:11
050 Parvis Jules Ferry - Gare Saint-Roch,8,0,8,2022,01-20,16:11
051 Pont de Lattes - Gare Saint-Roch,0,12,12,2022,01-20,16:11
053 Deux Ponts - Gare Saint-Roch,2,6,8,2022,01-20,16:11
054 Providence - Ovalie,4,4,8,2022,01-20,16:11
055 P�rols Etang de l'Or,10,58,68,2022,01-20,16:11
056 Albert 1er - Cath�drale,5,7,12,2022,01-20,16:11
057 Saint-Guilhem - Courreau,5,3,8,2022,01-20,16:11
059 Sud De France,3,5,8,2022,01-20,16:11
001 Rue Jules Ferry - Gare Saint-Roch,5,7,12,2022,01-20,16:22
002 Com�die,15,9,24,2022,01-20,16:22
003 Esplanade,12,20,32,2022,01-20,16:22
004 H�tel de Ville,5,11,16,2022,01-20,16:22
005 Corum,4,8,12,2022,01-20,16:22
006 Place Albert 1er - St Charles,19,12,31,2022,01-20,16:22
007 Foch,6,2,8,2022,01-20,16:22
008 Halles Castellane,2,10,12,2022,01-20,16:22
009 Observatoire,6,2,8,2022,01-20,16:22
010 Rondelet,4,12,16,2022,01-20,16:22
011 Plan Cabanes,2,10,12,2022,01-20,16:22
012 Boutonnet,8,4,12,2022,01-20,16:22
013 Emile Combes,6,2,8,2022,01-20,16:22
014 Beaux-Arts,1,7,8,2022,01-20,16:22
015 Les Aubes,2,6,8,2022,01-20,16:22
016 Antigone centre,5,11,16,2022,01-20,16:22
017 M�diath�que Emile Zola,10,6,16,2022,01-20,16:22
018 Nombre d'Or,13,3,16,2022,01-20,16:22
019 Louis Blanc,10,6,16,2022,01-20,16:22
020 Gambetta,1,7,8,2022,01-20,16:22
021 Port Marianne,12,4,16,2022,01-20,16:22
022 Clemenceau,8,4,12,2022,01-20,16:22
023 Les Arceaux,4,12,16,2022,01-20,16:22
024 Cit� Mion,3,5,8,2022,01-20,16:22
025 Nouveau Saint-Roch,1,7,8,2022,01-20,16:22
026 Renouvier,2,6,8,2022,01-20,16:22
027 Odysseum,3,5,8,2022,01-20,16:22
028 Saint-Denis,3,5,8,2022,01-20,16:22
029 Richter,7,9,16,2022,01-20,16:22
030 Charles Flahault,0,8,8,2022,01-20,16:22
031 Voltaire,2,6,8,2022,01-20,16:22
032 Pr�s d'Ar�nes,4,4,8,2022,01-20,16:22
033 Garcia Lorca,8,0,8,2022,01-20,16:22
034 Vert Bois,0,16,16,2022,01-20,16:22
035 Malbosc,3,5,8,2022,01-20,16:22
036 Occitanie,2,30,32,2022,01-20,16:22
037 FacdesSciences,2,22,24,2022,01-20,16:22
038 Fac de Lettres,4,12,16,2022,01-20,16:22
039 Aiguelongue,4,4,8,2022,01-20,16:22
040 Jeu de Mail des Abb�s,2,6,8,2022,01-20,16:22
041 Eurom�decine,3,5,8,2022,01-20,16:22
042 Marie Caizergues,4,4,8,2022,01-20,16:22
043 Sabines,4,4,8,2022,01-20,16:22
044 Celleneuve,1,7,8,2022,01-20,16:22
045 Jardin de la Lironde,3,5,8,2022,01-20,16:22
046 P�re Soulas,5,3,8,2022,01-20,16:22
047 Place Viala,2,6,8,2022,01-20,16:22
048 H�tel du D�partement,6,2,8,2022,01-20,16:22
049 Tonnelles,4,4,8,2022,01-20,16:22
050 Parvis Jules Ferry - Gare Saint-Roch,8,0,8,2022,01-20,16:22
051 Pont de Lattes - Gare Saint-Roch,0,12,12,2022,01-20,16:22
053 Deux Ponts - Gare Saint-Roch,2,6,8,2022,01-20,16:22
054 Providence - Ovalie,4,4,8,2022,01-20,16:22
055 P�rols Etang de l'Or,10,58,68,2022,01-20,16:22
056 Albert 1er - Cath�drale,6,6,12,2022,01-20,16:22
057 Saint-Guilhem - Courreau,5,3,8,2022,01-20,16:22
059 Sud De France,3,5,8,2022,01-20,16:22
001 Rue Jules Ferry - Gare Saint-Roch,5,7,12,2022,01-20,16:32
002 Com�die,15,9,24,2022,01-20,16:32
003 Esplanade,12,20,32,2022,01-20,16:32
004 H�tel de Ville,4,12,16,2022,01-20,16:32
005 Corum,4,8,12,2022,01-20,16:32
006 Place Albert 1er - St Charles,19,12,31,2022,01-20,16:32
007 Foch,6,2,8,2022,01-20,16:32
008 Halles Castellane,2,10,12,2022,01-20,16:32
009 Observatoire,6,2,8,2022,01-20,16:32
010 Rondelet,4,12,16,2022,01-20,16:32
011 Plan Cabanes,2,10,12,2022,01-20,16:32
012 Boutonnet,8,4,12,2022,01-20,16:32
013 Emile Combes,6,2,8,2022,01-20,16:32
014 Beaux-Arts,1,7,8,2022,01-20,16:32
015 Les Aubes,2,6,8,2022,01-20,16:32
016 Antigone centre,6,10,16,2022,01-20,16:32
017 M�diath�que Emile Zola,10,6,16,2022,01-20,16:32
018 Nombre d'Or,13,3,16,2022,01-20,16:32
019 Louis Blanc,10,6,16,2022,01-20,16:32
020 Gambetta,1,7,8,2022,01-20,16:32
021 Port Marianne,12,4,16,2022,01-20,16:32
022 Clemenceau,8,4,12,2022,01-20,16:32
023 Les Arceaux,4,12,16,2022,01-20,16:32
024 Cit� Mion,3,5,8,2022,01-20,16:32
025 Nouveau Saint-Roch,1,7,8,2022,01-20,16:32
026 Renouvier,2,6,8,2022,01-20,16:32
027 Odysseum,3,5,8,2022,01-20,16:32
028 Saint-Denis,4,4,8,2022,01-20,16:32
029 Richter,7,9,16,2022,01-20,16:32
030 Charles Flahault,0,8,8,2022,01-20,16:32
031 Voltaire,2,6,8,2022,01-20,16:32
032 Pr�s d'Ar�nes,4,4,8,2022,01-20,16:32
033 Garcia Lorca,8,0,8,2022,01-20,16:32
034 Vert Bois,0,16,16,2022,01-20,16:32
035 Malbosc,3,5,8,2022,01-20,16:32
036 Occitanie,2,30,32,2022,01-20,16:32
037 FacdesSciences,2,22,24,2022,01-20,16:32
038 Fac de Lettres,4,12,16,2022,01-20,16:32
039 Aiguelongue,4,4,8,2022,01-20,16:32
040 Jeu de Mail des Abb�s,2,6,8,2022,01-20,16:32
041 Eurom�decine,3,5,8,2022,01-20,16:32
042 Marie Caizergues,4,4,8,2022,01-20,16:32
043 Sabines,4,4,8,2022,01-20,16:32
044 Celleneuve,1,7,8,2022,01-20,16:32
045 Jardin de la Lironde,3,5,8,2022,01-20,16:32
046 P�re Soulas,5,3,8,2022,01-20,16:32
047 Place Viala,2,6,8,2022,01-20,16:32
048 H�tel du D�partement,6,2,8,2022,01-20,16:32
049 Tonnelles,4,4,8,2022,01-20,16:32
050 Parvis Jules Ferry - Gare Saint-Roch,8,0,8,2022,01-20,16:32
051 Pont de Lattes - Gare Saint-Roch,0,12,12,2022,01-20,16:32
053 Deux Ponts - Gare Saint-Roch,2,6,8,2022,01-20,16:32
054 Providence - Ovalie,4,4,8,2022,01-20,16:32
055 P�rols Etang de l'Or,10,58,68,2022,01-20,16:32
056 Albert 1er - Cath�drale,6,6,12,2022,01-20,16:32
057 Saint-Guilhem - Courreau,5,3,8,2022,01-20,16:32
059 Sud De France,3,5,8,2022,01-20,16:32
001 Rue Jules Ferry - Gare Saint-Roch,4,8,12,2022,01-20,16:42
002 Com�die,15,9,24,2022,01-20,16:42
003 Esplanade,10,22,32,2022,01-20,16:42
004 H�tel de Ville,4,12,16,2022,01-20,16:42
005 Corum,3,9,12,2022,01-20,16:42
006 Place Albert 1er - St Charles,19,12,31,2022,01-20,16:42
007 Foch,6,2,8,2022,01-20,16:42
008 Halles Castellane,2,10,12,2022,01-20,16:42
009 Observatoire,6,2,8,2022,01-20,16:42
010 Rondelet,4,12,16,2022,01-20,16:42
011 Plan Cabanes,2,10,12,2022,01-20,16:42
012 Boutonnet,9,3,12,2022,01-20,16:42
013 Emile Combes,6,2,8,2022,01-20,16:42
014 Beaux-Arts,0,8,8,2022,01-20,16:42
015 Les Aubes,2,6,8,2022,01-20,16:42
016 Antigone centre,6,10,16,2022,01-20,16:42
017 M�diath�que Emile Zola,10,6,16,2022,01-20,16:42
018 Nombre d'Or,13,3,16,2022,01-20,16:42
019 Louis Blanc,10,6,16,2022,01-20,16:42
020 Gambetta,1,7,8,2022,01-20,16:42
021 Port Marianne,12,4,16,2022,01-20,16:42
022 Clemenceau,10,2,12,2022,01-20,16:42
023 Les Arceaux,4,12,16,2022,01-20,16:42
024 Cit� Mion,3,5,8,2022,01-20,16:42
025 Nouveau Saint-Roch,1,7,8,2022,01-20,16:42
026 Renouvier,2,6,8,2022,01-20,16:42
027 Odysseum,3,5,8,2022,01-20,16:42
028 Saint-Denis,4,4,8,2022,01-20,16:42
029 Richter,7,9,16,2022,01-20,16:42
030 Charles Flahault,0,8,8,2022,01-20,16:42
031 Voltaire,2,6,8,2022,01-20,16:42
032 Pr�s d'Ar�nes,4,4,8,2022,01-20,16:42
033 Garcia Lorca,8,0,8,2022,01-20,16:42
034 Vert Bois,0,16,16,2022,01-20,16:42
035 Malbosc,3,5,8,2022,01-20,16:42
036 Occitanie,2,30,32,2022,01-20,16:42
037 FacdesSciences,2,22,24,2022,01-20,16:42
038 Fac de Lettres,2,14,16,2022,01-20,16:42
039 Aiguelongue,4,4,8,2022,01-20,16:42
040 Jeu de Mail des Abb�s,2,6,8,2022,01-20,16:42
041 Eurom�decine,3,5,8,2022,01-20,16:42
042 Marie Caizergues,4,4,8,2022,01-20,16:42
043 Sabines,4,4,8,2022,01-20,16:42
044 Celleneuve,1,7,8,2022,01-20,16:42
045 Jardin de la Lironde,3,5,8,2022,01-20,16:42
046 P�re Soulas,5,3,8,2022,01-20,16:42
047 Place Viala,2,6,8,2022,01-20,16:42
048 H�tel du D�partement,6,2,8,2022,01-20,16:42
049 Tonnelles,4,4,8,2022,01-20,16:42
050 Parvis Jules Ferry - Gare Saint-Roch,8,0,8,2022,01-20,16:42
051 Pont de Lattes - Gare Saint-Roch,0,12,12,2022,01-20,16:42
053 Deux Ponts - Gare Saint-Roch,2,6,8,2022,01-20,16:42
054 Providence - Ovalie,4,4,8,2022,01-20,16:42
055 P�rols Etang de l'Or,10,58,68,2022,01-20,16:42
056 Albert 1er - Cath�drale,6,6,12,2022,01-20,16:42
057 Saint-Guilhem - Courreau,5,3,8,2022,01-20,16:42
059 Sud De France,3,5,8,2022,01-20,16:42
001 Rue Jules Ferry - Gare Saint-Roch,4,8,12,2022,01-20,16:52
002 Com�die,15,9,24,2022,01-20,16:52
003 Esplanade,10,22,32,2022,01-20,16:52
004 H�tel de Ville,4,12,16,2022,01-20,16:52
005 Corum,3,9,12,2022,01-20,16:52
006 Place Albert 1er - St Charles,19,12,31,2022,01-20,16:52
007 Foch,6,2,8,2022,01-20,16:52
008 Halles Castellane,2,10,12,2022,01-20,16:52
009 Observatoire,6,2,8,2022,01-20,16:52
010 Rondelet,5,11,16,2022,01-20,16:52
011 Plan Cabanes,2,10,12,2022,01-20,16:52
012 Boutonnet,10,2,12,2022,01-20,16:52
013 Emile Combes,5,3,8,2022,01-20,16:52
014 Beaux-Arts,0,8,8,2022,01-20,16:52
015 Les Aubes,2,6,8,2022,01-20,16:52
016 Antigone centre,6,10,16,2022,01-20,16:52
017 M�diath�que Emile Zola,10,6,16,2022,01-20,16:52
018 Nombre d'Or,13,3,16,2022,01-20,16:52
019 Louis Blanc,11,5,16,2022,01-20,16:52
020 Gambetta,1,7,8,2022,01-20,16:52
021 Port Marianne,13,3,16,2022,01-20,16:52
022 Clemenceau,10,2,12,2022,01-20,16:52
023 Les Arceaux,4,12,16,2022,01-20,16:52
024 Cit� Mion,3,5,8,2022,01-20,16:52
025 Nouveau Saint-Roch,1,7,8,2022,01-20,16:52
026 Renouvier,2,6,8,2022,01-20,16:52
027 Odysseum,3,5,8,2022,01-20,16:52
028 Saint-Denis,5,3,8,2022,01-20,16:52
029 Richter,7,9,16,2022,01-20,16:52
030 Charles Flahault,0,8,8,2022,01-20,16:52
031 Voltaire,2,6,8,2022,01-20,16:52
032 Pr�s d'Ar�nes,4,4,8,2022,01-20,16:52
033 Garcia Lorca,8,0,8,2022,01-20,16:52
034 Vert Bois,0,16,16,2022,01-20,16:52
035 Malbosc,3,5,8,2022,01-20,16:52
036 Occitanie,2,30,32,2022,01-20,16:52
037 FacdesSciences,1,23,24,2022,01-20,16:52
038 Fac de Lettres,2,14,16,2022,01-20,16:52
039 Aiguelongue,4,4,8,2022,01-20,16:52
040 Jeu de Mail des Abb�s,2,6,8,2022,01-20,16:52
041 Eurom�decine,3,5,8,2022,01-20,16:52
042 Marie Caizergues,5,3,8,2022,01-20,16:52
043 Sabines,4,4,8,2022,01-20,16:52
044 Celleneuve,1,7,8,2022,01-20,16:52
045 Jardin de la Lironde,3,5,8,2022,01-20,16:52
046 P�re Soulas,4,4,8,2022,01-20,16:52
047 Place Viala,3,5,8,2022,01-20,16:52
048 H�tel du D�partement,6,2,8,2022,01-20,16:52
049 Tonnelles,4,4,8,2022,01-20,16:52
050 Parvis Jules Ferry - Gare Saint-Roch,8,0,8,2022,01-20,16:52
051 Pont de Lattes - Gare Saint-Roch,0,12,12,2022,01-20,16:52
053 Deux Ponts - Gare Saint-Roch,2,6,8,2022,01-20,16:52
054 Providence - Ovalie,4,4,8,2022,01-20,16:52
055 P�rols Etang de l'Or,10,58,68,2022,01-20,16:52
056 Albert 1er - Cath�drale,6,6,12,2022,01-20,16:52
057 Saint-Guilhem - Courreau,5,3,8,2022,01-20,16:52
059 Sud De France,3,5,8,2022,01-20,16:52
001 Rue Jules Ferry - Gare Saint-Roch,3,9,12,2022,01-20,17:02
002 Com�die,15,9,24,2022,01-20,17:02
003 Esplanade,8,24,32,2022,01-20,17:02
004 H�tel de Ville,5,11,16,2022,01-20,17:02
005 Corum,2,10,12,2022,01-20,17:02
006 Place Albert 1er - St Charles,19,12,31,2022,01-20,17:02
007 Foch,6,2,8,2022,01-20,17:02
008 Halles Castellane,2,10,12,2022,01-20,17:02
009 Observatoire,6,2,8,2022,01-20,17:02
010 Rondelet,5,11,16,2022,01-20,17:02
011 Plan Cabanes,2,10,12,2022,01-20,17:02
012 Boutonnet,8,4,12,2022,01-20,17:02
013 Emile Combes,5,3,8,2022,01-20,17:02
014 Beaux-Arts,0,8,8,2022,01-20,17:02
015 Les Aubes,2,6,8,2022,01-20,17:02
016 Antigone centre,7,9,16,2022,01-20,17:02
017 M�diath�que Emile Zola,10,6,16,2022,01-20,17:02
018 Nombre d'Or,12,4,16,2022,01-20,17:02
019 Louis Blanc,11,5,16,2022,01-20,17:02
020 Gambetta,1,7,8,2022,01-20,17:02
021 Port Marianne,13,3,16,2022,01-20,17:02
022 Clemenceau,10,2,12,2022,01-20,17:02
023 Les Arceaux,4,12,16,2022,01-20,17:02
024 Cit� Mion,3,5,8,2022,01-20,17:02
025 Nouveau Saint-Roch,1,7,8,2022,01-20,17:02
026 Renouvier,2,6,8,2022,01-20,17:02
027 Odysseum,3,5,8,2022,01-20,17:02
028 Saint-Denis,5,3,8,2022,01-20,17:02
029 Richter,7,9,16,2022,01-20,17:02
030 Charles Flahault,0,8,8,2022,01-20,17:02
031 Voltaire,2,6,8,2022,01-20,17:02
032 Pr�s d'Ar�nes,4,4,8,2022,01-20,17:02
033 Garcia Lorca,8,0,8,2022,01-20,17:02
034 Vert Bois,0,16,16,2022,01-20,17:02
035 Malbosc,3,5,8,2022,01-20,17:02
036 Occitanie,3,29,32,2022,01-20,17:02
037 FacdesSciences,1,23,24,2022,01-20,17:02
038 Fac de Lettres,2,14,16,2022,01-20,17:02
039 Aiguelongue,4,4,8,2022,01-20,17:02
040 Jeu de Mail des Abb�s,2,6,8,2022,01-20,17:02
041 Eurom�decine,2,6,8,2022,01-20,17:02
042 Marie Caizergues,5,3,8,2022,01-20,17:02
043 Sabines,4,4,8,2022,01-20,17:02
044 Celleneuve,1,7,8,2022,01-20,17:02
045 Jardin de la Lironde,2,6,8,2022,01-20,17:02
046 P�re Soulas,4,4,8,2022,01-20,17:02
047 Place Viala,3,5,8,2022,01-20,17:02
048 H�tel du D�partement,6,2,8,2022,01-20,17:02
049 Tonnelles,4,4,8,2022,01-20,17:02
050 Parvis Jules Ferry - Gare Saint-Roch,8,0,8,2022,01-20,17:02
051 Pont de Lattes - Gare Saint-Roch,0,12,12,2022,01-20,17:02
053 Deux Ponts - Gare Saint-Roch,1,7,8,2022,01-20,17:02
054 Providence - Ovalie,4,4,8,2022,01-20,17:02
055 P�rols Etang de l'Or,7,61,68,2022,01-20,17:02
056 Albert 1er - Cath�drale,6,6,12,2022,01-20,17:02
057 Saint-Guilhem - Courreau,5,3,8,2022,01-20,17:02
059 Sud De France,3,5,8,2022,01-20,17:02
001 Rue Jules Ferry - Gare Saint-Roch,4,8,12,2022,01-20,17:12
002 Com�die,18,6,24,2022,01-20,17:12
003 Esplanade,8,24,32,2022,01-20,17:12
004 H�tel de Ville,7,9,16,2022,01-20,17:12
005 Corum,2,10,12,2022,01-20,17:12
006 Place Albert 1er - St Charles,19,12,31,2022,01-20,17:12
007 Foch,7,1,8,2022,01-20,17:12
008 Halles Castellane,1,11,12,2022,01-20,17:12
009 Observatoire,7,1,8,2022,01-20,17:12
010 Rondelet,5,11,16,2022,01-20,17:12
011 Plan Cabanes,2,10,12,2022,01-20,17:12
012 Boutonnet,8,4,12,2022,01-20,17:12
013 Emile Combes,5,3,8,2022,01-20,17:12
014 Beaux-Arts,0,8,8,2022,01-20,17:12
015 Les Aubes,3,5,8,2022,01-20,17:12
016 Antigone centre,7,9,16,2022,01-20,17:12
017 M�diath�que Emile Zola,9,7,16,2022,01-20,17:12
018 Nombre d'Or,13,3,16,2022,01-20,17:12
019 Louis Blanc,11,5,16,2022,01-20,17:12
020 Gambetta,1,7,8,2022,01-20,17:12
021 Port Marianne,13,3,16,2022,01-20,17:12
022 Clemenceau,8,4,12,2022,01-20,17:12
023 Les Arceaux,5,11,16,2022,01-20,17:12
024 Cit� Mion,3,5,8,2022,01-20,17:12
025 Nouveau Saint-Roch,2,6,8,2022,01-20,17:12
026 Renouvier,2,6,8,2022,01-20,17:12
027 Odysseum,3,5,8,2022,01-20,17:12
028 Saint-Denis,4,4,8,2022,01-20,17:12
029 Richter,8,8,16,2022,01-20,17:12
030 Charles Flahault,0,8,8,2022,01-20,17:12
031 Voltaire,2,6,8,2022,01-20,17:12
032 Pr�s d'Ar�nes,4,4,8,2022,01-20,17:12
033 Garcia Lorca,8,0,8,2022,01-20,17:12
034 Vert Bois,0,16,16,2022,01-20,17:12
035 Malbosc,3,5,8,2022,01-20,17:12
036 Occitanie,2,30,32,2022,01-20,17:12
037 FacdesSciences,2,22,24,2022,01-20,17:12
038 Fac de Lettres,2,14,16,2022,01-20,17:12
039 Aiguelongue,4,4,8,2022,01-20,17:12
040 Jeu de Mail des Abb�s,2,6,8,2022,01-20,17:12
041 Eurom�decine,2,6,8,2022,01-20,17:12
042 Marie Caizergues,6,2,8,2022,01-20,17:12
043 Sabines,4,4,8,2022,01-20,17:12
044 Celleneuve,1,7,8,2022,01-20,17:12
045 Jardin de la Lironde,1,7,8,2022,01-20,17:12
046 P�re Soulas,4,4,8,2022,01-20,17:12
047 Place Viala,3,5,8,2022,01-20,17:12
048 H�tel du D�partement,6,2,8,2022,01-20,17:12
049 Tonnelles,4,4,8,2022,01-20,17:12
050 Parvis Jules Ferry - Gare Saint-Roch,7,1,8,2022,01-20,17:12
051 Pont de Lattes - Gare Saint-Roch,0,12,12,2022,01-20,17:12
053 Deux Ponts - Gare Saint-Roch,1,7,8,2022,01-20,17:12
054 Providence - Ovalie,4,4,8,2022,01-20,17:12
055 P�rols Etang de l'Or,7,61,68,2022,01-20,17:12
056 Albert 1er - Cath�drale,6,6,12,2022,01-20,17:12
057 Saint-Guilhem - Courreau,5,3,8,2022,01-20,17:12
059 Sud De France,3,5,8,2022,01-20,17:12
001 Rue Jules Ferry - Gare Saint-Roch,4,8,12,2022,01-20,17:23
002 Com�die,18,6,24,2022,01-20,17:23
003 Esplanade,9,23,32,2022,01-20,17:23
004 H�tel de Ville,7,9,16,2022,01-20,17:23
005 Corum,2,10,12,2022,01-20,17:23
006 Place Albert 1er - St Charles,19,12,31,2022,01-20,17:23
007 Foch,7,1,8,2022,01-20,17:23
008 Halles Castellane,1,11,12,2022,01-20,17:23
009 Observatoire,7,1,8,2022,01-20,17:23
010 Rondelet,5,11,16,2022,01-20,17:23
011 Plan Cabanes,1,11,12,2022,01-20,17:23
012 Boutonnet,9,3,12,2022,01-20,17:23
013 Emile Combes,5,3,8,2022,01-20,17:23
014 Beaux-Arts,0,8,8,2022,01-20,17:23
015 Les Aubes,3,5,8,2022,01-20,17:23
016 Antigone centre,6,10,16,2022,01-20,17:23
017 M�diath�que Emile Zola,8,8,16,2022,01-20,17:23
018 Nombre d'Or,13,3,16,2022,01-20,17:23
019 Louis Blanc,11,5,16,2022,01-20,17:23
020 Gambetta,1,7,8,2022,01-20,17:23
021 Port Marianne,13,3,16,2022,01-20,17:23
022 Clemenceau,8,4,12,2022,01-20,17:23
023 Les Arceaux,5,11,16,2022,01-20,17:23
024 Cit� Mion,3,5,8,2022,01-20,17:23
025 Nouveau Saint-Roch,2,6,8,2022,01-20,17:23
026 Renouvier,2,6,8,2022,01-20,17:23
027 Odysseum,3,5,8,2022,01-20,17:23
028 Saint-Denis,4,4,8,2022,01-20,17:23
029 Richter,8,8,16,2022,01-20,17:23
030 Charles Flahault,0,8,8,2022,01-20,17:23
031 Voltaire,2,6,8,2022,01-20,17:23
032 Pr�s d'Ar�nes,4,4,8,2022,01-20,17:23
033 Garcia Lorca,8,0,8,2022,01-20,17:23
034 Vert Bois,0,16,16,2022,01-20,17:23
035 Malbosc,2,6,8,2022,01-20,17:23
036 Occitanie,2,30,32,2022,01-20,17:23
037 FacdesSciences,2,22,24,2022,01-20,17:23
038 Fac de Lettres,4,12,16,2022,01-20,17:23
039 Aiguelongue,4,4,8,2022,01-20,17:23
040 Jeu de Mail des Abb�s,2,6,8,2022,01-20,17:23
041 Eurom�decine,2,6,8,2022,01-20,17:23
042 Marie Caizergues,7,1,8,2022,01-20,17:23
043 Sabines,4,4,8,2022,01-20,17:23
044 Celleneuve,1,7,8,2022,01-20,17:23
045 Jardin de la Lironde,1,7,8,2022,01-20,17:23
046 P�re Soulas,4,4,8,2022,01-20,17:23
047 Place Viala,2,6,8,2022,01-20,17:23
048 H�tel du D�partement,6,2,8,2022,01-20,17:23
049 Tonnelles,4,4,8,2022,01-20,17:23
050 Parvis Jules Ferry - Gare Saint-Roch,7,1,8,2022,01-20,17:23
051 Pont de Lattes - Gare Saint-Roch,0,12,12,2022,01-20,17:23
053 Deux Ponts - Gare Saint-Roch,1,7,8,2022,01-20,17:23
054 Providence - Ovalie,4,4,8,2022,01-20,17:23
055 P�rols Etang de l'Or,8,60,68,2022,01-20,17:23
056 Albert 1er - Cath�drale,6,6,12,2022,01-20,17:23
057 Saint-Guilhem - Courreau,5,3,8,2022,01-20,17:23
059 Sud De France,3,5,8,2022,01-20,17:23
001 Rue Jules Ferry - Gare Saint-Roch,4,8,12,2022,01-20,17:33
002 Com�die,15,9,24,2022,01-20,17:33
003 Esplanade,9,23,32,2022,01-20,17:33
004 H�tel de Ville,7,9,16,2022,01-20,17:33
005 Corum,2,10,12,2022,01-20,17:33
006 Place Albert 1er - St Charles,19,12,31,2022,01-20,17:33
007 Foch,7,1,8,2022,01-20,17:33
008 Halles Castellane,2,10,12,2022,01-20,17:33
009 Observatoire,7,1,8,2022,01-20,17:33
010 Rondelet,3,13,16,2022,01-20,17:33
011 Plan Cabanes,2,10,12,2022,01-20,17:33
012 Boutonnet,8,4,12,2022,01-20,17:33
013 Emile Combes,5,3,8,2022,01-20,17:33
014 Beaux-Arts,0,8,8,2022,01-20,17:33
015 Les Aubes,3,5,8,2022,01-20,17:33
016 Antigone centre,6,10,16,2022,01-20,17:33
017 M�diath�que Emile Zola,8,8,16,2022,01-20,17:33
018 Nombre d'Or,13,3,16,2022,01-20,17:33
019 Louis Blanc,11,5,16,2022,01-20,17:33
020 Gambetta,1,7,8,2022,01-20,17:33
021 Port Marianne,12,4,16,2022,01-20,17:33
022 Clemenceau,8,4,12,2022,01-20,17:33
023 Les Arceaux,5,11,16,2022,01-20,17:33
024 Cit� Mion,3,5,8,2022,01-20,17:33
025 Nouveau Saint-Roch,3,5,8,2022,01-20,17:33
026 Renouvier,2,6,8,2022,01-20,17:33
027 Odysseum,3,5,8,2022,01-20,17:33
028 Saint-Denis,5,3,8,2022,01-20,17:33
029 Richter,8,8,16,2022,01-20,17:33
030 Charles Flahault,0,8,8,2022,01-20,17:33
031 Voltaire,2,6,8,2022,01-20,17:33
032 Pr�s d'Ar�nes,4,4,8,2022,01-20,17:33
033 Garcia Lorca,8,0,8,2022,01-20,17:33
034 Vert Bois,0,16,16,2022,01-20,17:33
035 Malbosc,2,6,8,2022,01-20,17:33
036 Occitanie,2,30,32,2022,01-20,17:33
037 FacdesSciences,1,23,24,2022,01-20,17:33
038 Fac de Lettres,3,13,16,2022,01-20,17:33
039 Aiguelongue,4,4,8,2022,01-20,17:33
040 Jeu de Mail des Abb�s,2,6,8,2022,01-20,17:33
041 Eurom�decine,1,7,8,2022,01-20,17:33
042 Marie Caizergues,7,1,8,2022,01-20,17:33
043 Sabines,4,4,8,2022,01-20,17:33
044 Celleneuve,1,7,8,2022,01-20,17:33
045 Jardin de la Lironde,1,7,8,2022,01-20,17:33
046 P�re Soulas,5,3,8,2022,01-20,17:33
047 Place Viala,1,7,8,2022,01-20,17:33
048 H�tel du D�partement,6,2,8,2022,01-20,17:33
049 Tonnelles,4,4,8,2022,01-20,17:33
050 Parvis Jules Ferry - Gare Saint-Roch,8,0,8,2022,01-20,17:33
051 Pont de Lattes - Gare Saint-Roch,0,12,12,2022,01-20,17:33
053 Deux Ponts - Gare Saint-Roch,1,7,8,2022,01-20,17:33
054 Providence - Ovalie,4,4,8,2022,01-20,17:33
055 P�rols Etang de l'Or,12,56,68,2022,01-20,17:33
056 Albert 1er - Cath�drale,6,6,12,2022,01-20,17:33
057 Saint-Guilhem - Courreau,5,3,8,2022,01-20,17:33
059 Sud De France,3,5,8,2022,01-20,17:33
001 Rue Jules Ferry - Gare Saint-Roch,4,8,12,2022,01-20,17:43
002 Com�die,15,9,24,2022,01-20,17:43
003 Esplanade,9,23,32,2022,01-20,17:43
004 H�tel de Ville,7,9,16,2022,01-20,17:43
005 Corum,4,8,12,2022,01-20,17:43
006 Place Albert 1er - St Charles,20,11,31,2022,01-20,17:43
007 Foch,7,1,8,2022,01-20,17:43
008 Halles Castellane,2,10,12,2022,01-20,17:43
009 Observatoire,7,1,8,2022,01-20,17:43
010 Rondelet,3,13,16,2022,01-20,17:43
011 Plan Cabanes,1,11,12,2022,01-20,17:43
012 Boutonnet,9,3,12,2022,01-20,17:43
013 Emile Combes,5,3,8,2022,01-20,17:43
014 Beaux-Arts,0,8,8,2022,01-20,17:43
015 Les Aubes,3,5,8,2022,01-20,17:43
016 Antigone centre,5,11,16,2022,01-20,17:43
017 M�diath�que Emile Zola,11,5,16,2022,01-20,17:43
018 Nombre d'Or,14,2,16,2022,01-20,17:43
019 Louis Blanc,11,5,16,2022,01-20,17:43
020 Gambetta,1,7,8,2022,01-20,17:43
021 Port Marianne,12,4,16,2022,01-20,17:43
022 Clemenceau,7,5,12,2022,01-20,17:43
023 Les Arceaux,5,11,16,2022,01-20,17:43
024 Cit� Mion,3,5,8,2022,01-20,17:43
025 Nouveau Saint-Roch,3,5,8,2022,01-20,17:43
026 Renouvier,2,6,8,2022,01-20,17:43
027 Odysseum,3,5,8,2022,01-20,17:43
028 Saint-Denis,5,3,8,2022,01-20,17:43
029 Richter,8,8,16,2022,01-20,17:43
030 Charles Flahault,1,7,8,2022,01-20,17:43
031 Voltaire,3,5,8,2022,01-20,17:43
032 Pr�s d'Ar�nes,4,4,8,2022,01-20,17:43
033 Garcia Lorca,8,0,8,2022,01-20,17:43
034 Vert Bois,0,16,16,2022,01-20,17:43
035 Malbosc,2,6,8,2022,01-20,17:43
036 Occitanie,2,30,32,2022,01-20,17:43
037 FacdesSciences,1,23,24,2022,01-20,17:43
038 Fac de Lettres,3,13,16,2022,01-20,17:43
039 Aiguelongue,3,5,8,2022,01-20,17:43
040 Jeu de Mail des Abb�s,2,6,8,2022,01-20,17:43
041 Eurom�decine,1,7,8,2022,01-20,17:43
042 Marie Caizergues,7,1,8,2022,01-20,17:43
043 Sabines,4,4,8,2022,01-20,17:43
044 Celleneuve,2,6,8,2022,01-20,17:43
045 Jardin de la Lironde,1,7,8,2022,01-20,17:43
046 P�re Soulas,5,3,8,2022,01-20,17:43
047 Place Viala,0,8,8,2022,01-20,17:43
048 H�tel du D�partement,6,2,8,2022,01-20,17:43
049 Tonnelles,4,4,8,2022,01-20,17:43
050 Parvis Jules Ferry - Gare Saint-Roch,8,0,8,2022,01-20,17:43
051 Pont de Lattes - Gare Saint-Roch,0,12,12,2022,01-20,17:43
053 Deux Ponts - Gare Saint-Roch,1,7,8,2022,01-20,17:43
054 Providence - Ovalie,4,4,8,2022,01-20,17:43
055 P�rols Etang de l'Or,13,55,68,2022,01-20,17:43
056 Albert 1er - Cath�drale,5,7,12,2022,01-20,17:43
057 Saint-Guilhem - Courreau,5,3,8,2022,01-20,17:43
059 Sud De France,3,5,8,2022,01-20,17:43
001 Rue Jules Ferry - Gare Saint-Roch,4,8,12,2022,01-20,17:53
002 Com�die,15,9,24,2022,01-20,17:53
003 Esplanade,9,23,32,2022,01-20,17:53
004 H�tel de Ville,7,9,16,2022,01-20,17:53
005 Corum,5,7,12,2022,01-20,17:53
006 Place Albert 1er - St Charles,20,11,31,2022,01-20,17:53
007 Foch,7,1,8,2022,01-20,17:53
008 Halles Castellane,2,10,12,2022,01-20,17:53
009 Observatoire,8,0,8,2022,01-20,17:53
010 Rondelet,3,13,16,2022,01-20,17:53
011 Plan Cabanes,1,11,12,2022,01-20,17:53
012 Boutonnet,10,2,12,2022,01-20,17:53
013 Emile Combes,5,3,8,2022,01-20,17:53
014 Beaux-Arts,0,8,8,2022,01-20,17:53
015 Les Aubes,3,5,8,2022,01-20,17:53
016 Antigone centre,5,11,16,2022,01-20,17:53
017 M�diath�que Emile Zola,11,5,16,2022,01-20,17:53
018 Nombre d'Or,14,2,16,2022,01-20,17:53
019 Louis Blanc,11,5,16,2022,01-20,17:53
020 Gambetta,1,7,8,2022,01-20,17:53
021 Port Marianne,12,4,16,2022,01-20,17:53
022 Clemenceau,7,5,12,2022,01-20,17:53
023 Les Arceaux,4,12,16,2022,01-20,17:53
024 Cit� Mion,3,5,8,2022,01-20,17:53
025 Nouveau Saint-Roch,4,4,8,2022,01-20,17:53
026 Renouvier,2,6,8,2022,01-20,17:53
027 Odysseum,3,5,8,2022,01-20,17:53
028 Saint-Denis,5,3,8,2022,01-20,17:53
029 Richter,8,8,16,2022,01-20,17:53
030 Charles Flahault,1,7,8,2022,01-20,17:53
031 Voltaire,3,5,8,2022,01-20,17:53
032 Pr�s d'Ar�nes,4,4,8,2022,01-20,17:53
033 Garcia Lorca,8,0,8,2022,01-20,17:53
034 Vert Bois,0,16,16,2022,01-20,17:53
035 Malbosc,2,6,8,2022,01-20,17:53
036 Occitanie,3,29,32,2022,01-20,17:53
037 FacdesSciences,0,24,24,2022,01-20,17:53
038 Fac de Lettres,3,13,16,2022,01-20,17:53
039 Aiguelongue,3,5,8,2022,01-20,17:53
040 Jeu de Mail des Abb�s,2,6,8,2022,01-20,17:53
041 Eurom�decine,1,7,8,2022,01-20,17:53
042 Marie Caizergues,7,1,8,2022,01-20,17:53
043 Sabines,4,4,8,2022,01-20,17:53
044 Celleneuve,2,6,8,2022,01-20,17:53
045 Jardin de la Lironde,1,7,8,2022,01-20,17:53
046 P�re Soulas,5,3,8,2022,01-20,17:53
047 Place Viala,0,8,8,2022,01-20,17:53
048 H�tel du D�partement,6,2,8,2022,01-20,17:53
049 Tonnelles,4,4,8,2022,01-20,17:53
050 Parvis Jules Ferry - Gare Saint-Roch,8,0,8,2022,01-20,17:53
051 Pont de Lattes - Gare Saint-Roch,0,12,12,2022,01-20,17:53
053 Deux Ponts - Gare Saint-Roch,1,7,8,2022,01-20,17:53
054 Providence - Ovalie,4,4,8,2022,01-20,17:53
055 P�rols Etang de l'Or,15,53,68,2022,01-20,17:53
056 Albert 1er - Cath�drale,5,7,12,2022,01-20,17:53
057 Saint-Guilhem - Courreau,5,3,8,2022,01-20,17:53
059 Sud De France,3,5,8,2022,01-20,17:53
001 Rue Jules Ferry - Gare Saint-Roch,4,8,12,2022,01-20,18:03
002 Com�die,14,10,24,2022,01-20,18:03
003 Esplanade,9,23,32,2022,01-20,18:03
004 H�tel de Ville,7,9,16,2022,01-20,18:03
005 Corum,5,7,12,2022,01-20,18:03
006 Place Albert 1er - St Charles,20,11,31,2022,01-20,18:03
007 Foch,7,1,8,2022,01-20,18:03
008 Halles Castellane,2,10,12,2022,01-20,18:03
009 Observatoire,8,0,8,2022,01-20,18:03
010 Rondelet,3,13,16,2022,01-20,18:03
011 Plan Cabanes,1,11,12,2022,01-20,18:03
012 Boutonnet,10,2,12,2022,01-20,18:03
013 Emile Combes,5,3,8,2022,01-20,18:03
014 Beaux-Arts,0,8,8,2022,01-20,18:03
015 Les Aubes,3,5,8,2022,01-20,18:03
016 Antigone centre,5,11,16,2022,01-20,18:03
017 M�diath�que Emile Zola,9,7,16,2022,01-20,18:03
018 Nombre d'Or,14,2,16,2022,01-20,18:03
019 Louis Blanc,11,5,16,2022,01-20,18:03
020 Gambetta,1,7,8,2022,01-20,18:03
021 Port Marianne,12,4,16,2022,01-20,18:03
022 Clemenceau,7,5,12,2022,01-20,18:03
023 Les Arceaux,4,12,16,2022,01-20,18:03
024 Cit� Mion,3,5,8,2022,01-20,18:03
025 Nouveau Saint-Roch,4,4,8,2022,01-20,18:03
026 Renouvier,2,6,8,2022,01-20,18:03
027 Odysseum,4,4,8,2022,01-20,18:03
028 Saint-Denis,6,2,8,2022,01-20,18:03
029 Richter,8,8,16,2022,01-20,18:03
030 Charles Flahault,1,7,8,2022,01-20,18:03
031 Voltaire,3,5,8,2022,01-20,18:03
032 Pr�s d'Ar�nes,4,4,8,2022,01-20,18:03
033 Garcia Lorca,8,0,8,2022,01-20,18:03
034 Vert Bois,0,16,16,2022,01-20,18:03
035 Malbosc,2,6,8,2022,01-20,18:03
036 Occitanie,3,29,32,2022,01-20,18:03
037 FacdesSciences,0,24,24,2022,01-20,18:03
038 Fac de Lettres,3,13,16,2022,01-20,18:03
039 Aiguelongue,3,5,8,2022,01-20,18:03
040 Jeu de Mail des Abb�s,2,6,8,2022,01-20,18:03
041 Eurom�decine,1,7,8,2022,01-20,18:03
042 Marie Caizergues,7,1,8,2022,01-20,18:03
043 Sabines,4,4,8,2022,01-20,18:03
044 Celleneuve,2,6,8,2022,01-20,18:03
045 Jardin de la Lironde,1,7,8,2022,01-20,18:03
046 P�re Soulas,5,3,8,2022,01-20,18:03
047 Place Viala,0,8,8,2022,01-20,18:03
048 H�tel du D�partement,6,2,8,2022,01-20,18:03
049 Tonnelles,3,5,8,2022,01-20,18:03
050 Parvis Jules Ferry - Gare Saint-Roch,8,0,8,2022,01-20,18:03
051 Pont de Lattes - Gare Saint-Roch,0,12,12,2022,01-20,18:03
053 Deux Ponts - Gare Saint-Roch,1,7,8,2022,01-20,18:03
054 Providence - Ovalie,4,4,8,2022,01-20,18:03
055 P�rols Etang de l'Or,20,48,68,2022,01-20,18:03
056 Albert 1er - Cath�drale,5,7,12,2022,01-20,18:03
057 Saint-Guilhem - Courreau,5,3,8,2022,01-20,18:03
059 Sud De France,3,5,8,2022,01-20,18:03
001 Rue Jules Ferry - Gare Saint-Roch,5,7,12,2022,01-20,18:13
002 Com�die,14,10,24,2022,01-20,18:13
003 Esplanade,8,24,32,2022,01-20,18:13
004 H�tel de Ville,7,9,16,2022,01-20,18:13
005 Corum,5,7,12,2022,01-20,18:13
006 Place Albert 1er - St Charles,20,11,31,2022,01-20,18:13
007 Foch,7,1,8,2022,01-20,18:13
008 Halles Castellane,0,12,12,2022,01-20,18:13
009 Observatoire,8,0,8,2022,01-20,18:13
010 Rondelet,3,13,16,2022,01-20,18:13
011 Plan Cabanes,1,11,12,2022,01-20,18:13
012 Boutonnet,10,2,12,2022,01-20,18:13
013 Emile Combes,5,3,8,2022,01-20,18:13
014 Beaux-Arts,0,8,8,2022,01-20,18:13
015 Les Aubes,3,5,8,2022,01-20,18:13
016 Antigone centre,5,11,16,2022,01-20,18:13
017 M�diath�que Emile Zola,9,7,16,2022,01-20,18:13
018 Nombre d'Or,13,3,16,2022,01-20,18:13
019 Louis Blanc,11,5,16,2022,01-20,18:13
020 Gambetta,1,7,8,2022,01-20,18:13
021 Port Marianne,12,4,16,2022,01-20,18:13
022 Clemenceau,6,6,12,2022,01-20,18:13
023 Les Arceaux,4,12,16,2022,01-20,18:13
024 Cit� Mion,3,5,8,2022,01-20,18:13
025 Nouveau Saint-Roch,3,5,8,2022,01-20,18:13
026 Renouvier,3,5,8,2022,01-20,18:13
027 Odysseum,4,4,8,2022,01-20,18:13
028 Saint-Denis,6,2,8,2022,01-20,18:13
029 Richter,7,9,16,2022,01-20,18:13
030 Charles Flahault,1,7,8,2022,01-20,18:13
031 Voltaire,3,5,8,2022,01-20,18:13
032 Pr�s d'Ar�nes,4,4,8,2022,01-20,18:13
033 Garcia Lorca,8,0,8,2022,01-20,18:13
034 Vert Bois,0,16,16,2022,01-20,18:13
035 Malbosc,2,6,8,2022,01-20,18:13
036 Occitanie,3,29,32,2022,01-20,18:13
037 FacdesSciences,1,23,24,2022,01-20,18:13
038 Fac de Lettres,3,13,16,2022,01-20,18:13
039 Aiguelongue,3,5,8,2022,01-20,18:13
040 Jeu de Mail des Abb�s,2,6,8,2022,01-20,18:13
041 Eurom�decine,1,7,8,2022,01-20,18:13
042 Marie Caizergues,7,1,8,2022,01-20,18:13
043 Sabines,4,4,8,2022,01-20,18:13
044 Celleneuve,2,6,8,2022,01-20,18:13
045 Jardin de la Lironde,1,7,8,2022,01-20,18:13
046 P�re Soulas,5,3,8,2022,01-20,18:13
047 Place Viala,0,8,8,2022,01-20,18:13
048 H�tel du D�partement,6,2,8,2022,01-20,18:13
049 Tonnelles,3,5,8,2022,01-20,18:13
050 Parvis Jules Ferry - Gare Saint-Roch,8,0,8,2022,01-20,18:13
051 Pont de Lattes - Gare Saint-Roch,0,12,12,2022,01-20,18:13
053 Deux Ponts - Gare Saint-Roch,1,7,8,2022,01-20,18:13
054 Providence - Ovalie,4,4,8,2022,01-20,18:13
055 P�rols Etang de l'Or,20,48,68,2022,01-20,18:13
056 Albert 1er - Cath�drale,5,7,12,2022,01-20,18:13
057 Saint-Guilhem - Courreau,5,3,8,2022,01-20,18:13
059 Sud De France,3,5,8,2022,01-20,18:13
001 Rue Jules Ferry - Gare Saint-Roch,5,7,12,2022,01-20,18:24
002 Com�die,14,10,24,2022,01-20,18:24
003 Esplanade,8,24,32,2022,01-20,18:24
004 H�tel de Ville,7,9,16,2022,01-20,18:24
005 Corum,5,7,12,2022,01-20,18:24
006 Place Albert 1er - St Charles,21,10,31,2022,01-20,18:24
007 Foch,7,1,8,2022,01-20,18:24
008 Halles Castellane,0,12,12,2022,01-20,18:24
009 Observatoire,8,0,8,2022,01-20,18:24
010 Rondelet,3,13,16,2022,01-20,18:24
011 Plan Cabanes,1,11,12,2022,01-20,18:24
012 Boutonnet,10,2,12,2022,01-20,18:24
013 Emile Combes,5,3,8,2022,01-20,18:24
014 Beaux-Arts,0,8,8,2022,01-20,18:24
015 Les Aubes,4,4,8,2022,01-20,18:24
016 Antigone centre,5,11,16,2022,01-20,18:24
017 M�diath�que Emile Zola,12,4,16,2022,01-20,18:24
018 Nombre d'Or,13,3,16,2022,01-20,18:24
019 Louis Blanc,11,5,16,2022,01-20,18:24
020 Gambetta,1,7,8,2022,01-20,18:24
021 Port Marianne,12,4,16,2022,01-20,18:24
022 Clemenceau,6,6,12,2022,01-20,18:24
023 Les Arceaux,4,12,16,2022,01-20,18:24
024 Cit� Mion,3,5,8,2022,01-20,18:24
025 Nouveau Saint-Roch,3,5,8,2022,01-20,18:24
026 Renouvier,3,5,8,2022,01-20,18:24
027 Odysseum,4,4,8,2022,01-20,18:24
028 Saint-Denis,6,2,8,2022,01-20,18:24
029 Richter,7,9,16,2022,01-20,18:24
030 Charles Flahault,1,7,8,2022,01-20,18:24
031 Voltaire,3,5,8,2022,01-20,18:24
032 Pr�s d'Ar�nes,5,3,8,2022,01-20,18:24
033 Garcia Lorca,8,0,8,2022,01-20,18:24
034 Vert Bois,0,16,16,2022,01-20,18:24
035 Malbosc,2,6,8,2022,01-20,18:24
036 Occitanie,3,29,32,2022,01-20,18:24
037 FacdesSciences,0,24,24,2022,01-20,18:24
038 Fac de Lettres,3,13,16,2022,01-20,18:24
039 Aiguelongue,3,5,8,2022,01-20,18:24
040 Jeu de Mail des Abb�s,2,6,8,2022,01-20,18:24
041 Eurom�decine,1,7,8,2022,01-20,18:24
042 Marie Caizergues,6,2,8,2022,01-20,18:24
043 Sabines,4,4,8,2022,01-20,18:24
044 Celleneuve,2,6,8,2022,01-20,18:24
045 Jardin de la Lironde,1,7,8,2022,01-20,18:24
046 P�re Soulas,5,3,8,2022,01-20,18:24
047 Place Viala,0,8,8,2022,01-20,18:24
048 H�tel du D�partement,6,2,8,2022,01-20,18:24
049 Tonnelles,3,5,8,2022,01-20,18:24
050 Parvis Jules Ferry - Gare Saint-Roch,8,0,8,2022,01-20,18:24
051 Pont de Lattes - Gare Saint-Roch,0,12,12,2022,01-20,18:24
053 Deux Ponts - Gare Saint-Roch,1,7,8,2022,01-20,18:24
054 Providence - Ovalie,4,4,8,2022,01-20,18:24
055 P�rols Etang de l'Or,21,47,68,2022,01-20,18:24
056 Albert 1er - Cath�drale,4,8,12,2022,01-20,18:24
057 Saint-Guilhem - Courreau,4,4,8,2022,01-20,18:24
059 Sud De France,3,5,8,2022,01-20,18:24
001 Rue Jules Ferry - Gare Saint-Roch,5,7,12,2022,01-20,18:34
002 Com�die,14,10,24,2022,01-20,18:34
003 Esplanade,7,25,32,2022,01-20,18:34
004 H�tel de Ville,7,9,16,2022,01-20,18:34
005 Corum,5,7,12,2022,01-20,18:34
006 Place Albert 1er - St Charles,23,8,31,2022,01-20,18:34
007 Foch,7,1,8,2022,01-20,18:34
008 Halles Castellane,0,12,12,2022,01-20,18:34
009 Observatoire,8,0,8,2022,01-20,18:34
010 Rondelet,3,13,16,2022,01-20,18:34
011 Plan Cabanes,1,11,12,2022,01-20,18:34
012 Boutonnet,10,2,12,2022,01-20,18:34
013 Emile Combes,5,3,8,2022,01-20,18:34
014 Beaux-Arts,1,7,8,2022,01-20,18:34
015 Les Aubes,4,4,8,2022,01-20,18:34
016 Antigone centre,4,12,16,2022,01-20,18:34
017 M�diath�que Emile Zola,12,4,16,2022,01-20,18:34
018 Nombre d'Or,13,3,16,2022,01-20,18:34
019 Louis Blanc,12,4,16,2022,01-20,18:34
020 Gambetta,1,7,8,2022,01-20,18:34
021 Port Marianne,12,4,16,2022,01-20,18:34
022 Clemenceau,6,6,12,2022,01-20,18:34
023 Les Arceaux,5,11,16,2022,01-20,18:34
024 Cit� Mion,3,5,8,2022,01-20,18:34
025 Nouveau Saint-Roch,3,5,8,2022,01-20,18:34
026 Renouvier,4,4,8,2022,01-20,18:34
027 Odysseum,4,4,8,2022,01-20,18:34
028 Saint-Denis,5,3,8,2022,01-20,18:34
029 Richter,7,9,16,2022,01-20,18:34
030 Charles Flahault,0,8,8,2022,01-20,18:34
031 Voltaire,3,5,8,2022,01-20,18:34
032 Pr�s d'Ar�nes,5,3,8,2022,01-20,18:34
033 Garcia Lorca,8,0,8,2022,01-20,18:34
034 Vert Bois,0,16,16,2022,01-20,18:34
035 Malbosc,2,6,8,2022,01-20,18:34
036 Occitanie,3,29,32,2022,01-20,18:34
037 FacdesSciences,0,24,24,2022,01-20,18:34
038 Fac de Lettres,3,13,16,2022,01-20,18:34
039 Aiguelongue,3,5,8,2022,01-20,18:34
040 Jeu de Mail des Abb�s,2,6,8,2022,01-20,18:34
041 Eurom�decine,1,7,8,2022,01-20,18:34
042 Marie Caizergues,6,2,8,2022,01-20,18:34
043 Sabines,4,4,8,2022,01-20,18:34
044 Celleneuve,2,6,8,2022,01-20,18:34
045 Jardin de la Lironde,1,7,8,2022,01-20,18:34
046 P�re Soulas,4,4,8,2022,01-20,18:34
047 Place Viala,0,8,8,2022,01-20,18:34
048 H�tel du D�partement,6,2,8,2022,01-20,18:34
049 Tonnelles,3,5,8,2022,01-20,18:34
050 Parvis Jules Ferry - Gare Saint-Roch,8,0,8,2022,01-20,18:34
051 Pont de Lattes - Gare Saint-Roch,0,12,12,2022,01-20,18:34
053 Deux Ponts - Gare Saint-Roch,1,7,8,2022,01-20,18:34
054 Providence - Ovalie,4,4,8,2022,01-20,18:34
055 P�rols Etang de l'Or,21,47,68,2022,01-20,18:34
056 Albert 1er - Cath�drale,4,8,12,2022,01-20,18:34
057 Saint-Guilhem - Courreau,5,3,8,2022,01-20,18:34
059 Sud De France,3,5,8,2022,01-20,18:34
001 Rue Jules Ferry - Gare Saint-Roch,4,8,12,2022,01-20,18:44
002 Com�die,14,10,24,2022,01-20,18:44
003 Esplanade,7,25,32,2022,01-20,18:44
004 H�tel de Ville,7,9,16,2022,01-20,18:44
005 Corum,5,7,12,2022,01-20,18:44
006 Place Albert 1er - St Charles,25,6,31,2022,01-20,18:44
007 Foch,7,1,8,2022,01-20,18:44
008 Halles Castellane,0,12,12,2022,01-20,18:44
009 Observatoire,8,0,8,2022,01-20,18:44
010 Rondelet,3,13,16,2022,01-20,18:44
011 Plan Cabanes,1,11,12,2022,01-20,18:44
012 Boutonnet,10,2,12,2022,01-20,18:44
013 Emile Combes,5,3,8,2022,01-20,18:44
014 Beaux-Arts,1,7,8,2022,01-20,18:44
015 Les Aubes,4,4,8,2022,01-20,18:44
016 Antigone centre,4,12,16,2022,01-20,18:44
017 M�diath�que Emile Zola,12,4,16,2022,01-20,18:44
018 Nombre d'Or,13,3,16,2022,01-20,18:44
019 Louis Blanc,12,4,16,2022,01-20,18:44
020 Gambetta,1,7,8,2022,01-20,18:44
021 Port Marianne,12,4,16,2022,01-20,18:44
022 Clemenceau,6,6,12,2022,01-20,18:44
023 Les Arceaux,5,11,16,2022,01-20,18:44
024 Cit� Mion,3,5,8,2022,01-20,18:44
025 Nouveau Saint-Roch,3,5,8,2022,01-20,18:44
026 Renouvier,4,4,8,2022,01-20,18:44
027 Odysseum,4,4,8,2022,01-20,18:44
028 Saint-Denis,6,2,8,2022,01-20,18:44
029 Richter,7,9,16,2022,01-20,18:44
030 Charles Flahault,0,8,8,2022,01-20,18:44
031 Voltaire,3,5,8,2022,01-20,18:44
032 Pr�s d'Ar�nes,5,3,8,2022,01-20,18:44
033 Garcia Lorca,8,0,8,2022,01-20,18:44
034 Vert Bois,0,16,16,2022,01-20,18:44
035 Malbosc,2,6,8,2022,01-20,18:44
036 Occitanie,3,29,32,2022,01-20,18:44
037 FacdesSciences,0,24,24,2022,01-20,18:44
038 Fac de Lettres,3,13,16,2022,01-20,18:44
039 Aiguelongue,3,5,8,2022,01-20,18:44
040 Jeu de Mail des Abb�s,2,6,8,2022,01-20,18:44
041 Eurom�decine,1,7,8,2022,01-20,18:44
042 Marie Caizergues,6,2,8,2022,01-20,18:44
043 Sabines,4,4,8,2022,01-20,18:44
044 Celleneuve,2,6,8,2022,01-20,18:44
045 Jardin de la Lironde,2,6,8,2022,01-20,18:44
046 P�re Soulas,5,3,8,2022,01-20,18:44
047 Place Viala,1,7,8,2022,01-20,18:44
048 H�tel du D�partement,6,2,8,2022,01-20,18:44
049 Tonnelles,3,5,8,2022,01-20,18:44
050 Parvis Jules Ferry - Gare Saint-Roch,8,0,8,2022,01-20,18:44
051 Pont de Lattes - Gare Saint-Roch,0,12,12,2022,01-20,18:44
053 Deux Ponts - Gare Saint-Roch,1,7,8,2022,01-20,18:44
054 Providence - Ovalie,4,4,8,2022,01-20,18:44
055 P�rols Etang de l'Or,25,43,68,2022,01-20,18:44
056 Albert 1er - Cath�drale,4,8,12,2022,01-20,18:44
057 Saint-Guilhem - Courreau,7,1,8,2022,01-20,18:44
059 Sud De France,3,5,8,2022,01-20,18:44
001 Rue Jules Ferry - Gare Saint-Roch,5,7,12,2022,01-20,18:54
002 Com�die,13,11,24,2022,01-20,18:54
003 Esplanade,7,25,32,2022,01-20,18:54
004 H�tel de Ville,8,8,16,2022,01-20,18:54
005 Corum,5,7,12,2022,01-20,18:54
006 Place Albert 1er - St Charles,25,6,31,2022,01-20,18:54
007 Foch,7,1,8,2022,01-20,18:54
008 Halles Castellane,0,12,12,2022,01-20,18:54
009 Observatoire,8,0,8,2022,01-20,18:54
010 Rondelet,3,13,16,2022,01-20,18:54
011 Plan Cabanes,3,9,12,2022,01-20,18:54
012 Boutonnet,10,2,12,2022,01-20,18:54
013 Emile Combes,5,3,8,2022,01-20,18:54
014 Beaux-Arts,1,7,8,2022,01-20,18:54
015 Les Aubes,4,4,8,2022,01-20,18:54
016 Antigone centre,4,12,16,2022,01-20,18:54
017 M�diath�que Emile Zola,14,2,16,2022,01-20,18:54
018 Nombre d'Or,12,4,16,2022,01-20,18:54
019 Louis Blanc,13,3,16,2022,01-20,18:54
020 Gambetta,1,7,8,2022,01-20,18:54
021 Port Marianne,12,4,16,2022,01-20,18:54
022 Clemenceau,7,5,12,2022,01-20,18:54
023 Les Arceaux,6,10,16,2022,01-20,18:54
024 Cit� Mion,3,5,8,2022,01-20,18:54
025 Nouveau Saint-Roch,3,5,8,2022,01-20,18:54
026 Renouvier,4,4,8,2022,01-20,18:54
027 Odysseum,4,4,8,2022,01-20,18:54
028 Saint-Denis,5,3,8,2022,01-20,18:54
029 Richter,8,8,16,2022,01-20,18:54
030 Charles Flahault,0,8,8,2022,01-20,18:54
031 Voltaire,2,6,8,2022,01-20,18:54
032 Pr�s d'Ar�nes,5,3,8,2022,01-20,18:54
033 Garcia Lorca,8,0,8,2022,01-20,18:54
034 Vert Bois,0,16,16,2022,01-20,18:54
035 Malbosc,2,6,8,2022,01-20,18:54
036 Occitanie,2,30,32,2022,01-20,18:54
037 FacdesSciences,0,24,24,2022,01-20,18:54
038 Fac de Lettres,3,13,16,2022,01-20,18:54
039 Aiguelongue,3,5,8,2022,01-20,18:54
040 Jeu de Mail des Abb�s,2,6,8,2022,01-20,18:54
041 Eurom�decine,1,7,8,2022,01-20,18:54
042 Marie Caizergues,5,3,8,2022,01-20,18:54
043 Sabines,4,4,8,2022,01-20,18:54
044 Celleneuve,2,6,8,2022,01-20,18:54
045 Jardin de la Lironde,2,6,8,2022,01-20,18:54
046 P�re Soulas,5,3,8,2022,01-20,18:54
047 Place Viala,1,7,8,2022,01-20,18:54
048 H�tel du D�partement,6,2,8,2022,01-20,18:54
049 Tonnelles,3,5,8,2022,01-20,18:54
050 Parvis Jules Ferry - Gare Saint-Roch,8,0,8,2022,01-20,18:54
051 Pont de Lattes - Gare Saint-Roch,0,12,12,2022,01-20,18:54
053 Deux Ponts - Gare Saint-Roch,1,7,8,2022,01-20,18:54
054 Providence - Ovalie,4,4,8,2022,01-20,18:54
055 P�rols Etang de l'Or,25,43,68,2022,01-20,18:54
056 Albert 1er - Cath�drale,4,8,12,2022,01-20,18:54
057 Saint-Guilhem - Courreau,7,1,8,2022,01-20,18:54
059 Sud De France,3,5,8,2022,01-20,18:54
001 Rue Jules Ferry - Gare Saint-Roch,5,7,12,2022,01-20,19:04
002 Com�die,12,12,24,2022,01-20,19:04
003 Esplanade,7,25,32,2022,01-20,19:04
004 H�tel de Ville,8,8,16,2022,01-20,19:04
005 Corum,5,7,12,2022,01-20,19:04
006 Place Albert 1er - St Charles,25,6,31,2022,01-20,19:04
007 Foch,6,2,8,2022,01-20,19:04
008 Halles Castellane,0,12,12,2022,01-20,19:04
009 Observatoire,8,0,8,2022,01-20,19:04
010 Rondelet,3,13,16,2022,01-20,19:04
011 Plan Cabanes,3,9,12,2022,01-20,19:04
012 Boutonnet,8,4,12,2022,01-20,19:04
013 Emile Combes,5,3,8,2022,01-20,19:04
014 Beaux-Arts,1,7,8,2022,01-20,19:04
015 Les Aubes,5,3,8,2022,01-20,19:04
016 Antigone centre,4,12,16,2022,01-20,19:04
017 M�diath�que Emile Zola,14,2,16,2022,01-20,19:04
018 Nombre d'Or,12,4,16,2022,01-20,19:04
019 Louis Blanc,13,3,16,2022,01-20,19:04
020 Gambetta,2,6,8,2022,01-20,19:04
021 Port Marianne,12,4,16,2022,01-20,19:04
022 Clemenceau,7,5,12,2022,01-20,19:04
023 Les Arceaux,6,10,16,2022,01-20,19:04
024 Cit� Mion,3,5,8,2022,01-20,19:04
025 Nouveau Saint-Roch,3,5,8,2022,01-20,19:04
026 Renouvier,4,4,8,2022,01-20,19:04
027 Odysseum,4,4,8,2022,01-20,19:04
028 Saint-Denis,5,3,8,2022,01-20,19:04
029 Richter,8,8,16,2022,01-20,19:04
030 Charles Flahault,0,8,8,2022,01-20,19:04
031 Voltaire,2,6,8,2022,01-20,19:04
032 Pr�s d'Ar�nes,5,3,8,2022,01-20,19:04
033 Garcia Lorca,8,0,8,2022,01-20,19:04
034 Vert Bois,0,16,16,2022,01-20,19:04
035 Malbosc,2,6,8,2022,01-20,19:04
036 Occitanie,2,30,32,2022,01-20,19:04
037 FacdesSciences,0,24,24,2022,01-20,19:04
038 Fac de Lettres,3,13,16,2022,01-20,19:04
039 Aiguelongue,3,5,8,2022,01-20,19:04
040 Jeu de Mail des Abb�s,2,6,8,2022,01-20,19:04
041 Eurom�decine,1,7,8,2022,01-20,19:04
042 Marie Caizergues,5,3,8,2022,01-20,19:04
043 Sabines,4,4,8,2022,01-20,19:04
044 Celleneuve,2,6,8,2022,01-20,19:04
045 Jardin de la Lironde,2,6,8,2022,01-20,19:04
046 P�re Soulas,4,4,8,2022,01-20,19:04
047 Place Viala,1,7,8,2022,01-20,19:04
048 H�tel du D�partement,6,2,8,2022,01-20,19:04
049 Tonnelles,3,5,8,2022,01-20,19:04
050 Parvis Jules Ferry - Gare Saint-Roch,8,0,8,2022,01-20,19:04
051 Pont de Lattes - Gare Saint-Roch,0,12,12,2022,01-20,19:04
053 Deux Ponts - Gare Saint-Roch,1,7,8,2022,01-20,19:04
054 Providence - Ovalie,4,4,8,2022,01-20,19:04
055 P�rols Etang de l'Or,25,43,68,2022,01-20,19:04
056 Albert 1er - Cath�drale,4,8,12,2022,01-20,19:04
057 Saint-Guilhem - Courreau,7,1,8,2022,01-20,19:04
059 Sud De France,3,5,8,2022,01-20,19:04
001 Rue Jules Ferry - Gare Saint-Roch,5,7,12,2022,01-20,19:14
002 Com�die,12,12,24,2022,01-20,19:14
003 Esplanade,8,24,32,2022,01-20,19:14
004 H�tel de Ville,8,8,16,2022,01-20,19:14
005 Corum,5,7,12,2022,01-20,19:14
006 Place Albert 1er - St Charles,25,6,31,2022,01-20,19:14
007 Foch,6,2,8,2022,01-20,19:14
008 Halles Castellane,0,12,12,2022,01-20,19:14
009 Observatoire,8,0,8,2022,01-20,19:14
010 Rondelet,3,13,16,2022,01-20,19:14
011 Plan Cabanes,3,9,12,2022,01-20,19:14
012 Boutonnet,7,5,12,2022,01-20,19:14
013 Emile Combes,5,3,8,2022,01-20,19:14
014 Beaux-Arts,1,7,8,2022,01-20,19:14
015 Les Aubes,5,3,8,2022,01-20,19:14
016 Antigone centre,4,12,16,2022,01-20,19:14
017 M�diath�que Emile Zola,14,2,16,2022,01-20,19:14
018 Nombre d'Or,12,4,16,2022,01-20,19:14
019 Louis Blanc,13,3,16,2022,01-20,19:14
020 Gambetta,2,6,8,2022,01-20,19:14
021 Port Marianne,12,4,16,2022,01-20,19:14
022 Clemenceau,7,5,12,2022,01-20,19:14
023 Les Arceaux,6,10,16,2022,01-20,19:14
024 Cit� Mion,3,5,8,2022,01-20,19:14
025 Nouveau Saint-Roch,3,5,8,2022,01-20,19:14
026 Renouvier,4,4,8,2022,01-20,19:14
027 Odysseum,4,4,8,2022,01-20,19:14
028 Saint-Denis,5,3,8,2022,01-20,19:14
029 Richter,8,8,16,2022,01-20,19:14
030 Charles Flahault,1,7,8,2022,01-20,19:14
031 Voltaire,2,6,8,2022,01-20,19:14
032 Pr�s d'Ar�nes,5,3,8,2022,01-20,19:14
033 Garcia Lorca,8,0,8,2022,01-20,19:14
034 Vert Bois,0,16,16,2022,01-20,19:14
035 Malbosc,2,6,8,2022,01-20,19:14
036 Occitanie,2,30,32,2022,01-20,19:14
037 FacdesSciences,0,24,24,2022,01-20,19:14
038 Fac de Lettres,3,13,16,2022,01-20,19:14
039 Aiguelongue,3,5,8,2022,01-20,19:14
040 Jeu de Mail des Abb�s,2,6,8,2022,01-20,19:14
041 Eurom�decine,1,7,8,2022,01-20,19:14
042 Marie Caizergues,5,3,8,2022,01-20,19:14
043 Sabines,4,4,8,2022,01-20,19:14
044 Celleneuve,2,6,8,2022,01-20,19:14
045 Jardin de la Lironde,2,6,8,2022,01-20,19:14
046 P�re Soulas,4,4,8,2022,01-20,19:14
047 Place Viala,1,7,8,2022,01-20,19:14
048 H�tel du D�partement,6,2,8,2022,01-20,19:14
049 Tonnelles,3,5,8,2022,01-20,19:14
050 Parvis Jules Ferry - Gare Saint-Roch,8,0,8,2022,01-20,19:14
051 Pont de Lattes - Gare Saint-Roch,0,12,12,2022,01-20,19:14
053 Deux Ponts - Gare Saint-Roch,1,7,8,2022,01-20,19:14
054 Providence - Ovalie,4,4,8,2022,01-20,19:14
055 P�rols Etang de l'Or,25,43,68,2022,01-20,19:14
056 Albert 1er - Cath�drale,4,8,12,2022,01-20,19:14
057 Saint-Guilhem - Courreau,7,1,8,2022,01-20,19:14
059 Sud De France,3,5,8,2022,01-20,19:14
001 Rue Jules Ferry - Gare Saint-Roch,5,7,12,2022,01-20,19:25
002 Com�die,12,12,24,2022,01-20,19:25
003 Esplanade,8,24,32,2022,01-20,19:25
004 H�tel de Ville,8,8,16,2022,01-20,19:25
005 Corum,4,8,12,2022,01-20,19:25
006 Place Albert 1er - St Charles,25,6,31,2022,01-20,19:25
007 Foch,6,2,8,2022,01-20,19:25
008 Halles Castellane,0,12,12,2022,01-20,19:25
009 Observatoire,8,0,8,2022,01-20,19:25
010 Rondelet,3,13,16,2022,01-20,19:25
011 Plan Cabanes,3,9,12,2022,01-20,19:25
012 Boutonnet,7,5,12,2022,01-20,19:25
013 Emile Combes,5,3,8,2022,01-20,19:25
014 Beaux-Arts,1,7,8,2022,01-20,19:25
015 Les Aubes,5,3,8,2022,01-20,19:25
016 Antigone centre,4,12,16,2022,01-20,19:25
017 M�diath�que Emile Zola,14,2,16,2022,01-20,19:25
018 Nombre d'Or,11,5,16,2022,01-20,19:25
019 Louis Blanc,13,3,16,2022,01-20,19:25
020 Gambetta,2,6,8,2022,01-20,19:25
021 Port Marianne,12,4,16,2022,01-20,19:25
022 Clemenceau,7,5,12,2022,01-20,19:25
023 Les Arceaux,6,10,16,2022,01-20,19:25
024 Cit� Mion,4,4,8,2022,01-20,19:25
025 Nouveau Saint-Roch,2,6,8,2022,01-20,19:25
026 Renouvier,4,4,8,2022,01-20,19:25
027 Odysseum,4,4,8,2022,01-20,19:25
028 Saint-Denis,5,3,8,2022,01-20,19:25
029 Richter,8,8,16,2022,01-20,19:25
030 Charles Flahault,1,7,8,2022,01-20,19:25
031 Voltaire,2,6,8,2022,01-20,19:25
032 Pr�s d'Ar�nes,5,3,8,2022,01-20,19:25
033 Garcia Lorca,8,0,8,2022,01-20,19:25
034 Vert Bois,0,16,16,2022,01-20,19:25
035 Malbosc,2,6,8,2022,01-20,19:25
036 Occitanie,2,30,32,2022,01-20,19:25
037 FacdesSciences,0,24,24,2022,01-20,19:25
038 Fac de Lettres,3,13,16,2022,01-20,19:25
039 Aiguelongue,3,5,8,2022,01-20,19:25
040 Jeu de Mail des Abb�s,1,7,8,2022,01-20,19:25
041 Eurom�decine,1,7,8,2022,01-20,19:25
042 Marie Caizergues,5,3,8,2022,01-20,19:25
043 Sabines,4,4,8,2022,01-20,19:25
044 Celleneuve,2,6,8,2022,01-20,19:25
045 Jardin de la Lironde,2,6,8,2022,01-20,19:25
046 P�re Soulas,4,4,8,2022,01-20,19:25
047 Place Viala,1,7,8,2022,01-20,19:25
048 H�tel du D�partement,6,2,8,2022,01-20,19:25
049 Tonnelles,3,5,8,2022,01-20,19:25
050 Parvis Jules Ferry - Gare Saint-Roch,8,0,8,2022,01-20,19:25
051 Pont de Lattes - Gare Saint-Roch,0,12,12,2022,01-20,19:25
053 Deux Ponts - Gare Saint-Roch,1,7,8,2022,01-20,19:25
054 Providence - Ovalie,4,4,8,2022,01-20,19:25
055 P�rols Etang de l'Or,25,43,68,2022,01-20,19:25
056 Albert 1er - Cath�drale,4,8,12,2022,01-20,19:25
057 Saint-Guilhem - Courreau,7,1,8,2022,01-20,19:25
059 Sud De France,3,5,8,2022,01-20,19:25
001 Rue Jules Ferry - Gare Saint-Roch,5,7,12,2022,01-20,19:35
002 Com�die,12,12,24,2022,01-20,19:35
003 Esplanade,5,27,32,2022,01-20,19:35
004 H�tel de Ville,8,8,16,2022,01-20,19:35
005 Corum,4,8,12,2022,01-20,19:35
006 Place Albert 1er - St Charles,24,7,31,2022,01-20,19:35
007 Foch,6,2,8,2022,01-20,19:35
008 Halles Castellane,0,12,12,2022,01-20,19:35
009 Observatoire,8,0,8,2022,01-20,19:35
010 Rondelet,3,13,16,2022,01-20,19:35
011 Plan Cabanes,3,9,12,2022,01-20,19:35
012 Boutonnet,8,4,12,2022,01-20,19:35
013 Emile Combes,6,2,8,2022,01-20,19:35
014 Beaux-Arts,1,7,8,2022,01-20,19:35
015 Les Aubes,5,3,8,2022,01-20,19:35
016 Antigone centre,5,11,16,2022,01-20,19:35
017 M�diath�que Emile Zola,14,2,16,2022,01-20,19:35
018 Nombre d'Or,12,4,16,2022,01-20,19:35
019 Louis Blanc,13,3,16,2022,01-20,19:35
020 Gambetta,2,6,8,2022,01-20,19:35
021 Port Marianne,12,4,16,2022,01-20,19:35
022 Clemenceau,7,5,12,2022,01-20,19:35
023 Les Arceaux,6,10,16,2022,01-20,19:35
024 Cit� Mion,4,4,8,2022,01-20,19:35
025 Nouveau Saint-Roch,2,6,8,2022,01-20,19:35
026 Renouvier,3,5,8,2022,01-20,19:35
027 Odysseum,4,4,8,2022,01-20,19:35
028 Saint-Denis,5,3,8,2022,01-20,19:35
029 Richter,7,9,16,2022,01-20,19:35
030 Charles Flahault,1,7,8,2022,01-20,19:35
031 Voltaire,2,6,8,2022,01-20,19:35
032 Pr�s d'Ar�nes,5,3,8,2022,01-20,19:35
033 Garcia Lorca,8,0,8,2022,01-20,19:35
034 Vert Bois,0,16,16,2022,01-20,19:35
035 Malbosc,2,6,8,2022,01-20,19:35
036 Occitanie,2,30,32,2022,01-20,19:35
037 FacdesSciences,0,24,24,2022,01-20,19:35
038 Fac de Lettres,3,13,16,2022,01-20,19:35
039 Aiguelongue,3,5,8,2022,01-20,19:35
040 Jeu de Mail des Abb�s,1,7,8,2022,01-20,19:35
041 Eurom�decine,1,7,8,2022,01-20,19:35
042 Marie Caizergues,5,3,8,2022,01-20,19:35
043 Sabines,4,4,8,2022,01-20,19:35
044 Celleneuve,2,6,8,2022,01-20,19:35
045 Jardin de la Lironde,2,6,8,2022,01-20,19:35
046 P�re Soulas,4,4,8,2022,01-20,19:35
047 Place Viala,1,7,8,2022,01-20,19:35
048 H�tel du D�partement,6,2,8,2022,01-20,19:35
049 Tonnelles,3,5,8,2022,01-20,19:35
050 Parvis Jules Ferry - Gare Saint-Roch,8,0,8,2022,01-20,19:35
051 Pont de Lattes - Gare Saint-Roch,0,12,12,2022,01-20,19:35
053 Deux Ponts - Gare Saint-Roch,1,7,8,2022,01-20,19:35
054 Providence - Ovalie,3,5,8,2022,01-20,19:35
055 P�rols Etang de l'Or,25,43,68,2022,01-20,19:35
056 Albert 1er - Cath�drale,4,8,12,2022,01-20,19:35
057 Saint-Guilhem - Courreau,8,0,8,2022,01-20,19:35
059 Sud De France,3,5,8,2022,01-20,19:35
001 Rue Jules Ferry - Gare Saint-Roch,5,7,12,2022,01-20,19:45
002 Com�die,12,12,24,2022,01-20,19:45
003 Esplanade,5,27,32,2022,01-20,19:45
004 H�tel de Ville,8,8,16,2022,01-20,19:45
005 Corum,4,8,12,2022,01-20,19:45
006 Place Albert 1er - St Charles,24,7,31,2022,01-20,19:45
007 Foch,5,3,8,2022,01-20,19:45
008 Halles Castellane,1,11,12,2022,01-20,19:45
009 Observatoire,8,0,8,2022,01-20,19:45
010 Rondelet,3,13,16,2022,01-20,19:45
011 Plan Cabanes,3,9,12,2022,01-20,19:45
012 Boutonnet,7,5,12,2022,01-20,19:45
013 Emile Combes,6,2,8,2022,01-20,19:45
014 Beaux-Arts,1,7,8,2022,01-20,19:45
015 Les Aubes,5,3,8,2022,01-20,19:45
016 Antigone centre,5,11,16,2022,01-20,19:45
017 M�diath�que Emile Zola,14,2,16,2022,01-20,19:45
018 Nombre d'Or,12,4,16,2022,01-20,19:45
019 Louis Blanc,13,3,16,2022,01-20,19:45
020 Gambetta,2,6,8,2022,01-20,19:45
021 Port Marianne,12,4,16,2022,01-20,19:45
022 Clemenceau,7,5,12,2022,01-20,19:45
023 Les Arceaux,6,10,16,2022,01-20,19:45
024 Cit� Mion,4,4,8,2022,01-20,19:45
025 Nouveau Saint-Roch,2,6,8,2022,01-20,19:45
026 Renouvier,3,5,8,2022,01-20,19:45
027 Odysseum,4,4,8,2022,01-20,19:45
028 Saint-Denis,5,3,8,2022,01-20,19:45
029 Richter,7,9,16,2022,01-20,19:45
030 Charles Flahault,1,7,8,2022,01-20,19:45
031 Voltaire,2,6,8,2022,01-20,19:45
032 Pr�s d'Ar�nes,5,3,8,2022,01-20,19:45
033 Garcia Lorca,7,1,8,2022,01-20,19:45
034 Vert Bois,0,16,16,2022,01-20,19:45
035 Malbosc,2,6,8,2022,01-20,19:45
036 Occitanie,2,30,32,2022,01-20,19:45
037 FacdesSciences,0,24,24,2022,01-20,19:45
038 Fac de Lettres,2,14,16,2022,01-20,19:45
039 Aiguelongue,3,5,8,2022,01-20,19:45
040 Jeu de Mail des Abb�s,1,7,8,2022,01-20,19:45
041 Eurom�decine,1,7,8,2022,01-20,19:45
042 Marie Caizergues,5,3,8,2022,01-20,19:45
043 Sabines,4,4,8,2022,01-20,19:45
044 Celleneuve,2,6,8,2022,01-20,19:45
045 Jardin de la Lironde,2,6,8,2022,01-20,19:45
046 P�re Soulas,4,4,8,2022,01-20,19:45
047 Place Viala,1,7,8,2022,01-20,19:45
048 H�tel du D�partement,6,2,8,2022,01-20,19:45
049 Tonnelles,3,5,8,2022,01-20,19:45
050 Parvis Jules Ferry - Gare Saint-Roch,8,0,8,2022,01-20,19:45
051 Pont de Lattes - Gare Saint-Roch,0,12,12,2022,01-20,19:45
053 Deux Ponts - Gare Saint-Roch,1,7,8,2022,01-20,19:45
054 Providence - Ovalie,3,5,8,2022,01-20,19:45
055 P�rols Etang de l'Or,25,43,68,2022,01-20,19:45
056 Albert 1er - Cath�drale,4,8,12,2022,01-20,19:45
057 Saint-Guilhem - Courreau,8,0,8,2022,01-20,19:45
059 Sud De France,3,5,8,2022,01-20,19:45
001 Rue Jules Ferry - Gare Saint-Roch,5,7,12,2022,01-20,19:55
002 Com�die,12,12,24,2022,01-20,19:55
003 Esplanade,5,27,32,2022,01-20,19:55
004 H�tel de Ville,8,8,16,2022,01-20,19:55
005 Corum,4,8,12,2022,01-20,19:55
006 Place Albert 1er - St Charles,24,7,31,2022,01-20,19:55
007 Foch,4,4,8,2022,01-20,19:55
008 Halles Castellane,2,10,12,2022,01-20,19:55
009 Observatoire,8,0,8,2022,01-20,19:55
010 Rondelet,2,14,16,2022,01-20,19:55
011 Plan Cabanes,3,9,12,2022,01-20,19:55
012 Boutonnet,6,6,12,2022,01-20,19:55
013 Emile Combes,6,2,8,2022,01-20,19:55
014 Beaux-Arts,1,7,8,2022,01-20,19:55
015 Les Aubes,5,3,8,2022,01-20,19:55
016 Antigone centre,5,11,16,2022,01-20,19:55
017 M�diath�que Emile Zola,13,3,16,2022,01-20,19:55
018 Nombre d'Or,12,4,16,2022,01-20,19:55
019 Louis Blanc,13,3,16,2022,01-20,19:55
020 Gambetta,2,6,8,2022,01-20,19:55
021 Port Marianne,13,3,16,2022,01-20,19:55
022 Clemenceau,7,5,12,2022,01-20,19:55
023 Les Arceaux,6,10,16,2022,01-20,19:55
024 Cit� Mion,4,4,8,2022,01-20,19:55
025 Nouveau Saint-Roch,2,6,8,2022,01-20,19:55
026 Renouvier,3,5,8,2022,01-20,19:55
027 Odysseum,4,4,8,2022,01-20,19:55
028 Saint-Denis,5,3,8,2022,01-20,19:55
029 Richter,7,9,16,2022,01-20,19:55
030 Charles Flahault,1,7,8,2022,01-20,19:55
031 Voltaire,2,6,8,2022,01-20,19:55
032 Pr�s d'Ar�nes,5,3,8,2022,01-20,19:55
033 Garcia Lorca,7,1,8,2022,01-20,19:55
034 Vert Bois,0,16,16,2022,01-20,19:55
035 Malbosc,2,6,8,2022,01-20,19:55
036 Occitanie,2,30,32,2022,01-20,19:55
037 FacdesSciences,0,24,24,2022,01-20,19:55
038 Fac de Lettres,2,14,16,2022,01-20,19:55
039 Aiguelongue,3,5,8,2022,01-20,19:55
040 Jeu de Mail des Abb�s,1,7,8,2022,01-20,19:55
041 Eurom�decine,1,7,8,2022,01-20,19:55
042 Marie Caizergues,6,2,8,2022,01-20,19:55
043 Sabines,4,4,8,2022,01-20,19:55
044 Celleneuve,2,6,8,2022,01-20,19:55
045 Jardin de la Lironde,2,6,8,2022,01-20,19:55
046 P�re Soulas,4,4,8,2022,01-20,19:55
047 Place Viala,1,7,8,2022,01-20,19:55
048 H�tel du D�partement,6,2,8,2022,01-20,19:55
049 Tonnelles,3,5,8,2022,01-20,19:55
050 Parvis Jules Ferry - Gare Saint-Roch,8,0,8,2022,01-20,19:55
051 Pont de Lattes - Gare Saint-Roch,0,12,12,2022,01-20,19:55
053 Deux Ponts - Gare Saint-Roch,1,7,8,2022,01-20,19:55
054 Providence - Ovalie,3,5,8,2022,01-20,19:55
055 P�rols Etang de l'Or,25,43,68,2022,01-20,19:55
056 Albert 1er - Cath�drale,4,8,12,2022,01-20,19:55
057 Saint-Guilhem - Courreau,8,0,8,2022,01-20,19:55
059 Sud De France,3,5,8,2022,01-20,19:55
001 Rue Jules Ferry - Gare Saint-Roch,5,7,12,2022,01-20,20:05
002 Com�die,12,12,24,2022,01-20,20:05
003 Esplanade,6,26,32,2022,01-20,20:05
004 H�tel de Ville,9,7,16,2022,01-20,20:05
005 Corum,5,7,12,2022,01-20,20:05
006 Place Albert 1er - St Charles,24,7,31,2022,01-20,20:05
007 Foch,4,4,8,2022,01-20,20:05
008 Halles Castellane,2,10,12,2022,01-20,20:05
009 Observatoire,8,0,8,2022,01-20,20:05
010 Rondelet,2,14,16,2022,01-20,20:05
011 Plan Cabanes,3,9,12,2022,01-20,20:05
012 Boutonnet,6,6,12,2022,01-20,20:05
013 Emile Combes,6,2,8,2022,01-20,20:05
014 Beaux-Arts,1,7,8,2022,01-20,20:05
015 Les Aubes,5,3,8,2022,01-20,20:05
016 Antigone centre,5,11,16,2022,01-20,20:05
017 M�diath�que Emile Zola,14,2,16,2022,01-20,20:05
018 Nombre d'Or,12,4,16,2022,01-20,20:05
019 Louis Blanc,14,2,16,2022,01-20,20:05
020 Gambetta,1,7,8,2022,01-20,20:05
021 Port Marianne,13,3,16,2022,01-20,20:05
022 Clemenceau,7,5,12,2022,01-20,20:05
023 Les Arceaux,6,10,16,2022,01-20,20:05
024 Cit� Mion,4,4,8,2022,01-20,20:05
025 Nouveau Saint-Roch,2,6,8,2022,01-20,20:05
026 Renouvier,3,5,8,2022,01-20,20:05
027 Odysseum,4,4,8,2022,01-20,20:05
028 Saint-Denis,5,3,8,2022,01-20,20:05
029 Richter,7,9,16,2022,01-20,20:05
030 Charles Flahault,0,8,8,2022,01-20,20:05
031 Voltaire,2,6,8,2022,01-20,20:05
032 Pr�s d'Ar�nes,5,3,8,2022,01-20,20:05
033 Garcia Lorca,7,1,8,2022,01-20,20:05
034 Vert Bois,0,16,16,2022,01-20,20:05
035 Malbosc,2,6,8,2022,01-20,20:05
036 Occitanie,2,30,32,2022,01-20,20:05
037 FacdesSciences,0,24,24,2022,01-20,20:05
038 Fac de Lettres,2,14,16,2022,01-20,20:05
039 Aiguelongue,3,5,8,2022,01-20,20:05
040 Jeu de Mail des Abb�s,1,7,8,2022,01-20,20:05
041 Eurom�decine,1,7,8,2022,01-20,20:05
042 Marie Caizergues,6,2,8,2022,01-20,20:05
043 Sabines,4,4,8,2022,01-20,20:05
044 Celleneuve,2,6,8,2022,01-20,20:05
045 Jardin de la Lironde,2,6,8,2022,01-20,20:05
046 P�re Soulas,4,4,8,2022,01-20,20:05
047 Place Viala,1,7,8,2022,01-20,20:05
048 H�tel du D�partement,6,2,8,2022,01-20,20:05
049 Tonnelles,3,5,8,2022,01-20,20:05
050 Parvis Jules Ferry - Gare Saint-Roch,8,0,8,2022,01-20,20:05
051 Pont de Lattes - Gare Saint-Roch,0,12,12,2022,01-20,20:05
053 Deux Ponts - Gare Saint-Roch,1,7,8,2022,01-20,20:05
054 Providence - Ovalie,3,5,8,2022,01-20,20:05
055 P�rols Etang de l'Or,25,43,68,2022,01-20,20:05
056 Albert 1er - Cath�drale,4,8,12,2022,01-20,20:05
057 Saint-Guilhem - Courreau,8,0,8,2022,01-20,20:05
059 Sud De France,3,5,8,2022,01-20,20:05
001 Rue Jules Ferry - Gare Saint-Roch,5,7,12,2022,01-20,20:16
002 Com�die,12,12,24,2022,01-20,20:16
003 Esplanade,5,27,32,2022,01-20,20:16
004 H�tel de Ville,9,7,16,2022,01-20,20:16
005 Corum,6,6,12,2022,01-20,20:16
006 Place Albert 1er - St Charles,24,7,31,2022,01-20,20:16
007 Foch,4,4,8,2022,01-20,20:16
008 Halles Castellane,1,11,12,2022,01-20,20:16
009 Observatoire,8,0,8,2022,01-20,20:16
010 Rondelet,2,14,16,2022,01-20,20:16
011 Plan Cabanes,3,9,12,2022,01-20,20:16
012 Boutonnet,5,7,12,2022,01-20,20:16
013 Emile Combes,6,2,8,2022,01-20,20:16
014 Beaux-Arts,1,7,8,2022,01-20,20:16
015 Les Aubes,5,3,8,2022,01-20,20:16
016 Antigone centre,5,11,16,2022,01-20,20:16
017 M�diath�que Emile Zola,15,1,16,2022,01-20,20:16
018 Nombre d'Or,12,4,16,2022,01-20,20:16
019 Louis Blanc,13,3,16,2022,01-20,20:16
020 Gambetta,1,7,8,2022,01-20,20:16
021 Port Marianne,13,3,16,2022,01-20,20:16
022 Clemenceau,7,5,12,2022,01-20,20:16
023 Les Arceaux,6,10,16,2022,01-20,20:16
024 Cit� Mion,4,4,8,2022,01-20,20:16
025 Nouveau Saint-Roch,2,6,8,2022,01-20,20:16
026 Renouvier,3,5,8,2022,01-20,20:16
027 Odysseum,4,4,8,2022,01-20,20:16
028 Saint-Denis,5,3,8,2022,01-20,20:16
029 Richter,7,9,16,2022,01-20,20:16
030 Charles Flahault,1,7,8,2022,01-20,20:16
031 Voltaire,2,6,8,2022,01-20,20:16
032 Pr�s d'Ar�nes,5,3,8,2022,01-20,20:16
033 Garcia Lorca,7,1,8,2022,01-20,20:16
034 Vert Bois,0,16,16,2022,01-20,20:16
035 Malbosc,2,6,8,2022,01-20,20:16
036 Occitanie,3,29,32,2022,01-20,20:16
037 FacdesSciences,0,24,24,2022,01-20,20:16
038 Fac de Lettres,3,13,16,2022,01-20,20:16
039 Aiguelongue,3,5,8,2022,01-20,20:16
040 Jeu de Mail des Abb�s,2,6,8,2022,01-20,20:16
041 Eurom�decine,1,7,8,2022,01-20,20:16
042 Marie Caizergues,5,3,8,2022,01-20,20:16
043 Sabines,4,4,8,2022,01-20,20:16
044 Celleneuve,2,6,8,2022,01-20,20:16
045 Jardin de la Lironde,2,6,8,2022,01-20,20:16
046 P�re Soulas,4,4,8,2022,01-20,20:16
047 Place Viala,2,6,8,2022,01-20,20:16
048 H�tel du D�partement,6,2,8,2022,01-20,20:16
049 Tonnelles,3,5,8,2022,01-20,20:16
050 Parvis Jules Ferry - Gare Saint-Roch,8,0,8,2022,01-20,20:16
051 Pont de Lattes - Gare Saint-Roch,0,12,12,2022,01-20,20:16
053 Deux Ponts - Gare Saint-Roch,1,7,8,2022,01-20,20:16
054 Providence - Ovalie,3,5,8,2022,01-20,20:16
055 P�rols Etang de l'Or,25,43,68,2022,01-20,20:16
056 Albert 1er - Cath�drale,4,8,12,2022,01-20,20:16
057 Saint-Guilhem - Courreau,8,0,8,2022,01-20,20:16
059 Sud De France,3,5,8,2022,01-20,20:16
001 Rue Jules Ferry - Gare Saint-Roch,4,8,12,2022,01-20,20:26
002 Com�die,12,12,24,2022,01-20,20:26
003 Esplanade,5,27,32,2022,01-20,20:26
004 H�tel de Ville,9,7,16,2022,01-20,20:26
005 Corum,6,6,12,2022,01-20,20:26
006 Place Albert 1er - St Charles,25,6,31,2022,01-20,20:26
007 Foch,4,4,8,2022,01-20,20:26
008 Halles Castellane,1,11,12,2022,01-20,20:26
009 Observatoire,8,0,8,2022,01-20,20:26
010 Rondelet,2,14,16,2022,01-20,20:26
011 Plan Cabanes,3,9,12,2022,01-20,20:26
012 Boutonnet,5,7,12,2022,01-20,20:26
013 Emile Combes,6,2,8,2022,01-20,20:26
014 Beaux-Arts,1,7,8,2022,01-20,20:26
015 Les Aubes,5,3,8,2022,01-20,20:26
016 Antigone centre,6,10,16,2022,01-20,20:26
017 M�diath�que Emile Zola,15,1,16,2022,01-20,20:26
018 Nombre d'Or,12,4,16,2022,01-20,20:26
019 Louis Blanc,13,3,16,2022,01-20,20:26
020 Gambetta,1,7,8,2022,01-20,20:26
021 Port Marianne,13,3,16,2022,01-20,20:26
022 Clemenceau,8,4,12,2022,01-20,20:26
023 Les Arceaux,5,11,16,2022,01-20,20:26
024 Cit� Mion,4,4,8,2022,01-20,20:26
025 Nouveau Saint-Roch,2,6,8,2022,01-20,20:26
026 Renouvier,3,5,8,2022,01-20,20:26
027 Odysseum,4,4,8,2022,01-20,20:26
028 Saint-Denis,7,1,8,2022,01-20,20:26
029 Richter,7,9,16,2022,01-20,20:26
030 Charles Flahault,1,7,8,2022,01-20,20:26
031 Voltaire,2,6,8,2022,01-20,20:26
032 Pr�s d'Ar�nes,5,3,8,2022,01-20,20:26
033 Garcia Lorca,7,1,8,2022,01-20,20:26
034 Vert Bois,0,16,16,2022,01-20,20:26
035 Malbosc,2,6,8,2022,01-20,20:26
036 Occitanie,2,30,32,2022,01-20,20:26
037 FacdesSciences,0,24,24,2022,01-20,20:26
038 Fac de Lettres,3,13,16,2022,01-20,20:26
039 Aiguelongue,3,5,8,2022,01-20,20:26
040 Jeu de Mail des Abb�s,2,6,8,2022,01-20,20:26
041 Eurom�decine,1,7,8,2022,01-20,20:26
042 Marie Caizergues,5,3,8,2022,01-20,20:26
043 Sabines,4,4,8,2022,01-20,20:26
044 Celleneuve,2,6,8,2022,01-20,20:26
045 Jardin de la Lironde,2,6,8,2022,01-20,20:26
046 P�re Soulas,4,4,8,2022,01-20,20:26
047 Place Viala,1,7,8,2022,01-20,20:26
048 H�tel du D�partement,6,2,8,2022,01-20,20:26
049 Tonnelles,3,5,8,2022,01-20,20:26
050 Parvis Jules Ferry - Gare Saint-Roch,8,0,8,2022,01-20,20:26
051 Pont de Lattes - Gare Saint-Roch,0,12,12,2022,01-20,20:26
053 Deux Ponts - Gare Saint-Roch,1,7,8,2022,01-20,20:26
054 Providence - Ovalie,3,5,8,2022,01-20,20:26
055 P�rols Etang de l'Or,25,43,68,2022,01-20,20:26
056 Albert 1er - Cath�drale,4,8,12,2022,01-20,20:26
057 Saint-Guilhem - Courreau,7,1,8,2022,01-20,20:26
059 Sud De France,3,5,8,2022,01-20,20:26
001 Rue Jules Ferry - Gare Saint-Roch,6,6,12,2022,01-20,20:36
002 Com�die,12,12,24,2022,01-20,20:36
003 Esplanade,5,27,32,2022,01-20,20:36
004 H�tel de Ville,9,7,16,2022,01-20,20:36
005 Corum,6,6,12,2022,01-20,20:36
006 Place Albert 1er - St Charles,25,6,31,2022,01-20,20:36
007 Foch,4,4,8,2022,01-20,20:36
008 Halles Castellane,1,11,12,2022,01-20,20:36
009 Observatoire,8,0,8,2022,01-20,20:36
010 Rondelet,2,14,16,2022,01-20,20:36
011 Plan Cabanes,3,9,12,2022,01-20,20:36
012 Boutonnet,5,7,12,2022,01-20,20:36
013 Emile Combes,6,2,8,2022,01-20,20:36
014 Beaux-Arts,1,7,8,2022,01-20,20:36
015 Les Aubes,5,3,8,2022,01-20,20:36
016 Antigone centre,7,9,16,2022,01-20,20:36
017 M�diath�que Emile Zola,15,1,16,2022,01-20,20:36
018 Nombre d'Or,12,4,16,2022,01-20,20:36
019 Louis Blanc,13,3,16,2022,01-20,20:36
020 Gambetta,1,7,8,2022,01-20,20:36
021 Port Marianne,13,3,16,2022,01-20,20:36
022 Clemenceau,8,4,12,2022,01-20,20:36
023 Les Arceaux,5,11,16,2022,01-20,20:36
024 Cit� Mion,4,4,8,2022,01-20,20:36
025 Nouveau Saint-Roch,2,6,8,2022,01-20,20:36
026 Renouvier,3,5,8,2022,01-20,20:36
027 Odysseum,4,4,8,2022,01-20,20:36
028 Saint-Denis,7,1,8,2022,01-20,20:36
029 Richter,7,9,16,2022,01-20,20:36
030 Charles Flahault,1,7,8,2022,01-20,20:36
031 Voltaire,2,6,8,2022,01-20,20:36
032 Pr�s d'Ar�nes,5,3,8,2022,01-20,20:36
033 Garcia Lorca,7,1,8,2022,01-20,20:36
034 Vert Bois,0,16,16,2022,01-20,20:36
035 Malbosc,2,6,8,2022,01-20,20:36
036 Occitanie,2,30,32,2022,01-20,20:36
037 FacdesSciences,0,24,24,2022,01-20,20:36
038 Fac de Lettres,3,13,16,2022,01-20,20:36
039 Aiguelongue,3,5,8,2022,01-20,20:36
040 Jeu de Mail des Abb�s,3,5,8,2022,01-20,20:36
041 Eurom�decine,1,7,8,2022,01-20,20:36
042 Marie Caizergues,6,2,8,2022,01-20,20:36
043 Sabines,4,4,8,2022,01-20,20:36
044 Celleneuve,1,7,8,2022,01-20,20:36
045 Jardin de la Lironde,2,6,8,2022,01-20,20:36
046 P�re Soulas,4,4,8,2022,01-20,20:36
047 Place Viala,1,7,8,2022,01-20,20:36
048 H�tel du D�partement,6,2,8,2022,01-20,20:36
049 Tonnelles,3,5,8,2022,01-20,20:36
050 Parvis Jules Ferry - Gare Saint-Roch,8,0,8,2022,01-20,20:36
051 Pont de Lattes - Gare Saint-Roch,0,12,12,2022,01-20,20:36
053 Deux Ponts - Gare Saint-Roch,1,7,8,2022,01-20,20:36
054 Providence - Ovalie,3,5,8,2022,01-20,20:36
055 P�rols Etang de l'Or,25,43,68,2022,01-20,20:36
056 Albert 1er - Cath�drale,4,8,12,2022,01-20,20:36
057 Saint-Guilhem - Courreau,7,1,8,2022,01-20,20:36
059 Sud De France,3,5,8,2022,01-20,20:36
001 Rue Jules Ferry - Gare Saint-Roch,6,6,12,2022,01-20,20:46
002 Com�die,12,12,24,2022,01-20,20:46
003 Esplanade,5,27,32,2022,01-20,20:46
004 H�tel de Ville,9,7,16,2022,01-20,20:46
005 Corum,6,6,12,2022,01-20,20:46
006 Place Albert 1er - St Charles,24,7,31,2022,01-20,20:46
007 Foch,4,4,8,2022,01-20,20:46
008 Halles Castellane,1,11,12,2022,01-20,20:46
009 Observatoire,8,0,8,2022,01-20,20:46
010 Rondelet,2,14,16,2022,01-20,20:46
011 Plan Cabanes,3,9,12,2022,01-20,20:46
012 Boutonnet,5,7,12,2022,01-20,20:46
013 Emile Combes,7,1,8,2022,01-20,20:46
014 Beaux-Arts,1,7,8,2022,01-20,20:46
015 Les Aubes,5,3,8,2022,01-20,20:46
016 Antigone centre,7,9,16,2022,01-20,20:46
017 M�diath�que Emile Zola,15,1,16,2022,01-20,20:46
018 Nombre d'Or,12,4,16,2022,01-20,20:46
019 Louis Blanc,13,3,16,2022,01-20,20:46
020 Gambetta,1,7,8,2022,01-20,20:46
021 Port Marianne,13,3,16,2022,01-20,20:46
022 Clemenceau,8,4,12,2022,01-20,20:46
023 Les Arceaux,4,12,16,2022,01-20,20:46
024 Cit� Mion,4,4,8,2022,01-20,20:46
025 Nouveau Saint-Roch,2,6,8,2022,01-20,20:46
026 Renouvier,3,5,8,2022,01-20,20:46
027 Odysseum,4,4,8,2022,01-20,20:46
028 Saint-Denis,7,1,8,2022,01-20,20:46
029 Richter,7,9,16,2022,01-20,20:46
030 Charles Flahault,1,7,8,2022,01-20,20:46
031 Voltaire,2,6,8,2022,01-20,20:46
032 Pr�s d'Ar�nes,5,3,8,2022,01-20,20:46
033 Garcia Lorca,7,1,8,2022,01-20,20:46
034 Vert Bois,0,16,16,2022,01-20,20:46
035 Malbosc,2,6,8,2022,01-20,20:46
036 Occitanie,2,30,32,2022,01-20,20:46
037 FacdesSciences,0,24,24,2022,01-20,20:46
038 Fac de Lettres,3,13,16,2022,01-20,20:46
039 Aiguelongue,3,5,8,2022,01-20,20:46
040 Jeu de Mail des Abb�s,3,5,8,2022,01-20,20:46
041 Eurom�decine,1,7,8,2022,01-20,20:46
042 Marie Caizergues,6,2,8,2022,01-20,20:46
043 Sabines,4,4,8,2022,01-20,20:46
044 Celleneuve,1,7,8,2022,01-20,20:46
045 Jardin de la Lironde,2,6,8,2022,01-20,20:46
046 P�re Soulas,4,4,8,2022,01-20,20:46
047 Place Viala,1,7,8,2022,01-20,20:46
048 H�tel du D�partement,6,2,8,2022,01-20,20:46
049 Tonnelles,2,6,8,2022,01-20,20:46
050 Parvis Jules Ferry - Gare Saint-Roch,8,0,8,2022,01-20,20:46
051 Pont de Lattes - Gare Saint-Roch,0,12,12,2022,01-20,20:46
053 Deux Ponts - Gare Saint-Roch,1,7,8,2022,01-20,20:46
054 Providence - Ovalie,3,5,8,2022,01-20,20:46
055 P�rols Etang de l'Or,25,43,68,2022,01-20,20:46
056 Albert 1er - Cath�drale,4,8,12,2022,01-20,20:46
057 Saint-Guilhem - Courreau,7,1,8,2022,01-20,20:46
059 Sud De France,3,5,8,2022,01-20,20:46
001 Rue Jules Ferry - Gare Saint-Roch,6,6,12,2022,01-20,20:56
002 Com�die,12,12,24,2022,01-20,20:56
003 Esplanade,5,27,32,2022,01-20,20:56
004 H�tel de Ville,9,7,16,2022,01-20,20:56
005 Corum,6,6,12,2022,01-20,20:56
006 Place Albert 1er - St Charles,24,7,31,2022,01-20,20:56
007 Foch,4,4,8,2022,01-20,20:56
008 Halles Castellane,1,11,12,2022,01-20,20:56
009 Observatoire,8,0,8,2022,01-20,20:56
010 Rondelet,2,14,16,2022,01-20,20:56
011 Plan Cabanes,3,9,12,2022,01-20,20:56
012 Boutonnet,6,6,12,2022,01-20,20:56
013 Emile Combes,7,1,8,2022,01-20,20:56
014 Beaux-Arts,1,7,8,2022,01-20,20:56
015 Les Aubes,5,3,8,2022,01-20,20:56
016 Antigone centre,7,9,16,2022,01-20,20:56
017 M�diath�que Emile Zola,15,1,16,2022,01-20,20:56
018 Nombre d'Or,12,4,16,2022,01-20,20:56
019 Louis Blanc,13,3,16,2022,01-20,20:56
020 Gambetta,1,7,8,2022,01-20,20:56
021 Port Marianne,13,3,16,2022,01-20,20:56
022 Clemenceau,8,4,12,2022,01-20,20:56
023 Les Arceaux,4,12,16,2022,01-20,20:56
024 Cit� Mion,4,4,8,2022,01-20,20:56
025 Nouveau Saint-Roch,2,6,8,2022,01-20,20:56
026 Renouvier,3,5,8,2022,01-20,20:56
027 Odysseum,4,4,8,2022,01-20,20:56
028 Saint-Denis,7,1,8,2022,01-20,20:56
029 Richter,7,9,16,2022,01-20,20:56
030 Charles Flahault,1,7,8,2022,01-20,20:56
031 Voltaire,2,6,8,2022,01-20,20:56
032 Pr�s d'Ar�nes,5,3,8,2022,01-20,20:56
033 Garcia Lorca,7,1,8,2022,01-20,20:56
034 Vert Bois,0,16,16,2022,01-20,20:56
035 Malbosc,2,6,8,2022,01-20,20:56
036 Occitanie,2,30,32,2022,01-20,20:56
037 FacdesSciences,0,24,24,2022,01-20,20:56
038 Fac de Lettres,3,13,16,2022,01-20,20:56
039 Aiguelongue,3,5,8,2022,01-20,20:56
040 Jeu de Mail des Abb�s,3,5,8,2022,01-20,20:56
041 Eurom�decine,1,7,8,2022,01-20,20:56
042 Marie Caizergues,7,1,8,2022,01-20,20:56
043 Sabines,4,4,8,2022,01-20,20:56
044 Celleneuve,1,7,8,2022,01-20,20:56
045 Jardin de la Lironde,2,6,8,2022,01-20,20:56
046 P�re Soulas,4,4,8,2022,01-20,20:56
047 Place Viala,1,7,8,2022,01-20,20:56
048 H�tel du D�partement,6,2,8,2022,01-20,20:56
049 Tonnelles,2,6,8,2022,01-20,20:56
050 Parvis Jules Ferry - Gare Saint-Roch,8,0,8,2022,01-20,20:56
051 Pont de Lattes - Gare Saint-Roch,0,12,12,2022,01-20,20:56
053 Deux Ponts - Gare Saint-Roch,2,6,8,2022,01-20,20:56
054 Providence - Ovalie,3,5,8,2022,01-20,20:56
055 P�rols Etang de l'Or,25,43,68,2022,01-20,20:56
056 Albert 1er - Cath�drale,4,8,12,2022,01-20,20:56
057 Saint-Guilhem - Courreau,8,0,8,2022,01-20,20:56
059 Sud De France,3,5,8,2022,01-20,20:56
001 Rue Jules Ferry - Gare Saint-Roch,5,7,12,2022,01-20,21:06
002 Com�die,13,11,24,2022,01-20,21:06
003 Esplanade,5,27,32,2022,01-20,21:06
004 H�tel de Ville,9,7,16,2022,01-20,21:06
005 Corum,6,6,12,2022,01-20,21:06
006 Place Albert 1er - St Charles,23,8,31,2022,01-20,21:06
007 Foch,4,4,8,2022,01-20,21:06
008 Halles Castellane,1,11,12,2022,01-20,21:06
009 Observatoire,8,0,8,2022,01-20,21:06
010 Rondelet,1,15,16,2022,01-20,21:06
011 Plan Cabanes,3,9,12,2022,01-20,21:06
012 Boutonnet,5,7,12,2022,01-20,21:06
013 Emile Combes,7,1,8,2022,01-20,21:06
014 Beaux-Arts,1,7,8,2022,01-20,21:06
015 Les Aubes,5,3,8,2022,01-20,21:06
016 Antigone centre,7,9,16,2022,01-20,21:06
017 M�diath�que Emile Zola,15,1,16,2022,01-20,21:06
018 Nombre d'Or,12,4,16,2022,01-20,21:06
019 Louis Blanc,15,1,16,2022,01-20,21:06
020 Gambetta,1,7,8,2022,01-20,21:06
021 Port Marianne,12,4,16,2022,01-20,21:06
022 Clemenceau,8,4,12,2022,01-20,21:06
023 Les Arceaux,4,12,16,2022,01-20,21:06
024 Cit� Mion,4,4,8,2022,01-20,21:06
025 Nouveau Saint-Roch,4,4,8,2022,01-20,21:06
026 Renouvier,3,5,8,2022,01-20,21:06
027 Odysseum,4,4,8,2022,01-20,21:06
028 Saint-Denis,7,1,8,2022,01-20,21:06
029 Richter,7,9,16,2022,01-20,21:06
030 Charles Flahault,1,7,8,2022,01-20,21:06
031 Voltaire,2,6,8,2022,01-20,21:06
032 Pr�s d'Ar�nes,4,4,8,2022,01-20,21:06
033 Garcia Lorca,7,1,8,2022,01-20,21:06
034 Vert Bois,0,16,16,2022,01-20,21:06
035 Malbosc,2,6,8,2022,01-20,21:06
036 Occitanie,2,30,32,2022,01-20,21:06
037 FacdesSciences,0,24,24,2022,01-20,21:06
038 Fac de Lettres,3,13,16,2022,01-20,21:06
039 Aiguelongue,3,5,8,2022,01-20,21:06
040 Jeu de Mail des Abb�s,1,7,8,2022,01-20,21:06
041 Eurom�decine,1,7,8,2022,01-20,21:06
042 Marie Caizergues,7,1,8,2022,01-20,21:06
043 Sabines,4,4,8,2022,01-20,21:06
044 Celleneuve,1,7,8,2022,01-20,21:06
045 Jardin de la Lironde,2,6,8,2022,01-20,21:06
046 P�re Soulas,3,5,8,2022,01-20,21:06
047 Place Viala,1,7,8,2022,01-20,21:06
048 H�tel du D�partement,6,2,8,2022,01-20,21:06
049 Tonnelles,2,6,8,2022,01-20,21:06
050 Parvis Jules Ferry - Gare Saint-Roch,8,0,8,2022,01-20,21:06
051 Pont de Lattes - Gare Saint-Roch,0,12,12,2022,01-20,21:06
053 Deux Ponts - Gare Saint-Roch,2,6,8,2022,01-20,21:06
054 Providence - Ovalie,3,5,8,2022,01-20,21:06
055 P�rols Etang de l'Or,25,43,68,2022,01-20,21:06
056 Albert 1er - Cath�drale,4,8,12,2022,01-20,21:06
057 Saint-Guilhem - Courreau,8,0,8,2022,01-20,21:06
059 Sud De France,3,5,8,2022,01-20,21:06
001 Rue Jules Ferry - Gare Saint-Roch,4,8,12,2022,01-20,21:17
002 Com�die,13,11,24,2022,01-20,21:17
003 Esplanade,5,27,32,2022,01-20,21:17
004 H�tel de Ville,9,7,16,2022,01-20,21:17
005 Corum,7,5,12,2022,01-20,21:17
006 Place Albert 1er - St Charles,24,7,31,2022,01-20,21:17
007 Foch,4,4,8,2022,01-20,21:17
008 Halles Castellane,1,11,12,2022,01-20,21:17
009 Observatoire,8,0,8,2022,01-20,21:17
010 Rondelet,1,15,16,2022,01-20,21:17
011 Plan Cabanes,4,8,12,2022,01-20,21:17
012 Boutonnet,4,8,12,2022,01-20,21:17
013 Emile Combes,7,1,8,2022,01-20,21:17
014 Beaux-Arts,1,7,8,2022,01-20,21:17
015 Les Aubes,6,2,8,2022,01-20,21:17
016 Antigone centre,7,9,16,2022,01-20,21:17
017 M�diath�que Emile Zola,15,1,16,2022,01-20,21:17
018 Nombre d'Or,12,4,16,2022,01-20,21:17
019 Louis Blanc,15,1,16,2022,01-20,21:17
020 Gambetta,1,7,8,2022,01-20,21:17
021 Port Marianne,12,4,16,2022,01-20,21:17
022 Clemenceau,8,4,12,2022,01-20,21:17
023 Les Arceaux,4,12,16,2022,01-20,21:17
024 Cit� Mion,4,4,8,2022,01-20,21:17
025 Nouveau Saint-Roch,4,4,8,2022,01-20,21:17
026 Renouvier,3,5,8,2022,01-20,21:17
027 Odysseum,4,4,8,2022,01-20,21:17
028 Saint-Denis,7,1,8,2022,01-20,21:17
029 Richter,7,9,16,2022,01-20,21:17
030 Charles Flahault,0,8,8,2022,01-20,21:17
031 Voltaire,2,6,8,2022,01-20,21:17
032 Pr�s d'Ar�nes,4,4,8,2022,01-20,21:17
033 Garcia Lorca,7,1,8,2022,01-20,21:17
034 Vert Bois,0,16,16,2022,01-20,21:17
035 Malbosc,2,6,8,2022,01-20,21:17
036 Occitanie,2,30,32,2022,01-20,21:17
037 FacdesSciences,0,24,24,2022,01-20,21:17
038 Fac de Lettres,3,13,16,2022,01-20,21:17
039 Aiguelongue,3,5,8,2022,01-20,21:17
040 Jeu de Mail des Abb�s,1,7,8,2022,01-20,21:17
041 Eurom�decine,1,7,8,2022,01-20,21:17
042 Marie Caizergues,7,1,8,2022,01-20,21:17
043 Sabines,4,4,8,2022,01-20,21:17
044 Celleneuve,1,7,8,2022,01-20,21:17
045 Jardin de la Lironde,2,6,8,2022,01-20,21:17
046 P�re Soulas,3,5,8,2022,01-20,21:17
047 Place Viala,0,8,8,2022,01-20,21:17
048 H�tel du D�partement,6,2,8,2022,01-20,21:17
049 Tonnelles,2,6,8,2022,01-20,21:17
050 Parvis Jules Ferry - Gare Saint-Roch,8,0,8,2022,01-20,21:17
051 Pont de Lattes - Gare Saint-Roch,0,12,12,2022,01-20,21:17
053 Deux Ponts - Gare Saint-Roch,2,6,8,2022,01-20,21:17
054 Providence - Ovalie,3,5,8,2022,01-20,21:17
055 P�rols Etang de l'Or,25,43,68,2022,01-20,21:17
056 Albert 1er - Cath�drale,4,8,12,2022,01-20,21:17
057 Saint-Guilhem - Courreau,8,0,8,2022,01-20,21:17
059 Sud De France,3,5,8,2022,01-20,21:17
001 Rue Jules Ferry - Gare Saint-Roch,4,8,12,2022,01-20,21:27
002 Com�die,14,10,24,2022,01-20,21:27
003 Esplanade,4,28,32,2022,01-20,21:27
004 H�tel de Ville,9,7,16,2022,01-20,21:27
005 Corum,10,2,12,2022,01-20,21:27
006 Place Albert 1er - St Charles,24,7,31,2022,01-20,21:27
007 Foch,4,4,8,2022,01-20,21:27
008 Halles Castellane,1,11,12,2022,01-20,21:27
009 Observatoire,8,0,8,2022,01-20,21:27
010 Rondelet,1,15,16,2022,01-20,21:27
011 Plan Cabanes,3,9,12,2022,01-20,21:27
012 Boutonnet,4,8,12,2022,01-20,21:27
013 Emile Combes,7,1,8,2022,01-20,21:27
014 Beaux-Arts,1,7,8,2022,01-20,21:27
015 Les Aubes,6,2,8,2022,01-20,21:27
016 Antigone centre,7,9,16,2022,01-20,21:27
017 M�diath�que Emile Zola,15,1,16,2022,01-20,21:27
018 Nombre d'Or,12,4,16,2022,01-20,21:27
019 Louis Blanc,15,1,16,2022,01-20,21:27
020 Gambetta,1,7,8,2022,01-20,21:27
021 Port Marianne,12,4,16,2022,01-20,21:27
022 Clemenceau,8,4,12,2022,01-20,21:27
023 Les Arceaux,3,13,16,2022,01-20,21:27
024 Cit� Mion,4,4,8,2022,01-20,21:27
025 Nouveau Saint-Roch,4,4,8,2022,01-20,21:27
026 Renouvier,3,5,8,2022,01-20,21:27
027 Odysseum,4,4,8,2022,01-20,21:27
028 Saint-Denis,8,0,8,2022,01-20,21:27
029 Richter,7,9,16,2022,01-20,21:27
030 Charles Flahault,0,8,8,2022,01-20,21:27
031 Voltaire,2,6,8,2022,01-20,21:27
032 Pr�s d'Ar�nes,4,4,8,2022,01-20,21:27
033 Garcia Lorca,7,1,8,2022,01-20,21:27
034 Vert Bois,0,16,16,2022,01-20,21:27
035 Malbosc,2,6,8,2022,01-20,21:27
036 Occitanie,2,30,32,2022,01-20,21:27
037 FacdesSciences,1,23,24,2022,01-20,21:27
038 Fac de Lettres,4,12,16,2022,01-20,21:27
039 Aiguelongue,3,5,8,2022,01-20,21:27
040 Jeu de Mail des Abb�s,1,7,8,2022,01-20,21:27
041 Eurom�decine,1,7,8,2022,01-20,21:27
042 Marie Caizergues,7,1,8,2022,01-20,21:27
043 Sabines,4,4,8,2022,01-20,21:27
044 Celleneuve,1,7,8,2022,01-20,21:27
045 Jardin de la Lironde,2,6,8,2022,01-20,21:27
046 P�re Soulas,3,5,8,2022,01-20,21:27
047 Place Viala,0,8,8,2022,01-20,21:27
048 H�tel du D�partement,6,2,8,2022,01-20,21:27
049 Tonnelles,2,6,8,2022,01-20,21:27
050 Parvis Jules Ferry - Gare Saint-Roch,8,0,8,2022,01-20,21:27
051 Pont de Lattes - Gare Saint-Roch,0,12,12,2022,01-20,21:27
053 Deux Ponts - Gare Saint-Roch,2,6,8,2022,01-20,21:27
054 Providence - Ovalie,3,5,8,2022,01-20,21:27
055 P�rols Etang de l'Or,25,43,68,2022,01-20,21:27
056 Albert 1er - Cath�drale,4,8,12,2022,01-20,21:27
057 Saint-Guilhem - Courreau,8,0,8,2022,01-20,21:27
059 Sud De France,3,5,8,2022,01-20,21:27
001 Rue Jules Ferry - Gare Saint-Roch,5,7,12,2022,01-20,21:37
002 Com�die,14,10,24,2022,01-20,21:37
003 Esplanade,4,28,32,2022,01-20,21:37
004 H�tel de Ville,9,7,16,2022,01-20,21:37
005 Corum,10,2,12,2022,01-20,21:37
006 Place Albert 1er - St Charles,24,7,31,2022,01-20,21:37
007 Foch,4,4,8,2022,01-20,21:37
008 Halles Castellane,1,11,12,2022,01-20,21:37
009 Observatoire,8,0,8,2022,01-20,21:37
010 Rondelet,1,15,16,2022,01-20,21:37
011 Plan Cabanes,3,9,12,2022,01-20,21:37
012 Boutonnet,2,10,12,2022,01-20,21:37
013 Emile Combes,7,1,8,2022,01-20,21:37
014 Beaux-Arts,1,7,8,2022,01-20,21:37
015 Les Aubes,6,2,8,2022,01-20,21:37
016 Antigone centre,7,9,16,2022,01-20,21:37
017 M�diath�que Emile Zola,14,2,16,2022,01-20,21:37
018 Nombre d'Or,12,4,16,2022,01-20,21:37
019 Louis Blanc,15,1,16,2022,01-20,21:37
020 Gambetta,1,7,8,2022,01-20,21:37
021 Port Marianne,12,4,16,2022,01-20,21:37
022 Clemenceau,8,4,12,2022,01-20,21:37
023 Les Arceaux,3,13,16,2022,01-20,21:37
024 Cit� Mion,4,4,8,2022,01-20,21:37
025 Nouveau Saint-Roch,4,4,8,2022,01-20,21:37
026 Renouvier,3,5,8,2022,01-20,21:37
027 Odysseum,4,4,8,2022,01-20,21:37
028 Saint-Denis,8,0,8,2022,01-20,21:37
029 Richter,7,9,16,2022,01-20,21:37
030 Charles Flahault,0,8,8,2022,01-20,21:37
031 Voltaire,2,6,8,2022,01-20,21:37
032 Pr�s d'Ar�nes,4,4,8,2022,01-20,21:37
033 Garcia Lorca,7,1,8,2022,01-20,21:37
034 Vert Bois,0,16,16,2022,01-20,21:37
035 Malbosc,2,6,8,2022,01-20,21:37
036 Occitanie,2,30,32,2022,01-20,21:37
037 FacdesSciences,0,24,24,2022,01-20,21:37
038 Fac de Lettres,4,12,16,2022,01-20,21:37
039 Aiguelongue,3,5,8,2022,01-20,21:37
040 Jeu de Mail des Abb�s,1,7,8,2022,01-20,21:37
041 Eurom�decine,1,7,8,2022,01-20,21:37
042 Marie Caizergues,7,1,8,2022,01-20,21:37
043 Sabines,4,4,8,2022,01-20,21:37
044 Celleneuve,1,7,8,2022,01-20,21:37
045 Jardin de la Lironde,2,6,8,2022,01-20,21:37
046 P�re Soulas,3,5,8,2022,01-20,21:37
047 Place Viala,0,8,8,2022,01-20,21:37
048 H�tel du D�partement,6,2,8,2022,01-20,21:37
049 Tonnelles,2,6,8,2022,01-20,21:37
050 Parvis Jules Ferry - Gare Saint-Roch,8,0,8,2022,01-20,21:37
051 Pont de Lattes - Gare Saint-Roch,0,12,12,2022,01-20,21:37
053 Deux Ponts - Gare Saint-Roch,2,6,8,2022,01-20,21:37
054 Providence - Ovalie,3,5,8,2022,01-20,21:37
055 P�rols Etang de l'Or,25,43,68,2022,01-20,21:37
056 Albert 1er - Cath�drale,4,8,12,2022,01-20,21:37
057 Saint-Guilhem - Courreau,8,0,8,2022,01-20,21:37
059 Sud De France,3,5,8,2022,01-20,21:37
001 Rue Jules Ferry - Gare Saint-Roch,5,7,12,2022,01-20,21:47
002 Com�die,15,9,24,2022,01-20,21:47
003 Esplanade,4,28,32,2022,01-20,21:47
004 H�tel de Ville,9,7,16,2022,01-20,21:47
005 Corum,11,1,12,2022,01-20,21:47
006 Place Albert 1er - St Charles,24,7,31,2022,01-20,21:47
007 Foch,2,6,8,2022,01-20,21:47
008 Halles Castellane,1,11,12,2022,01-20,21:47
009 Observatoire,8,0,8,2022,01-20,21:47
010 Rondelet,1,15,16,2022,01-20,21:47
011 Plan Cabanes,3,9,12,2022,01-20,21:47
012 Boutonnet,2,10,12,2022,01-20,21:47
013 Emile Combes,7,1,8,2022,01-20,21:47
014 Beaux-Arts,2,6,8,2022,01-20,21:47
015 Les Aubes,6,2,8,2022,01-20,21:47
016 Antigone centre,7,9,16,2022,01-20,21:47
017 M�diath�que Emile Zola,14,2,16,2022,01-20,21:47
018 Nombre d'Or,12,4,16,2022,01-20,21:47
019 Louis Blanc,15,1,16,2022,01-20,21:47
020 Gambetta,1,7,8,2022,01-20,21:47
021 Port Marianne,12,4,16,2022,01-20,21:47
022 Clemenceau,8,4,12,2022,01-20,21:47
023 Les Arceaux,3,13,16,2022,01-20,21:47
024 Cit� Mion,4,4,8,2022,01-20,21:47
025 Nouveau Saint-Roch,4,4,8,2022,01-20,21:47
026 Renouvier,3,5,8,2022,01-20,21:47
027 Odysseum,4,4,8,2022,01-20,21:47
028 Saint-Denis,8,0,8,2022,01-20,21:47
029 Richter,7,9,16,2022,01-20,21:47
030 Charles Flahault,0,8,8,2022,01-20,21:47
031 Voltaire,2,6,8,2022,01-20,21:47
032 Pr�s d'Ar�nes,4,4,8,2022,01-20,21:47
033 Garcia Lorca,7,1,8,2022,01-20,21:47
034 Vert Bois,0,16,16,2022,01-20,21:47
035 Malbosc,2,6,8,2022,01-20,21:47
036 Occitanie,2,30,32,2022,01-20,21:47
037 FacdesSciences,0,24,24,2022,01-20,21:47
038 Fac de Lettres,4,12,16,2022,01-20,21:47
039 Aiguelongue,3,5,8,2022,01-20,21:47
040 Jeu de Mail des Abb�s,1,7,8,2022,01-20,21:47
041 Eurom�decine,1,7,8,2022,01-20,21:47
042 Marie Caizergues,7,1,8,2022,01-20,21:47
043 Sabines,4,4,8,2022,01-20,21:47
044 Celleneuve,1,7,8,2022,01-20,21:47
045 Jardin de la Lironde,3,5,8,2022,01-20,21:47
046 P�re Soulas,3,5,8,2022,01-20,21:47
047 Place Viala,0,8,8,2022,01-20,21:47
048 H�tel du D�partement,6,2,8,2022,01-20,21:47
049 Tonnelles,2,6,8,2022,01-20,21:47
050 Parvis Jules Ferry - Gare Saint-Roch,7,1,8,2022,01-20,21:47
051 Pont de Lattes - Gare Saint-Roch,0,12,12,2022,01-20,21:47
053 Deux Ponts - Gare Saint-Roch,2,6,8,2022,01-20,21:47
054 Providence - Ovalie,3,5,8,2022,01-20,21:47
055 P�rols Etang de l'Or,25,43,68,2022,01-20,21:47
056 Albert 1er - Cath�drale,4,8,12,2022,01-20,21:47
057 Saint-Guilhem - Courreau,8,0,8,2022,01-20,21:47
059 Sud De France,3,5,8,2022,01-20,21:47
001 Rue Jules Ferry - Gare Saint-Roch,5,7,12,2022,01-20,21:57
002 Com�die,15,9,24,2022,01-20,21:57
003 Esplanade,4,28,32,2022,01-20,21:57
004 H�tel de Ville,8,8,16,2022,01-20,21:57
005 Corum,11,1,12,2022,01-20,21:57
006 Place Albert 1er - St Charles,23,8,31,2022,01-20,21:57
007 Foch,2,6,8,2022,01-20,21:57
008 Halles Castellane,1,11,12,2022,01-20,21:57
009 Observatoire,8,0,8,2022,01-20,21:57
010 Rondelet,1,15,16,2022,01-20,21:57
011 Plan Cabanes,3,9,12,2022,01-20,21:57
012 Boutonnet,2,10,12,2022,01-20,21:57
013 Emile Combes,7,1,8,2022,01-20,21:57
014 Beaux-Arts,2,6,8,2022,01-20,21:57
015 Les Aubes,6,2,8,2022,01-20,21:57
016 Antigone centre,7,9,16,2022,01-20,21:57
017 M�diath�que Emile Zola,14,2,16,2022,01-20,21:57
018 Nombre d'Or,12,4,16,2022,01-20,21:57
019 Louis Blanc,15,1,16,2022,01-20,21:57
020 Gambetta,1,7,8,2022,01-20,21:57
021 Port Marianne,12,4,16,2022,01-20,21:57
022 Clemenceau,8,4,12,2022,01-20,21:57
023 Les Arceaux,3,13,16,2022,01-20,21:57
024 Cit� Mion,4,4,8,2022,01-20,21:57
025 Nouveau Saint-Roch,4,4,8,2022,01-20,21:57
026 Renouvier,3,5,8,2022,01-20,21:57
027 Odysseum,4,4,8,2022,01-20,21:57
028 Saint-Denis,8,0,8,2022,01-20,21:57
029 Richter,7,9,16,2022,01-20,21:57
030 Charles Flahault,0,8,8,2022,01-20,21:57
031 Voltaire,2,6,8,2022,01-20,21:57
032 Pr�s d'Ar�nes,4,4,8,2022,01-20,21:57
033 Garcia Lorca,7,1,8,2022,01-20,21:57
034 Vert Bois,0,16,16,2022,01-20,21:57
035 Malbosc,2,6,8,2022,01-20,21:57
036 Occitanie,2,30,32,2022,01-20,21:57
037 FacdesSciences,0,24,24,2022,01-20,21:57
038 Fac de Lettres,4,12,16,2022,01-20,21:57
039 Aiguelongue,3,5,8,2022,01-20,21:57
040 Jeu de Mail des Abb�s,1,7,8,2022,01-20,21:57
041 Eurom�decine,1,7,8,2022,01-20,21:57
042 Marie Caizergues,8,0,8,2022,01-20,21:57
043 Sabines,4,4,8,2022,01-20,21:57
044 Celleneuve,1,7,8,2022,01-20,21:57
045 Jardin de la Lironde,3,5,8,2022,01-20,21:57
046 P�re Soulas,3,5,8,2022,01-20,21:57
047 Place Viala,3,5,8,2022,01-20,21:57
048 H�tel du D�partement,6,2,8,2022,01-20,21:57
049 Tonnelles,2,6,8,2022,01-20,21:57
050 Parvis Jules Ferry - Gare Saint-Roch,7,1,8,2022,01-20,21:57
051 Pont de Lattes - Gare Saint-Roch,0,12,12,2022,01-20,21:57
053 Deux Ponts - Gare Saint-Roch,2,6,8,2022,01-20,21:57
054 Providence - Ovalie,3,5,8,2022,01-20,21:57
055 P�rols Etang de l'Or,25,43,68,2022,01-20,21:57
056 Albert 1er - Cath�drale,4,8,12,2022,01-20,21:57
057 Saint-Guilhem - Courreau,8,0,8,2022,01-20,21:57
059 Sud De France,3,5,8,2022,01-20,21:57
001 Rue Jules Ferry - Gare Saint-Roch,6,6,12,2022,01-20,22:07
002 Com�die,16,8,24,2022,01-20,22:07
003 Esplanade,4,28,32,2022,01-20,22:07
004 H�tel de Ville,8,8,16,2022,01-20,22:07
005 Corum,11,1,12,2022,01-20,22:07
006 Place Albert 1er - St Charles,23,8,31,2022,01-20,22:07
007 Foch,2,6,8,2022,01-20,22:07
008 Halles Castellane,1,11,12,2022,01-20,22:07
009 Observatoire,8,0,8,2022,01-20,22:07
010 Rondelet,1,15,16,2022,01-20,22:07
011 Plan Cabanes,3,9,12,2022,01-20,22:07
012 Boutonnet,2,10,12,2022,01-20,22:07
013 Emile Combes,7,1,8,2022,01-20,22:07
014 Beaux-Arts,2,6,8,2022,01-20,22:07
015 Les Aubes,6,2,8,2022,01-20,22:07
016 Antigone centre,7,9,16,2022,01-20,22:07
017 M�diath�que Emile Zola,14,2,16,2022,01-20,22:07
018 Nombre d'Or,12,4,16,2022,01-20,22:07
019 Louis Blanc,15,1,16,2022,01-20,22:07
020 Gambetta,1,7,8,2022,01-20,22:07
021 Port Marianne,12,4,16,2022,01-20,22:07
022 Clemenceau,8,4,12,2022,01-20,22:07
023 Les Arceaux,3,13,16,2022,01-20,22:07
024 Cit� Mion,4,4,8,2022,01-20,22:07
025 Nouveau Saint-Roch,4,4,8,2022,01-20,22:07
026 Renouvier,3,5,8,2022,01-20,22:07
027 Odysseum,4,4,8,2022,01-20,22:07
028 Saint-Denis,8,0,8,2022,01-20,22:07
029 Richter,7,9,16,2022,01-20,22:07
030 Charles Flahault,0,8,8,2022,01-20,22:07
031 Voltaire,2,6,8,2022,01-20,22:07
032 Pr�s d'Ar�nes,4,4,8,2022,01-20,22:07
033 Garcia Lorca,7,1,8,2022,01-20,22:07
034 Vert Bois,0,16,16,2022,01-20,22:07
035 Malbosc,2,6,8,2022,01-20,22:07
036 Occitanie,2,30,32,2022,01-20,22:07
037 FacdesSciences,0,24,24,2022,01-20,22:07
038 Fac de Lettres,4,12,16,2022,01-20,22:07
039 Aiguelongue,3,5,8,2022,01-20,22:07
040 Jeu de Mail des Abb�s,1,7,8,2022,01-20,22:07
041 Eurom�decine,1,7,8,2022,01-20,22:07
042 Marie Caizergues,8,0,8,2022,01-20,22:07
043 Sabines,4,4,8,2022,01-20,22:07
044 Celleneuve,1,7,8,2022,01-20,22:07
045 Jardin de la Lironde,3,5,8,2022,01-20,22:07
046 P�re Soulas,3,5,8,2022,01-20,22:07
047 Place Viala,3,5,8,2022,01-20,22:07
048 H�tel du D�partement,6,2,8,2022,01-20,22:07
049 Tonnelles,2,6,8,2022,01-20,22:07
050 Parvis Jules Ferry - Gare Saint-Roch,7,1,8,2022,01-20,22:07
051 Pont de Lattes - Gare Saint-Roch,0,12,12,2022,01-20,22:07
053 Deux Ponts - Gare Saint-Roch,2,6,8,2022,01-20,22:07
054 Providence - Ovalie,3,5,8,2022,01-20,22:07
055 P�rols Etang de l'Or,25,43,68,2022,01-20,22:07
056 Albert 1er - Cath�drale,3,9,12,2022,01-20,22:07
057 Saint-Guilhem - Courreau,8,0,8,2022,01-20,22:07
059 Sud De France,3,5,8,2022,01-20,22:07
001 Rue Jules Ferry - Gare Saint-Roch,6,6,12,2022,01-20,22:18
002 Com�die,15,9,24,2022,01-20,22:18
003 Esplanade,4,28,32,2022,01-20,22:18
004 H�tel de Ville,8,8,16,2022,01-20,22:18
005 Corum,11,1,12,2022,01-20,22:18
006 Place Albert 1er - St Charles,23,8,31,2022,01-20,22:18
007 Foch,2,6,8,2022,01-20,22:18
008 Halles Castellane,1,11,12,2022,01-20,22:18
009 Observatoire,8,0,8,2022,01-20,22:18
010 Rondelet,1,15,16,2022,01-20,22:18
011 Plan Cabanes,3,9,12,2022,01-20,22:18
012 Boutonnet,2,10,12,2022,01-20,22:18
013 Emile Combes,7,1,8,2022,01-20,22:18
014 Beaux-Arts,2,6,8,2022,01-20,22:18
015 Les Aubes,6,2,8,2022,01-20,22:18
016 Antigone centre,7,9,16,2022,01-20,22:18
017 M�diath�que Emile Zola,13,3,16,2022,01-20,22:18
018 Nombre d'Or,12,4,16,2022,01-20,22:18
019 Louis Blanc,15,1,16,2022,01-20,22:18
020 Gambetta,1,7,8,2022,01-20,22:18
021 Port Marianne,12,4,16,2022,01-20,22:18
022 Clemenceau,7,5,12,2022,01-20,22:18
023 Les Arceaux,3,13,16,2022,01-20,22:18
024 Cit� Mion,4,4,8,2022,01-20,22:18
025 Nouveau Saint-Roch,4,4,8,2022,01-20,22:18
026 Renouvier,3,5,8,2022,01-20,22:18
027 Odysseum,4,4,8,2022,01-20,22:18
028 Saint-Denis,8,0,8,2022,01-20,22:18
029 Richter,7,9,16,2022,01-20,22:18
030 Charles Flahault,0,8,8,2022,01-20,22:18
031 Voltaire,2,6,8,2022,01-20,22:18
032 Pr�s d'Ar�nes,4,4,8,2022,01-20,22:18
033 Garcia Lorca,7,1,8,2022,01-20,22:18
034 Vert Bois,0,16,16,2022,01-20,22:18
035 Malbosc,2,6,8,2022,01-20,22:18
036 Occitanie,3,29,32,2022,01-20,22:18
037 FacdesSciences,0,24,24,2022,01-20,22:18
038 Fac de Lettres,4,12,16,2022,01-20,22:18
039 Aiguelongue,3,5,8,2022,01-20,22:18
040 Jeu de Mail des Abb�s,1,7,8,2022,01-20,22:18
041 Eurom�decine,1,7,8,2022,01-20,22:18
042 Marie Caizergues,8,0,8,2022,01-20,22:18
043 Sabines,4,4,8,2022,01-20,22:18
044 Celleneuve,1,7,8,2022,01-20,22:18
045 Jardin de la Lironde,3,5,8,2022,01-20,22:18
046 P�re Soulas,3,5,8,2022,01-20,22:18
047 Place Viala,3,5,8,2022,01-20,22:18
048 H�tel du D�partement,6,2,8,2022,01-20,22:18
049 Tonnelles,2,6,8,2022,01-20,22:18
050 Parvis Jules Ferry - Gare Saint-Roch,7,1,8,2022,01-20,22:18
051 Pont de Lattes - Gare Saint-Roch,0,12,12,2022,01-20,22:18
053 Deux Ponts - Gare Saint-Roch,2,6,8,2022,01-20,22:18
054 Providence - Ovalie,3,5,8,2022,01-20,22:18
055 P�rols Etang de l'Or,25,43,68,2022,01-20,22:18
056 Albert 1er - Cath�drale,3,9,12,2022,01-20,22:18
057 Saint-Guilhem - Courreau,8,0,8,2022,01-20,22:18
059 Sud De France,3,5,8,2022,01-20,22:18
001 Rue Jules Ferry - Gare Saint-Roch,6,6,12,2022,01-20,22:28
002 Com�die,12,12,24,2022,01-20,22:28
003 Esplanade,4,28,32,2022,01-20,22:28
004 H�tel de Ville,8,8,16,2022,01-20,22:28
005 Corum,11,1,12,2022,01-20,22:28
006 Place Albert 1er - St Charles,23,8,31,2022,01-20,22:28
007 Foch,2,6,8,2022,01-20,22:28
008 Halles Castellane,1,11,12,2022,01-20,22:28
009 Observatoire,8,0,8,2022,01-20,22:28
010 Rondelet,1,15,16,2022,01-20,22:28
011 Plan Cabanes,3,9,12,2022,01-20,22:28
012 Boutonnet,2,10,12,2022,01-20,22:28
013 Emile Combes,7,1,8,2022,01-20,22:28
014 Beaux-Arts,2,6,8,2022,01-20,22:28
015 Les Aubes,6,2,8,2022,01-20,22:28
016 Antigone centre,7,9,16,2022,01-20,22:28
017 M�diath�que Emile Zola,13,3,16,2022,01-20,22:28
018 Nombre d'Or,12,4,16,2022,01-20,22:28
019 Louis Blanc,15,1,16,2022,01-20,22:28
020 Gambetta,1,7,8,2022,01-20,22:28
021 Port Marianne,12,4,16,2022,01-20,22:28
022 Clemenceau,8,4,12,2022,01-20,22:28
023 Les Arceaux,3,13,16,2022,01-20,22:28
024 Cit� Mion,4,4,8,2022,01-20,22:28
025 Nouveau Saint-Roch,4,4,8,2022,01-20,22:28
026 Renouvier,3,5,8,2022,01-20,22:28
027 Odysseum,4,4,8,2022,01-20,22:28
028 Saint-Denis,8,0,8,2022,01-20,22:28
029 Richter,7,9,16,2022,01-20,22:28
030 Charles Flahault,0,8,8,2022,01-20,22:28
031 Voltaire,2,6,8,2022,01-20,22:28
032 Pr�s d'Ar�nes,4,4,8,2022,01-20,22:28
033 Garcia Lorca,7,1,8,2022,01-20,22:28
034 Vert Bois,0,16,16,2022,01-20,22:28
035 Malbosc,2,6,8,2022,01-20,22:28
036 Occitanie,3,29,32,2022,01-20,22:28
037 FacdesSciences,0,24,24,2022,01-20,22:28
038 Fac de Lettres,4,12,16,2022,01-20,22:28
039 Aiguelongue,3,5,8,2022,01-20,22:28
040 Jeu de Mail des Abb�s,1,7,8,2022,01-20,22:28
041 Eurom�decine,1,7,8,2022,01-20,22:28
042 Marie Caizergues,8,0,8,2022,01-20,22:28
043 Sabines,4,4,8,2022,01-20,22:28
044 Celleneuve,1,7,8,2022,01-20,22:28
045 Jardin de la Lironde,3,5,8,2022,01-20,22:28
046 P�re Soulas,3,5,8,2022,01-20,22:28
047 Place Viala,3,5,8,2022,01-20,22:28
048 H�tel du D�partement,6,2,8,2022,01-20,22:28
049 Tonnelles,2,6,8,2022,01-20,22:28
050 Parvis Jules Ferry - Gare Saint-Roch,7,1,8,2022,01-20,22:28
051 Pont de Lattes - Gare Saint-Roch,0,12,12,2022,01-20,22:28
053 Deux Ponts - Gare Saint-Roch,2,6,8,2022,01-20,22:28
054 Providence - Ovalie,3,5,8,2022,01-20,22:28
055 P�rols Etang de l'Or,25,43,68,2022,01-20,22:28
056 Albert 1er - Cath�drale,3,9,12,2022,01-20,22:28
057 Saint-Guilhem - Courreau,8,0,8,2022,01-20,22:28
059 Sud De France,3,5,8,2022,01-20,22:28
001 Rue Jules Ferry - Gare Saint-Roch,6,6,12,2022,01-20,22:38
002 Com�die,12,12,24,2022,01-20,22:38
003 Esplanade,4,28,32,2022,01-20,22:38
004 H�tel de Ville,8,8,16,2022,01-20,22:38
005 Corum,11,1,12,2022,01-20,22:38
006 Place Albert 1er - St Charles,23,8,31,2022,01-20,22:38
007 Foch,2,6,8,2022,01-20,22:38
008 Halles Castellane,1,11,12,2022,01-20,22:38
009 Observatoire,8,0,8,2022,01-20,22:38
010 Rondelet,1,15,16,2022,01-20,22:38
011 Plan Cabanes,3,9,12,2022,01-20,22:38
012 Boutonnet,2,10,12,2022,01-20,22:38
013 Emile Combes,8,0,8,2022,01-20,22:38
014 Beaux-Arts,2,6,8,2022,01-20,22:38
015 Les Aubes,6,2,8,2022,01-20,22:38
016 Antigone centre,7,9,16,2022,01-20,22:38
017 M�diath�que Emile Zola,13,3,16,2022,01-20,22:38
018 Nombre d'Or,12,4,16,2022,01-20,22:38
019 Louis Blanc,15,1,16,2022,01-20,22:38
020 Gambetta,1,7,8,2022,01-20,22:38
021 Port Marianne,12,4,16,2022,01-20,22:38
022 Clemenceau,8,4,12,2022,01-20,22:38
023 Les Arceaux,3,13,16,2022,01-20,22:38
024 Cit� Mion,4,4,8,2022,01-20,22:38
025 Nouveau Saint-Roch,4,4,8,2022,01-20,22:38
026 Renouvier,3,5,8,2022,01-20,22:38
027 Odysseum,4,4,8,2022,01-20,22:38
028 Saint-Denis,8,0,8,2022,01-20,22:38
029 Richter,7,9,16,2022,01-20,22:38
030 Charles Flahault,0,8,8,2022,01-20,22:38
031 Voltaire,2,6,8,2022,01-20,22:38
032 Pr�s d'Ar�nes,4,4,8,2022,01-20,22:38
033 Garcia Lorca,7,1,8,2022,01-20,22:38
034 Vert Bois,0,16,16,2022,01-20,22:38
035 Malbosc,2,6,8,2022,01-20,22:38
036 Occitanie,3,29,32,2022,01-20,22:38
037 FacdesSciences,0,24,24,2022,01-20,22:38
038 Fac de Lettres,3,13,16,2022,01-20,22:38
039 Aiguelongue,3,5,8,2022,01-20,22:38
040 Jeu de Mail des Abb�s,1,7,8,2022,01-20,22:38
041 Eurom�decine,1,7,8,2022,01-20,22:38
042 Marie Caizergues,8,0,8,2022,01-20,22:38
043 Sabines,4,4,8,2022,01-20,22:38
044 Celleneuve,1,7,8,2022,01-20,22:38
045 Jardin de la Lironde,3,5,8,2022,01-20,22:38
046 P�re Soulas,3,5,8,2022,01-20,22:38
047 Place Viala,3,5,8,2022,01-20,22:38
048 H�tel du D�partement,6,2,8,2022,01-20,22:38
049 Tonnelles,2,6,8,2022,01-20,22:38
050 Parvis Jules Ferry - Gare Saint-Roch,7,1,8,2022,01-20,22:38
051 Pont de Lattes - Gare Saint-Roch,0,12,12,2022,01-20,22:38
053 Deux Ponts - Gare Saint-Roch,2,6,8,2022,01-20,22:38
054 Providence - Ovalie,3,5,8,2022,01-20,22:38
055 P�rols Etang de l'Or,25,43,68,2022,01-20,22:38
056 Albert 1er - Cath�drale,3,9,12,2022,01-20,22:38
057 Saint-Guilhem - Courreau,8,0,8,2022,01-20,22:38
059 Sud De France,3,5,8,2022,01-20,22:38
001 Rue Jules Ferry - Gare Saint-Roch,6,6,12,2022,01-20,22:48
002 Com�die,11,13,24,2022,01-20,22:48
003 Esplanade,4,28,32,2022,01-20,22:48
004 H�tel de Ville,8,8,16,2022,01-20,22:48
005 Corum,12,0,12,2022,01-20,22:48
006 Place Albert 1er - St Charles,23,8,31,2022,01-20,22:48
007 Foch,2,6,8,2022,01-20,22:48
008 Halles Castellane,1,11,12,2022,01-20,22:48
009 Observatoire,8,0,8,2022,01-20,22:48
010 Rondelet,1,15,16,2022,01-20,22:48
011 Plan Cabanes,3,9,12,2022,01-20,22:48
012 Boutonnet,2,10,12,2022,01-20,22:48
013 Emile Combes,8,0,8,2022,01-20,22:48
014 Beaux-Arts,2,6,8,2022,01-20,22:48
015 Les Aubes,6,2,8,2022,01-20,22:48
016 Antigone centre,8,8,16,2022,01-20,22:48
017 M�diath�que Emile Zola,15,1,16,2022,01-20,22:48
018 Nombre d'Or,12,4,16,2022,01-20,22:48
019 Louis Blanc,15,1,16,2022,01-20,22:48
020 Gambetta,1,7,8,2022,01-20,22:48
021 Port Marianne,12,4,16,2022,01-20,22:48
022 Clemenceau,8,4,12,2022,01-20,22:48
023 Les Arceaux,3,13,16,2022,01-20,22:48
024 Cit� Mion,4,4,8,2022,01-20,22:48
025 Nouveau Saint-Roch,4,4,8,2022,01-20,22:48
026 Renouvier,3,5,8,2022,01-20,22:48
027 Odysseum,4,4,8,2022,01-20,22:48
028 Saint-Denis,7,1,8,2022,01-20,22:48
029 Richter,7,9,16,2022,01-20,22:48
030 Charles Flahault,0,8,8,2022,01-20,22:48
031 Voltaire,2,6,8,2022,01-20,22:48
032 Pr�s d'Ar�nes,4,4,8,2022,01-20,22:48
033 Garcia Lorca,7,1,8,2022,01-20,22:48
034 Vert Bois,0,16,16,2022,01-20,22:48
035 Malbosc,2,6,8,2022,01-20,22:48
036 Occitanie,3,29,32,2022,01-20,22:48
037 FacdesSciences,0,24,24,2022,01-20,22:48
038 Fac de Lettres,3,13,16,2022,01-20,22:48
039 Aiguelongue,3,5,8,2022,01-20,22:48
040 Jeu de Mail des Abb�s,1,7,8,2022,01-20,22:48
041 Eurom�decine,1,7,8,2022,01-20,22:48
042 Marie Caizergues,8,0,8,2022,01-20,22:48
043 Sabines,4,4,8,2022,01-20,22:48
044 Celleneuve,1,7,8,2022,01-20,22:48
045 Jardin de la Lironde,3,5,8,2022,01-20,22:48
046 P�re Soulas,3,5,8,2022,01-20,22:48
047 Place Viala,3,5,8,2022,01-20,22:48
048 H�tel du D�partement,6,2,8,2022,01-20,22:48
049 Tonnelles,2,6,8,2022,01-20,22:48
050 Parvis Jules Ferry - Gare Saint-Roch,7,1,8,2022,01-20,22:48
051 Pont de Lattes - Gare Saint-Roch,0,12,12,2022,01-20,22:48
053 Deux Ponts - Gare Saint-Roch,2,6,8,2022,01-20,22:48
054 Providence - Ovalie,3,5,8,2022,01-20,22:48
055 P�rols Etang de l'Or,25,43,68,2022,01-20,22:48
056 Albert 1er - Cath�drale,3,9,12,2022,01-20,22:48
057 Saint-Guilhem - Courreau,8,0,8,2022,01-20,22:48
059 Sud De France,3,5,8,2022,01-20,22:48
001 Rue Jules Ferry - Gare Saint-Roch,6,6,12,2022,01-20,22:58
002 Com�die,10,14,24,2022,01-20,22:58
003 Esplanade,4,28,32,2022,01-20,22:58
004 H�tel de Ville,8,8,16,2022,01-20,22:58
005 Corum,12,0,12,2022,01-20,22:58
006 Place Albert 1er - St Charles,23,8,31,2022,01-20,22:58
007 Foch,2,6,8,2022,01-20,22:58
008 Halles Castellane,1,11,12,2022,01-20,22:58
009 Observatoire,8,0,8,2022,01-20,22:58
010 Rondelet,1,15,16,2022,01-20,22:58
011 Plan Cabanes,4,8,12,2022,01-20,22:58
012 Boutonnet,2,10,12,2022,01-20,22:58
013 Emile Combes,8,0,8,2022,01-20,22:58
014 Beaux-Arts,2,6,8,2022,01-20,22:58
015 Les Aubes,6,2,8,2022,01-20,22:58
016 Antigone centre,8,8,16,2022,01-20,22:58
017 M�diath�que Emile Zola,15,1,16,2022,01-20,22:58
018 Nombre d'Or,12,4,16,2022,01-20,22:58
019 Louis Blanc,15,1,16,2022,01-20,22:58
020 Gambetta,1,7,8,2022,01-20,22:58
021 Port Marianne,12,4,16,2022,01-20,22:58
022 Clemenceau,8,4,12,2022,01-20,22:58
023 Les Arceaux,3,13,16,2022,01-20,22:58
024 Cit� Mion,4,4,8,2022,01-20,22:58
025 Nouveau Saint-Roch,4,4,8,2022,01-20,22:58
026 Renouvier,3,5,8,2022,01-20,22:58
027 Odysseum,4,4,8,2022,01-20,22:58
028 Saint-Denis,7,1,8,2022,01-20,22:58
029 Richter,7,9,16,2022,01-20,22:58
030 Charles Flahault,0,8,8,2022,01-20,22:58
031 Voltaire,2,6,8,2022,01-20,22:58
032 Pr�s d'Ar�nes,4,4,8,2022,01-20,22:58
033 Garcia Lorca,7,1,8,2022,01-20,22:58
034 Vert Bois,0,16,16,2022,01-20,22:58
035 Malbosc,2,6,8,2022,01-20,22:58
036 Occitanie,3,29,32,2022,01-20,22:58
037 FacdesSciences,0,24,24,2022,01-20,22:58
038 Fac de Lettres,3,13,16,2022,01-20,22:58
039 Aiguelongue,3,5,8,2022,01-20,22:58
040 Jeu de Mail des Abb�s,1,7,8,2022,01-20,22:58
041 Eurom�decine,1,7,8,2022,01-20,22:58
042 Marie Caizergues,8,0,8,2022,01-20,22:58
043 Sabines,4,4,8,2022,01-20,22:58
044 Celleneuve,1,7,8,2022,01-20,22:58
045 Jardin de la Lironde,3,5,8,2022,01-20,22:58
046 P�re Soulas,3,5,8,2022,01-20,22:58
047 Place Viala,3,5,8,2022,01-20,22:58
048 H�tel du D�partement,6,2,8,2022,01-20,22:58
049 Tonnelles,2,6,8,2022,01-20,22:58
050 Parvis Jules Ferry - Gare Saint-Roch,7,1,8,2022,01-20,22:58
051 Pont de Lattes - Gare Saint-Roch,0,12,12,2022,01-20,22:58
053 Deux Ponts - Gare Saint-Roch,2,6,8,2022,01-20,22:58
054 Providence - Ovalie,3,5,8,2022,01-20,22:58
055 P�rols Etang de l'Or,25,43,68,2022,01-20,22:58
056 Albert 1er - Cath�drale,3,9,12,2022,01-20,22:58
057 Saint-Guilhem - Courreau,8,0,8,2022,01-20,22:58
059 Sud De France,3,5,8,2022,01-20,22:58
001 Rue Jules Ferry - Gare Saint-Roch,6,6,12,2022,01-20,23:08
002 Com�die,10,14,24,2022,01-20,23:08
003 Esplanade,4,28,32,2022,01-20,23:08
004 H�tel de Ville,8,8,16,2022,01-20,23:08
005 Corum,12,0,12,2022,01-20,23:08
006 Place Albert 1er - St Charles,23,8,31,2022,01-20,23:08
007 Foch,2,6,8,2022,01-20,23:08
008 Halles Castellane,1,11,12,2022,01-20,23:08
009 Observatoire,8,0,8,2022,01-20,23:08
010 Rondelet,1,15,16,2022,01-20,23:08
011 Plan Cabanes,3,9,12,2022,01-20,23:08
012 Boutonnet,2,10,12,2022,01-20,23:08
013 Emile Combes,8,0,8,2022,01-20,23:08
014 Beaux-Arts,3,5,8,2022,01-20,23:08
015 Les Aubes,6,2,8,2022,01-20,23:08
016 Antigone centre,9,7,16,2022,01-20,23:08
017 M�diath�que Emile Zola,15,1,16,2022,01-20,23:08
018 Nombre d'Or,12,4,16,2022,01-20,23:08
019 Louis Blanc,15,1,16,2022,01-20,23:08
020 Gambetta,1,7,8,2022,01-20,23:08
021 Port Marianne,12,4,16,2022,01-20,23:08
022 Clemenceau,8,4,12,2022,01-20,23:08
023 Les Arceaux,3,13,16,2022,01-20,23:08
024 Cit� Mion,4,4,8,2022,01-20,23:08
025 Nouveau Saint-Roch,4,4,8,2022,01-20,23:08
026 Renouvier,3,5,8,2022,01-20,23:08
027 Odysseum,4,4,8,2022,01-20,23:08
028 Saint-Denis,7,1,8,2022,01-20,23:08
029 Richter,7,9,16,2022,01-20,23:08
030 Charles Flahault,0,8,8,2022,01-20,23:08
031 Voltaire,2,6,8,2022,01-20,23:08
032 Pr�s d'Ar�nes,4,4,8,2022,01-20,23:08
033 Garcia Lorca,7,1,8,2022,01-20,23:08
034 Vert Bois,0,16,16,2022,01-20,23:08
035 Malbosc,2,6,8,2022,01-20,23:08
036 Occitanie,2,30,32,2022,01-20,23:08
037 FacdesSciences,0,24,24,2022,01-20,23:08
038 Fac de Lettres,3,13,16,2022,01-20,23:08
039 Aiguelongue,3,5,8,2022,01-20,23:08
040 Jeu de Mail des Abb�s,1,7,8,2022,01-20,23:08
041 Eurom�decine,1,7,8,2022,01-20,23:08
042 Marie Caizergues,8,0,8,2022,01-20,23:08
043 Sabines,4,4,8,2022,01-20,23:08
044 Celleneuve,1,7,8,2022,01-20,23:08
045 Jardin de la Lironde,3,5,8,2022,01-20,23:08
046 P�re Soulas,3,5,8,2022,01-20,23:08
047 Place Viala,3,5,8,2022,01-20,23:08
048 H�tel du D�partement,6,2,8,2022,01-20,23:08
049 Tonnelles,2,6,8,2022,01-20,23:08
050 Parvis Jules Ferry - Gare Saint-Roch,7,1,8,2022,01-20,23:08
051 Pont de Lattes - Gare Saint-Roch,0,12,12,2022,01-20,23:08
053 Deux Ponts - Gare Saint-Roch,2,6,8,2022,01-20,23:08
054 Providence - Ovalie,3,5,8,2022,01-20,23:08
055 P�rols Etang de l'Or,25,43,68,2022,01-20,23:08
056 Albert 1er - Cath�drale,3,9,12,2022,01-20,23:08
057 Saint-Guilhem - Courreau,8,0,8,2022,01-20,23:08
059 Sud De France,3,5,8,2022,01-20,23:08
001 Rue Jules Ferry - Gare Saint-Roch,6,6,12,2022,01-20,23:19
002 Com�die,10,14,24,2022,01-20,23:19
003 Esplanade,4,28,32,2022,01-20,23:19
004 H�tel de Ville,8,8,16,2022,01-20,23:19
005 Corum,12,0,12,2022,01-20,23:19
006 Place Albert 1er - St Charles,23,8,31,2022,01-20,23:19
007 Foch,2,6,8,2022,01-20,23:19
008 Halles Castellane,1,11,12,2022,01-20,23:19
009 Observatoire,8,0,8,2022,01-20,23:19
010 Rondelet,1,15,16,2022,01-20,23:19
011 Plan Cabanes,3,9,12,2022,01-20,23:19
012 Boutonnet,2,10,12,2022,01-20,23:19
013 Emile Combes,8,0,8,2022,01-20,23:19
014 Beaux-Arts,3,5,8,2022,01-20,23:19
015 Les Aubes,6,2,8,2022,01-20,23:19
016 Antigone centre,9,7,16,2022,01-20,23:19
017 M�diath�que Emile Zola,15,1,16,2022,01-20,23:19
018 Nombre d'Or,12,4,16,2022,01-20,23:19
019 Louis Blanc,15,1,16,2022,01-20,23:19
020 Gambetta,1,7,8,2022,01-20,23:19
021 Port Marianne,12,4,16,2022,01-20,23:19
022 Clemenceau,8,4,12,2022,01-20,23:19
023 Les Arceaux,3,13,16,2022,01-20,23:19
024 Cit� Mion,4,4,8,2022,01-20,23:19
025 Nouveau Saint-Roch,4,4,8,2022,01-20,23:19
026 Renouvier,3,5,8,2022,01-20,23:19
027 Odysseum,4,4,8,2022,01-20,23:19
028 Saint-Denis,7,1,8,2022,01-20,23:19
029 Richter,7,9,16,2022,01-20,23:19
030 Charles Flahault,0,8,8,2022,01-20,23:19
031 Voltaire,2,6,8,2022,01-20,23:19
032 Pr�s d'Ar�nes,4,4,8,2022,01-20,23:19
033 Garcia Lorca,7,1,8,2022,01-20,23:19
034 Vert Bois,0,16,16,2022,01-20,23:19
035 Malbosc,2,6,8,2022,01-20,23:19
036 Occitanie,2,30,32,2022,01-20,23:19
037 FacdesSciences,0,24,24,2022,01-20,23:19
038 Fac de Lettres,3,13,16,2022,01-20,23:19
039 Aiguelongue,3,5,8,2022,01-20,23:19
040 Jeu de Mail des Abb�s,1,7,8,2022,01-20,23:19
041 Eurom�decine,1,7,8,2022,01-20,23:19
042 Marie Caizergues,8,0,8,2022,01-20,23:19
043 Sabines,4,4,8,2022,01-20,23:19
044 Celleneuve,1,7,8,2022,01-20,23:19
045 Jardin de la Lironde,3,5,8,2022,01-20,23:19
046 P�re Soulas,3,5,8,2022,01-20,23:19
047 Place Viala,3,5,8,2022,01-20,23:19
048 H�tel du D�partement,6,2,8,2022,01-20,23:19
049 Tonnelles,2,6,8,2022,01-20,23:19
050 Parvis Jules Ferry - Gare Saint-Roch,7,1,8,2022,01-20,23:19
051 Pont de Lattes - Gare Saint-Roch,0,12,12,2022,01-20,23:19
053 Deux Ponts - Gare Saint-Roch,2,6,8,2022,01-20,23:19
054 Providence - Ovalie,3,5,8,2022,01-20,23:19
055 P�rols Etang de l'Or,25,43,68,2022,01-20,23:19
056 Albert 1er - Cath�drale,3,9,12,2022,01-20,23:19
057 Saint-Guilhem - Courreau,7,1,8,2022,01-20,23:19
059 Sud De France,3,5,8,2022,01-20,23:19
001 Rue Jules Ferry - Gare Saint-Roch,6,6,12,2022,01-20,23:29
002 Com�die,10,14,24,2022,01-20,23:29
003 Esplanade,4,28,32,2022,01-20,23:29
004 H�tel de Ville,8,8,16,2022,01-20,23:29
005 Corum,12,0,12,2022,01-20,23:29
006 Place Albert 1er - St Charles,23,8,31,2022,01-20,23:29
007 Foch,2,6,8,2022,01-20,23:29
008 Halles Castellane,1,11,12,2022,01-20,23:29
009 Observatoire,8,0,8,2022,01-20,23:29
010 Rondelet,1,15,16,2022,01-20,23:29
011 Plan Cabanes,3,9,12,2022,01-20,23:29
012 Boutonnet,3,9,12,2022,01-20,23:29
013 Emile Combes,8,0,8,2022,01-20,23:29
014 Beaux-Arts,3,5,8,2022,01-20,23:29
015 Les Aubes,6,2,8,2022,01-20,23:29
016 Antigone centre,10,6,16,2022,01-20,23:29
017 M�diath�que Emile Zola,15,1,16,2022,01-20,23:29
018 Nombre d'Or,12,4,16,2022,01-20,23:29
019 Louis Blanc,15,1,16,2022,01-20,23:29
020 Gambetta,2,6,8,2022,01-20,23:29
021 Port Marianne,12,4,16,2022,01-20,23:29
022 Clemenceau,8,4,12,2022,01-20,23:29
023 Les Arceaux,3,13,16,2022,01-20,23:29
024 Cit� Mion,4,4,8,2022,01-20,23:29
025 Nouveau Saint-Roch,4,4,8,2022,01-20,23:29
026 Renouvier,3,5,8,2022,01-20,23:29
027 Odysseum,4,4,8,2022,01-20,23:29
028 Saint-Denis,7,1,8,2022,01-20,23:29
029 Richter,7,9,16,2022,01-20,23:29
030 Charles Flahault,0,8,8,2022,01-20,23:29
031 Voltaire,2,6,8,2022,01-20,23:29
032 Pr�s d'Ar�nes,4,4,8,2022,01-20,23:29
033 Garcia Lorca,7,1,8,2022,01-20,23:29
034 Vert Bois,0,16,16,2022,01-20,23:29
035 Malbosc,2,6,8,2022,01-20,23:29
036 Occitanie,2,30,32,2022,01-20,23:29
037 FacdesSciences,0,24,24,2022,01-20,23:29
038 Fac de Lettres,3,13,16,2022,01-20,23:29
039 Aiguelongue,2,6,8,2022,01-20,23:29
040 Jeu de Mail des Abb�s,1,7,8,2022,01-20,23:29
041 Eurom�decine,1,7,8,2022,01-20,23:29
042 Marie Caizergues,8,0,8,2022,01-20,23:29
043 Sabines,4,4,8,2022,01-20,23:29
044 Celleneuve,1,7,8,2022,01-20,23:29
045 Jardin de la Lironde,3,5,8,2022,01-20,23:29
046 P�re Soulas,3,5,8,2022,01-20,23:29
047 Place Viala,3,5,8,2022,01-20,23:29
048 H�tel du D�partement,6,2,8,2022,01-20,23:29
049 Tonnelles,2,6,8,2022,01-20,23:29
050 Parvis Jules Ferry - Gare Saint-Roch,7,1,8,2022,01-20,23:29
051 Pont de Lattes - Gare Saint-Roch,0,12,12,2022,01-20,23:29
053 Deux Ponts - Gare Saint-Roch,2,6,8,2022,01-20,23:29
054 Providence - Ovalie,3,5,8,2022,01-20,23:29
055 P�rols Etang de l'Or,25,43,68,2022,01-20,23:29
056 Albert 1er - Cath�drale,3,9,12,2022,01-20,23:29
057 Saint-Guilhem - Courreau,7,1,8,2022,01-20,23:29
059 Sud De France,3,5,8,2022,01-20,23:29
001 Rue Jules Ferry - Gare Saint-Roch,6,6,12,2022,01-20,23:39
002 Com�die,10,14,24,2022,01-20,23:39
003 Esplanade,3,29,32,2022,01-20,23:39
004 H�tel de Ville,8,8,16,2022,01-20,23:39
005 Corum,12,0,12,2022,01-20,23:39
006 Place Albert 1er - St Charles,23,8,31,2022,01-20,23:39
007 Foch,2,6,8,2022,01-20,23:39
008 Halles Castellane,1,11,12,2022,01-20,23:39
009 Observatoire,8,0,8,2022,01-20,23:39
010 Rondelet,1,15,16,2022,01-20,23:39
011 Plan Cabanes,3,9,12,2022,01-20,23:39
012 Boutonnet,3,9,12,2022,01-20,23:39
013 Emile Combes,8,0,8,2022,01-20,23:39
014 Beaux-Arts,3,5,8,2022,01-20,23:39
015 Les Aubes,6,2,8,2022,01-20,23:39
016 Antigone centre,10,6,16,2022,01-20,23:39
017 M�diath�que Emile Zola,15,1,16,2022,01-20,23:39
018 Nombre d'Or,12,4,16,2022,01-20,23:39
019 Louis Blanc,15,1,16,2022,01-20,23:39
020 Gambetta,2,6,8,2022,01-20,23:39
021 Port Marianne,12,4,16,2022,01-20,23:39
022 Clemenceau,8,4,12,2022,01-20,23:39
023 Les Arceaux,3,13,16,2022,01-20,23:39
024 Cit� Mion,4,4,8,2022,01-20,23:39
025 Nouveau Saint-Roch,4,4,8,2022,01-20,23:39
026 Renouvier,3,5,8,2022,01-20,23:39
027 Odysseum,4,4,8,2022,01-20,23:39
028 Saint-Denis,7,1,8,2022,01-20,23:39
029 Richter,7,9,16,2022,01-20,23:39
030 Charles Flahault,0,8,8,2022,01-20,23:39
031 Voltaire,2,6,8,2022,01-20,23:39
032 Pr�s d'Ar�nes,4,4,8,2022,01-20,23:39
033 Garcia Lorca,7,1,8,2022,01-20,23:39
034 Vert Bois,0,16,16,2022,01-20,23:39
035 Malbosc,2,6,8,2022,01-20,23:39
036 Occitanie,2,30,32,2022,01-20,23:39
037 FacdesSciences,0,24,24,2022,01-20,23:39
038 Fac de Lettres,3,13,16,2022,01-20,23:39
039 Aiguelongue,2,6,8,2022,01-20,23:39
040 Jeu de Mail des Abb�s,1,7,8,2022,01-20,23:39
041 Eurom�decine,1,7,8,2022,01-20,23:39
042 Marie Caizergues,8,0,8,2022,01-20,23:39
043 Sabines,4,4,8,2022,01-20,23:39
044 Celleneuve,1,7,8,2022,01-20,23:39
045 Jardin de la Lironde,3,5,8,2022,01-20,23:39
046 P�re Soulas,3,5,8,2022,01-20,23:39
047 Place Viala,3,5,8,2022,01-20,23:39
048 H�tel du D�partement,6,2,8,2022,01-20,23:39
049 Tonnelles,2,6,8,2022,01-20,23:39
050 Parvis Jules Ferry - Gare Saint-Roch,7,1,8,2022,01-20,23:39
051 Pont de Lattes - Gare Saint-Roch,0,12,12,2022,01-20,23:39
053 Deux Ponts - Gare Saint-Roch,2,6,8,2022,01-20,23:39
054 Providence - Ovalie,3,5,8,2022,01-20,23:39
055 P�rols Etang de l'Or,25,43,68,2022,01-20,23:39
056 Albert 1er - Cath�drale,3,9,12,2022,01-20,23:39
057 Saint-Guilhem - Courreau,7,1,8,2022,01-20,23:39
059 Sud De France,3,5,8,2022,01-20,23:39
001 Rue Jules Ferry - Gare Saint-Roch,6,6,12,2022,01-20,23:49
002 Com�die,8,16,24,2022,01-20,23:49
003 Esplanade,2,30,32,2022,01-20,23:49
004 H�tel de Ville,8,8,16,2022,01-20,23:49
005 Corum,12,0,12,2022,01-20,23:49
006 Place Albert 1er - St Charles,23,8,31,2022,01-20,23:49
007 Foch,2,6,8,2022,01-20,23:49
008 Halles Castellane,0,12,12,2022,01-20,23:49
009 Observatoire,8,0,8,2022,01-20,23:49
010 Rondelet,1,15,16,2022,01-20,23:49
011 Plan Cabanes,3,9,12,2022,01-20,23:49
012 Boutonnet,3,9,12,2022,01-20,23:49
013 Emile Combes,8,0,8,2022,01-20,23:49
014 Beaux-Arts,3,5,8,2022,01-20,23:49
015 Les Aubes,7,1,8,2022,01-20,23:49
016 Antigone centre,10,6,16,2022,01-20,23:49
017 M�diath�que Emile Zola,15,1,16,2022,01-20,23:49
018 Nombre d'Or,12,4,16,2022,01-20,23:49
019 Louis Blanc,15,1,16,2022,01-20,23:49
020 Gambetta,2,6,8,2022,01-20,23:49
021 Port Marianne,12,4,16,2022,01-20,23:49
022 Clemenceau,8,4,12,2022,01-20,23:49
023 Les Arceaux,3,13,16,2022,01-20,23:49
024 Cit� Mion,4,4,8,2022,01-20,23:49
025 Nouveau Saint-Roch,4,4,8,2022,01-20,23:49
026 Renouvier,3,5,8,2022,01-20,23:49
027 Odysseum,4,4,8,2022,01-20,23:49
028 Saint-Denis,7,1,8,2022,01-20,23:49
029 Richter,7,9,16,2022,01-20,23:49
030 Charles Flahault,0,8,8,2022,01-20,23:49
031 Voltaire,2,6,8,2022,01-20,23:49
032 Pr�s d'Ar�nes,4,4,8,2022,01-20,23:49
033 Garcia Lorca,7,1,8,2022,01-20,23:49
034 Vert Bois,0,16,16,2022,01-20,23:49
035 Malbosc,2,6,8,2022,01-20,23:49
036 Occitanie,2,30,32,2022,01-20,23:49
037 FacdesSciences,0,24,24,2022,01-20,23:49
038 Fac de Lettres,3,13,16,2022,01-20,23:49
039 Aiguelongue,2,6,8,2022,01-20,23:49
040 Jeu de Mail des Abb�s,2,6,8,2022,01-20,23:49
041 Eurom�decine,1,7,8,2022,01-20,23:49
042 Marie Caizergues,8,0,8,2022,01-20,23:49
043 Sabines,4,4,8,2022,01-20,23:49
044 Celleneuve,1,7,8,2022,01-20,23:49
045 Jardin de la Lironde,3,5,8,2022,01-20,23:49
046 P�re Soulas,3,5,8,2022,01-20,23:49
047 Place Viala,3,5,8,2022,01-20,23:49
048 H�tel du D�partement,6,2,8,2022,01-20,23:49
049 Tonnelles,2,6,8,2022,01-20,23:49
050 Parvis Jules Ferry - Gare Saint-Roch,7,1,8,2022,01-20,23:49
051 Pont de Lattes - Gare Saint-Roch,0,12,12,2022,01-20,23:49
053 Deux Ponts - Gare Saint-Roch,2,6,8,2022,01-20,23:49
054 Providence - Ovalie,3,5,8,2022,01-20,23:49
055 P�rols Etang de l'Or,25,43,68,2022,01-20,23:49
056 Albert 1er - Cath�drale,3,9,12,2022,01-20,23:49
057 Saint-Guilhem - Courreau,7,1,8,2022,01-20,23:49
059 Sud De France,3,5,8,2022,01-20,23:49
001 Rue Jules Ferry - Gare Saint-Roch,6,6,12,2022,01-20,23:59
002 Com�die,8,16,24,2022,01-20,23:59
003 Esplanade,2,30,32,2022,01-20,23:59
004 H�tel de Ville,8,8,16,2022,01-20,23:59
005 Corum,12,0,12,2022,01-20,23:59
006 Place Albert 1er - St Charles,23,8,31,2022,01-20,23:59
007 Foch,2,6,8,2022,01-20,23:59
008 Halles Castellane,0,12,12,2022,01-20,23:59
009 Observatoire,8,0,8,2022,01-20,23:59
010 Rondelet,1,15,16,2022,01-20,23:59
011 Plan Cabanes,3,9,12,2022,01-20,23:59
012 Boutonnet,3,9,12,2022,01-20,23:59
013 Emile Combes,8,0,8,2022,01-20,23:59
014 Beaux-Arts,3,5,8,2022,01-20,23:59
015 Les Aubes,7,1,8,2022,01-20,23:59
016 Antigone centre,10,6,16,2022,01-20,23:59
017 M�diath�que Emile Zola,15,1,16,2022,01-20,23:59
018 Nombre d'Or,12,4,16,2022,01-20,23:59
019 Louis Blanc,15,1,16,2022,01-20,23:59
020 Gambetta,2,6,8,2022,01-20,23:59
021 Port Marianne,12,4,16,2022,01-20,23:59
022 Clemenceau,8,4,12,2022,01-20,23:59
023 Les Arceaux,3,13,16,2022,01-20,23:59
024 Cit� Mion,4,4,8,2022,01-20,23:59
025 Nouveau Saint-Roch,4,4,8,2022,01-20,23:59
026 Renouvier,3,5,8,2022,01-20,23:59
027 Odysseum,4,4,8,2022,01-20,23:59
028 Saint-Denis,7,1,8,2022,01-20,23:59
029 Richter,7,9,16,2022,01-20,23:59
030 Charles Flahault,0,8,8,2022,01-20,23:59
031 Voltaire,2,6,8,2022,01-20,23:59
032 Pr�s d'Ar�nes,4,4,8,2022,01-20,23:59
033 Garcia Lorca,7,1,8,2022,01-20,23:59
034 Vert Bois,0,16,16,2022,01-20,23:59
035 Malbosc,2,6,8,2022,01-20,23:59
036 Occitanie,2,30,32,2022,01-20,23:59
037 FacdesSciences,0,24,24,2022,01-20,23:59
038 Fac de Lettres,3,13,16,2022,01-20,23:59
039 Aiguelongue,2,6,8,2022,01-20,23:59
040 Jeu de Mail des Abb�s,2,6,8,2022,01-20,23:59
041 Eurom�decine,1,7,8,2022,01-20,23:59
042 Marie Caizergues,8,0,8,2022,01-20,23:59
043 Sabines,4,4,8,2022,01-20,23:59
044 Celleneuve,1,7,8,2022,01-20,23:59
045 Jardin de la Lironde,3,5,8,2022,01-20,23:59
046 P�re Soulas,3,5,8,2022,01-20,23:59
047 Place Viala,3,5,8,2022,01-20,23:59
048 H�tel du D�partement,6,2,8,2022,01-20,23:59
049 Tonnelles,2,6,8,2022,01-20,23:59
050 Parvis Jules Ferry - Gare Saint-Roch,7,1,8,2022,01-20,23:59
051 Pont de Lattes - Gare Saint-Roch,0,12,12,2022,01-20,23:59
053 Deux Ponts - Gare Saint-Roch,2,6,8,2022,01-20,23:59
054 Providence - Ovalie,3,5,8,2022,01-20,23:59
055 P�rols Etang de l'Or,25,43,68,2022,01-20,23:59
056 Albert 1er - Cath�drale,3,9,12,2022,01-20,23:59
057 Saint-Guilhem - Courreau,7,1,8,2022,01-20,23:59
059 Sud De France,3,5,8,2022,01-20,23:59
001 Rue Jules Ferry - Gare Saint-Roch,6,6,12,2022,01-21,00:10
002 Com�die,7,17,24,2022,01-21,00:10
003 Esplanade,2,30,32,2022,01-21,00:10
004 H�tel de Ville,8,8,16,2022,01-21,00:10
005 Corum,12,0,12,2022,01-21,00:10
006 Place Albert 1er - St Charles,23,8,31,2022,01-21,00:10
007 Foch,2,6,8,2022,01-21,00:10
008 Halles Castellane,0,12,12,2022,01-21,00:10
009 Observatoire,8,0,8,2022,01-21,00:10
010 Rondelet,1,15,16,2022,01-21,00:10
011 Plan Cabanes,4,8,12,2022,01-21,00:10
012 Boutonnet,3,9,12,2022,01-21,00:10
013 Emile Combes,8,0,8,2022,01-21,00:10
014 Beaux-Arts,3,5,8,2022,01-21,00:10
015 Les Aubes,7,1,8,2022,01-21,00:10
016 Antigone centre,10,6,16,2022,01-21,00:10
017 M�diath�que Emile Zola,15,1,16,2022,01-21,00:10
018 Nombre d'Or,12,4,16,2022,01-21,00:10
019 Louis Blanc,15,1,16,2022,01-21,00:10
020 Gambetta,2,6,8,2022,01-21,00:10
021 Port Marianne,12,4,16,2022,01-21,00:10
022 Clemenceau,8,4,12,2022,01-21,00:10
023 Les Arceaux,3,13,16,2022,01-21,00:10
024 Cit� Mion,4,4,8,2022,01-21,00:10
025 Nouveau Saint-Roch,4,4,8,2022,01-21,00:10
026 Renouvier,3,5,8,2022,01-21,00:10
027 Odysseum,4,4,8,2022,01-21,00:10
028 Saint-Denis,7,1,8,2022,01-21,00:10
029 Richter,7,9,16,2022,01-21,00:10
030 Charles Flahault,0,8,8,2022,01-21,00:10
031 Voltaire,2,6,8,2022,01-21,00:10
032 Pr�s d'Ar�nes,4,4,8,2022,01-21,00:10
033 Garcia Lorca,7,1,8,2022,01-21,00:10
034 Vert Bois,0,16,16,2022,01-21,00:10
035 Malbosc,2,6,8,2022,01-21,00:10
036 Occitanie,2,30,32,2022,01-21,00:10
037 FacdesSciences,0,24,24,2022,01-21,00:10
038 Fac de Lettres,3,13,16,2022,01-21,00:10
039 Aiguelongue,2,6,8,2022,01-21,00:10
040 Jeu de Mail des Abb�s,2,6,8,2022,01-21,00:10
041 Eurom�decine,1,7,8,2022,01-21,00:10
042 Marie Caizergues,8,0,8,2022,01-21,00:10
043 Sabines,4,4,8,2022,01-21,00:10
044 Celleneuve,1,7,8,2022,01-21,00:10
045 Jardin de la Lironde,3,5,8,2022,01-21,00:10
046 P�re Soulas,3,5,8,2022,01-21,00:10
047 Place Viala,3,5,8,2022,01-21,00:10
048 H�tel du D�partement,6,2,8,2022,01-21,00:10
049 Tonnelles,2,6,8,2022,01-21,00:10
050 Parvis Jules Ferry - Gare Saint-Roch,7,1,8,2022,01-21,00:10
051 Pont de Lattes - Gare Saint-Roch,0,12,12,2022,01-21,00:10
053 Deux Ponts - Gare Saint-Roch,2,6,8,2022,01-21,00:10
054 Providence - Ovalie,3,5,8,2022,01-21,00:10
055 P�rols Etang de l'Or,25,43,68,2022,01-21,00:10
056 Albert 1er - Cath�drale,3,9,12,2022,01-21,00:10
057 Saint-Guilhem - Courreau,7,1,8,2022,01-21,00:10
059 Sud De France,3,5,8,2022,01-21,00:10
001 Rue Jules Ferry - Gare Saint-Roch,6,6,12,2022,01-21,00:20
002 Com�die,7,17,24,2022,01-21,00:20
003 Esplanade,2,30,32,2022,01-21,00:20
004 H�tel de Ville,8,8,16,2022,01-21,00:20
005 Corum,12,0,12,2022,01-21,00:20
006 Place Albert 1er - St Charles,23,8,31,2022,01-21,00:20
007 Foch,2,6,8,2022,01-21,00:20
008 Halles Castellane,0,12,12,2022,01-21,00:20
009 Observatoire,8,0,8,2022,01-21,00:20
010 Rondelet,1,15,16,2022,01-21,00:20
011 Plan Cabanes,6,6,12,2022,01-21,00:20
012 Boutonnet,3,9,12,2022,01-21,00:20
013 Emile Combes,8,0,8,2022,01-21,00:20
014 Beaux-Arts,3,5,8,2022,01-21,00:20
015 Les Aubes,7,1,8,2022,01-21,00:20
016 Antigone centre,10,6,16,2022,01-21,00:20
017 M�diath�que Emile Zola,15,1,16,2022,01-21,00:20
018 Nombre d'Or,12,4,16,2022,01-21,00:20
019 Louis Blanc,15,1,16,2022,01-21,00:20
020 Gambetta,2,6,8,2022,01-21,00:20
021 Port Marianne,12,4,16,2022,01-21,00:20
022 Clemenceau,8,4,12,2022,01-21,00:20
023 Les Arceaux,3,13,16,2022,01-21,00:20
024 Cit� Mion,4,4,8,2022,01-21,00:20
025 Nouveau Saint-Roch,4,4,8,2022,01-21,00:20
026 Renouvier,3,5,8,2022,01-21,00:20
027 Odysseum,4,4,8,2022,01-21,00:20
028 Saint-Denis,7,1,8,2022,01-21,00:20
029 Richter,7,9,16,2022,01-21,00:20
030 Charles Flahault,0,8,8,2022,01-21,00:20
031 Voltaire,2,6,8,2022,01-21,00:20
032 Pr�s d'Ar�nes,4,4,8,2022,01-21,00:20
033 Garcia Lorca,7,1,8,2022,01-21,00:20
034 Vert Bois,0,16,16,2022,01-21,00:20
035 Malbosc,2,6,8,2022,01-21,00:20
036 Occitanie,2,30,32,2022,01-21,00:20
037 FacdesSciences,0,24,24,2022,01-21,00:20
038 Fac de Lettres,3,13,16,2022,01-21,00:20
039 Aiguelongue,2,6,8,2022,01-21,00:20
040 Jeu de Mail des Abb�s,2,6,8,2022,01-21,00:20
041 Eurom�decine,1,7,8,2022,01-21,00:20
042 Marie Caizergues,8,0,8,2022,01-21,00:20
043 Sabines,4,4,8,2022,01-21,00:20
044 Celleneuve,1,7,8,2022,01-21,00:20
045 Jardin de la Lironde,3,5,8,2022,01-21,00:20
046 P�re Soulas,3,5,8,2022,01-21,00:20
047 Place Viala,3,5,8,2022,01-21,00:20
048 H�tel du D�partement,6,2,8,2022,01-21,00:20
049 Tonnelles,2,6,8,2022,01-21,00:20
050 Parvis Jules Ferry - Gare Saint-Roch,7,1,8,2022,01-21,00:20
051 Pont de Lattes - Gare Saint-Roch,0,12,12,2022,01-21,00:20
053 Deux Ponts - Gare Saint-Roch,2,6,8,2022,01-21,00:20
054 Providence - Ovalie,3,5,8,2022,01-21,00:20
055 P�rols Etang de l'Or,25,43,68,2022,01-21,00:20
056 Albert 1er - Cath�drale,3,9,12,2022,01-21,00:20
057 Saint-Guilhem - Courreau,7,1,8,2022,01-21,00:20
059 Sud De France,3,5,8,2022,01-21,00:20
001 Rue Jules Ferry - Gare Saint-Roch,6,6,12,2022,01-21,00:30
002 Com�die,6,18,24,2022,01-21,00:30
003 Esplanade,2,30,32,2022,01-21,00:30
004 H�tel de Ville,8,8,16,2022,01-21,00:30
005 Corum,12,0,12,2022,01-21,00:30
006 Place Albert 1er - St Charles,23,8,31,2022,01-21,00:30
007 Foch,2,6,8,2022,01-21,00:30
008 Halles Castellane,0,12,12,2022,01-21,00:30
009 Observatoire,7,1,8,2022,01-21,00:30
010 Rondelet,1,15,16,2022,01-21,00:30
011 Plan Cabanes,5,7,12,2022,01-21,00:30
012 Boutonnet,2,10,12,2022,01-21,00:30
013 Emile Combes,8,0,8,2022,01-21,00:30
014 Beaux-Arts,3,5,8,2022,01-21,00:30
015 Les Aubes,7,1,8,2022,01-21,00:30
016 Antigone centre,10,6,16,2022,01-21,00:30
017 M�diath�que Emile Zola,15,1,16,2022,01-21,00:30
018 Nombre d'Or,12,4,16,2022,01-21,00:30
019 Louis Blanc,15,1,16,2022,01-21,00:30
020 Gambetta,3,5,8,2022,01-21,00:30
021 Port Marianne,12,4,16,2022,01-21,00:30
022 Clemenceau,8,4,12,2022,01-21,00:30
023 Les Arceaux,3,13,16,2022,01-21,00:30
024 Cit� Mion,4,4,8,2022,01-21,00:30
025 Nouveau Saint-Roch,4,4,8,2022,01-21,00:30
026 Renouvier,3,5,8,2022,01-21,00:30
027 Odysseum,4,4,8,2022,01-21,00:30
028 Saint-Denis,7,1,8,2022,01-21,00:30
029 Richter,7,9,16,2022,01-21,00:30
030 Charles Flahault,0,8,8,2022,01-21,00:30
031 Voltaire,2,6,8,2022,01-21,00:30
032 Pr�s d'Ar�nes,4,4,8,2022,01-21,00:30
033 Garcia Lorca,7,1,8,2022,01-21,00:30
034 Vert Bois,0,16,16,2022,01-21,00:30
035 Malbosc,2,6,8,2022,01-21,00:30
036 Occitanie,2,30,32,2022,01-21,00:30
037 FacdesSciences,0,24,24,2022,01-21,00:30
038 Fac de Lettres,3,13,16,2022,01-21,00:30
039 Aiguelongue,2,6,8,2022,01-21,00:30
040 Jeu de Mail des Abb�s,2,6,8,2022,01-21,00:30
041 Eurom�decine,1,7,8,2022,01-21,00:30
042 Marie Caizergues,8,0,8,2022,01-21,00:30
043 Sabines,4,4,8,2022,01-21,00:30
044 Celleneuve,1,7,8,2022,01-21,00:30
045 Jardin de la Lironde,3,5,8,2022,01-21,00:30
046 P�re Soulas,3,5,8,2022,01-21,00:30
047 Place Viala,3,5,8,2022,01-21,00:30
048 H�tel du D�partement,6,2,8,2022,01-21,00:30
049 Tonnelles,2,6,8,2022,01-21,00:30
050 Parvis Jules Ferry - Gare Saint-Roch,7,1,8,2022,01-21,00:30
051 Pont de Lattes - Gare Saint-Roch,0,12,12,2022,01-21,00:30
053 Deux Ponts - Gare Saint-Roch,2,6,8,2022,01-21,00:30
054 Providence - Ovalie,3,5,8,2022,01-21,00:30
055 P�rols Etang de l'Or,25,43,68,2022,01-21,00:30
056 Albert 1er - Cath�drale,3,9,12,2022,01-21,00:30
057 Saint-Guilhem - Courreau,7,1,8,2022,01-21,00:30
059 Sud De France,3,5,8,2022,01-21,00:30
001 Rue Jules Ferry - Gare Saint-Roch,5,7,12,2022,01-21,00:40
002 Com�die,6,18,24,2022,01-21,00:40
003 Esplanade,2,30,32,2022,01-21,00:40
004 H�tel de Ville,8,8,16,2022,01-21,00:40
005 Corum,12,0,12,2022,01-21,00:40
006 Place Albert 1er - St Charles,23,8,31,2022,01-21,00:40
007 Foch,2,6,8,2022,01-21,00:40
008 Halles Castellane,0,12,12,2022,01-21,00:40
009 Observatoire,7,1,8,2022,01-21,00:40
010 Rondelet,1,15,16,2022,01-21,00:40
011 Plan Cabanes,5,7,12,2022,01-21,00:40
012 Boutonnet,2,10,12,2022,01-21,00:40
013 Emile Combes,8,0,8,2022,01-21,00:40
014 Beaux-Arts,3,5,8,2022,01-21,00:40
015 Les Aubes,7,1,8,2022,01-21,00:40
016 Antigone centre,10,6,16,2022,01-21,00:40
017 M�diath�que Emile Zola,15,1,16,2022,01-21,00:40
018 Nombre d'Or,12,4,16,2022,01-21,00:40
019 Louis Blanc,15,1,16,2022,01-21,00:40
020 Gambetta,3,5,8,2022,01-21,00:40
021 Port Marianne,12,4,16,2022,01-21,00:40
022 Clemenceau,8,4,12,2022,01-21,00:40
023 Les Arceaux,3,13,16,2022,01-21,00:40
024 Cit� Mion,4,4,8,2022,01-21,00:40
025 Nouveau Saint-Roch,5,3,8,2022,01-21,00:40
026 Renouvier,3,5,8,2022,01-21,00:40
027 Odysseum,4,4,8,2022,01-21,00:40
028 Saint-Denis,6,2,8,2022,01-21,00:40
029 Richter,6,10,16,2022,01-21,00:40
030 Charles Flahault,0,8,8,2022,01-21,00:40
031 Voltaire,2,6,8,2022,01-21,00:40
032 Pr�s d'Ar�nes,3,5,8,2022,01-21,00:40
033 Garcia Lorca,7,1,8,2022,01-21,00:40
034 Vert Bois,0,16,16,2022,01-21,00:40
035 Malbosc,2,6,8,2022,01-21,00:40
036 Occitanie,2,30,32,2022,01-21,00:40
037 FacdesSciences,0,24,24,2022,01-21,00:40
038 Fac de Lettres,3,13,16,2022,01-21,00:40
039 Aiguelongue,2,6,8,2022,01-21,00:40
040 Jeu de Mail des Abb�s,2,6,8,2022,01-21,00:40
041 Eurom�decine,1,7,8,2022,01-21,00:40
042 Marie Caizergues,8,0,8,2022,01-21,00:40
043 Sabines,4,4,8,2022,01-21,00:40
044 Celleneuve,1,7,8,2022,01-21,00:40
045 Jardin de la Lironde,3,5,8,2022,01-21,00:40
046 P�re Soulas,4,4,8,2022,01-21,00:40
047 Place Viala,4,4,8,2022,01-21,00:40
048 H�tel du D�partement,6,2,8,2022,01-21,00:40
049 Tonnelles,2,6,8,2022,01-21,00:40
050 Parvis Jules Ferry - Gare Saint-Roch,7,1,8,2022,01-21,00:40
051 Pont de Lattes - Gare Saint-Roch,0,12,12,2022,01-21,00:40
053 Deux Ponts - Gare Saint-Roch,2,6,8,2022,01-21,00:40
054 Providence - Ovalie,3,5,8,2022,01-21,00:40
055 P�rols Etang de l'Or,25,43,68,2022,01-21,00:40
056 Albert 1er - Cath�drale,3,9,12,2022,01-21,00:40
057 Saint-Guilhem - Courreau,7,1,8,2022,01-21,00:40
059 Sud De France,3,5,8,2022,01-21,00:40
001 Rue Jules Ferry - Gare Saint-Roch,5,7,12,2022,01-21,00:50
002 Com�die,6,18,24,2022,01-21,00:50
003 Esplanade,3,29,32,2022,01-21,00:50
004 H�tel de Ville,8,8,16,2022,01-21,00:50
005 Corum,12,0,12,2022,01-21,00:50
006 Place Albert 1er - St Charles,23,8,31,2022,01-21,00:50
007 Foch,2,6,8,2022,01-21,00:50
008 Halles Castellane,0,12,12,2022,01-21,00:50
009 Observatoire,7,1,8,2022,01-21,00:50
010 Rondelet,1,15,16,2022,01-21,00:50
011 Plan Cabanes,5,7,12,2022,01-21,00:50
012 Boutonnet,2,10,12,2022,01-21,00:50
013 Emile Combes,8,0,8,2022,01-21,00:50
014 Beaux-Arts,3,5,8,2022,01-21,00:50
015 Les Aubes,7,1,8,2022,01-21,00:50
016 Antigone centre,10,6,16,2022,01-21,00:50
017 M�diath�que Emile Zola,15,1,16,2022,01-21,00:50
018 Nombre d'Or,12,4,16,2022,01-21,00:50
019 Louis Blanc,14,2,16,2022,01-21,00:50
020 Gambetta,3,5,8,2022,01-21,00:50
021 Port Marianne,12,4,16,2022,01-21,00:50
022 Clemenceau,8,4,12,2022,01-21,00:50
023 Les Arceaux,3,13,16,2022,01-21,00:50
024 Cit� Mion,4,4,8,2022,01-21,00:50
025 Nouveau Saint-Roch,5,3,8,2022,01-21,00:50
026 Renouvier,3,5,8,2022,01-21,00:50
027 Odysseum,4,4,8,2022,01-21,00:50
028 Saint-Denis,6,2,8,2022,01-21,00:50
029 Richter,6,10,16,2022,01-21,00:50
030 Charles Flahault,0,8,8,2022,01-21,00:50
031 Voltaire,2,6,8,2022,01-21,00:50
032 Pr�s d'Ar�nes,3,5,8,2022,01-21,00:50
033 Garcia Lorca,7,1,8,2022,01-21,00:50
034 Vert Bois,0,16,16,2022,01-21,00:50
035 Malbosc,2,6,8,2022,01-21,00:50
036 Occitanie,2,30,32,2022,01-21,00:50
037 FacdesSciences,0,24,24,2022,01-21,00:50
038 Fac de Lettres,3,13,16,2022,01-21,00:50
039 Aiguelongue,2,6,8,2022,01-21,00:50
040 Jeu de Mail des Abb�s,2,6,8,2022,01-21,00:50
041 Eurom�decine,1,7,8,2022,01-21,00:50
042 Marie Caizergues,8,0,8,2022,01-21,00:50
043 Sabines,4,4,8,2022,01-21,00:50
044 Celleneuve,1,7,8,2022,01-21,00:50
045 Jardin de la Lironde,3,5,8,2022,01-21,00:50
046 P�re Soulas,4,4,8,2022,01-21,00:50
047 Place Viala,4,4,8,2022,01-21,00:50
048 H�tel du D�partement,6,2,8,2022,01-21,00:50
049 Tonnelles,2,6,8,2022,01-21,00:50
050 Parvis Jules Ferry - Gare Saint-Roch,7,1,8,2022,01-21,00:50
051 Pont de Lattes - Gare Saint-Roch,0,12,12,2022,01-21,00:50
053 Deux Ponts - Gare Saint-Roch,2,6,8,2022,01-21,00:50
054 Providence - Ovalie,3,5,8,2022,01-21,00:50
055 P�rols Etang de l'Or,25,43,68,2022,01-21,00:50
056 Albert 1er - Cath�drale,3,9,12,2022,01-21,00:50
057 Saint-Guilhem - Courreau,7,1,8,2022,01-21,00:50
059 Sud De France,3,5,8,2022,01-21,00:50
001 Rue Jules Ferry - Gare Saint-Roch,5,7,12,2022,01-21,01:00
002 Com�die,6,18,24,2022,01-21,01:00
003 Esplanade,3,29,32,2022,01-21,01:00
004 H�tel de Ville,8,8,16,2022,01-21,01:00
005 Corum,12,0,12,2022,01-21,01:00
006 Place Albert 1er - St Charles,23,8,31,2022,01-21,01:00
007 Foch,2,6,8,2022,01-21,01:00
008 Halles Castellane,0,12,12,2022,01-21,01:00
009 Observatoire,7,1,8,2022,01-21,01:00
010 Rondelet,1,15,16,2022,01-21,01:00
011 Plan Cabanes,5,7,12,2022,01-21,01:00
012 Boutonnet,2,10,12,2022,01-21,01:00
013 Emile Combes,8,0,8,2022,01-21,01:00
014 Beaux-Arts,3,5,8,2022,01-21,01:00
015 Les Aubes,7,1,8,2022,01-21,01:00
016 Antigone centre,11,5,16,2022,01-21,01:00
017 M�diath�que Emile Zola,15,1,16,2022,01-21,01:00
018 Nombre d'Or,12,4,16,2022,01-21,01:00
019 Louis Blanc,14,2,16,2022,01-21,01:00
020 Gambetta,3,5,8,2022,01-21,01:00
021 Port Marianne,12,4,16,2022,01-21,01:00
022 Clemenceau,8,4,12,2022,01-21,01:00
023 Les Arceaux,3,13,16,2022,01-21,01:00
024 Cit� Mion,4,4,8,2022,01-21,01:00
025 Nouveau Saint-Roch,5,3,8,2022,01-21,01:00
026 Renouvier,3,5,8,2022,01-21,01:00
027 Odysseum,4,4,8,2022,01-21,01:00
028 Saint-Denis,6,2,8,2022,01-21,01:00
029 Richter,6,10,16,2022,01-21,01:00
030 Charles Flahault,0,8,8,2022,01-21,01:00
031 Voltaire,2,6,8,2022,01-21,01:00
032 Pr�s d'Ar�nes,4,4,8,2022,01-21,01:00
033 Garcia Lorca,7,1,8,2022,01-21,01:00
034 Vert Bois,0,16,16,2022,01-21,01:00
035 Malbosc,2,6,8,2022,01-21,01:00
036 Occitanie,2,30,32,2022,01-21,01:00
037 FacdesSciences,0,24,24,2022,01-21,01:00
038 Fac de Lettres,3,13,16,2022,01-21,01:00
039 Aiguelongue,2,6,8,2022,01-21,01:00
040 Jeu de Mail des Abb�s,2,6,8,2022,01-21,01:00
041 Eurom�decine,1,7,8,2022,01-21,01:00
042 Marie Caizergues,8,0,8,2022,01-21,01:00
043 Sabines,4,4,8,2022,01-21,01:00
044 Celleneuve,1,7,8,2022,01-21,01:00
045 Jardin de la Lironde,3,5,8,2022,01-21,01:00
046 P�re Soulas,4,4,8,2022,01-21,01:00
047 Place Viala,4,4,8,2022,01-21,01:00
048 H�tel du D�partement,6,2,8,2022,01-21,01:00
049 Tonnelles,2,6,8,2022,01-21,01:00
050 Parvis Jules Ferry - Gare Saint-Roch,7,1,8,2022,01-21,01:00
051 Pont de Lattes - Gare Saint-Roch,0,12,12,2022,01-21,01:00
053 Deux Ponts - Gare Saint-Roch,2,6,8,2022,01-21,01:00
054 Providence - Ovalie,3,5,8,2022,01-21,01:00
055 P�rols Etang de l'Or,25,43,68,2022,01-21,01:00
056 Albert 1er - Cath�drale,3,9,12,2022,01-21,01:00
057 Saint-Guilhem - Courreau,7,1,8,2022,01-21,01:00
059 Sud De France,3,5,8,2022,01-21,01:00
001 Rue Jules Ferry - Gare Saint-Roch,5,7,12,2022,01-21,01:10
002 Com�die,5,19,24,2022,01-21,01:10
003 Esplanade,3,29,32,2022,01-21,01:10
004 H�tel de Ville,8,8,16,2022,01-21,01:10
005 Corum,12,0,12,2022,01-21,01:10
006 Place Albert 1er - St Charles,23,8,31,2022,01-21,01:10
007 Foch,2,6,8,2022,01-21,01:10
008 Halles Castellane,0,12,12,2022,01-21,01:10
009 Observatoire,7,1,8,2022,01-21,01:10
010 Rondelet,1,15,16,2022,01-21,01:10
011 Plan Cabanes,5,7,12,2022,01-21,01:10
012 Boutonnet,2,10,12,2022,01-21,01:10
013 Emile Combes,8,0,8,2022,01-21,01:10
014 Beaux-Arts,3,5,8,2022,01-21,01:10
015 Les Aubes,7,1,8,2022,01-21,01:10
016 Antigone centre,11,5,16,2022,01-21,01:10
017 M�diath�que Emile Zola,15,1,16,2022,01-21,01:10
018 Nombre d'Or,12,4,16,2022,01-21,01:10
019 Louis Blanc,14,2,16,2022,01-21,01:10
020 Gambetta,3,5,8,2022,01-21,01:10
021 Port Marianne,12,4,16,2022,01-21,01:10
022 Clemenceau,8,4,12,2022,01-21,01:10
023 Les Arceaux,3,13,16,2022,01-21,01:10
024 Cit� Mion,4,4,8,2022,01-21,01:10
025 Nouveau Saint-Roch,5,3,8,2022,01-21,01:10
026 Renouvier,3,5,8,2022,01-21,01:10
027 Odysseum,4,4,8,2022,01-21,01:10
028 Saint-Denis,6,2,8,2022,01-21,01:10
029 Richter,6,10,16,2022,01-21,01:10
030 Charles Flahault,0,8,8,2022,01-21,01:10
031 Voltaire,2,6,8,2022,01-21,01:10
032 Pr�s d'Ar�nes,4,4,8,2022,01-21,01:10
033 Garcia Lorca,7,1,8,2022,01-21,01:10
034 Vert Bois,0,16,16,2022,01-21,01:10
035 Malbosc,2,6,8,2022,01-21,01:10
036 Occitanie,3,29,32,2022,01-21,01:10
037 FacdesSciences,0,24,24,2022,01-21,01:10
038 Fac de Lettres,3,13,16,2022,01-21,01:10
039 Aiguelongue,2,6,8,2022,01-21,01:10
040 Jeu de Mail des Abb�s,2,6,8,2022,01-21,01:10
041 Eurom�decine,1,7,8,2022,01-21,01:10
042 Marie Caizergues,8,0,8,2022,01-21,01:10
043 Sabines,4,4,8,2022,01-21,01:10
044 Celleneuve,0,8,8,2022,01-21,01:10
045 Jardin de la Lironde,3,5,8,2022,01-21,01:10
046 P�re Soulas,4,4,8,2022,01-21,01:10
047 Place Viala,4,4,8,2022,01-21,01:10
048 H�tel du D�partement,6,2,8,2022,01-21,01:10
049 Tonnelles,2,6,8,2022,01-21,01:10
050 Parvis Jules Ferry - Gare Saint-Roch,7,1,8,2022,01-21,01:10
051 Pont de Lattes - Gare Saint-Roch,0,12,12,2022,01-21,01:10
053 Deux Ponts - Gare Saint-Roch,2,6,8,2022,01-21,01:10
054 Providence - Ovalie,3,5,8,2022,01-21,01:10
055 P�rols Etang de l'Or,25,43,68,2022,01-21,01:10
056 Albert 1er - Cath�drale,3,9,12,2022,01-21,01:10
057 Saint-Guilhem - Courreau,7,1,8,2022,01-21,01:10
059 Sud De France,3,5,8,2022,01-21,01:10
001 Rue Jules Ferry - Gare Saint-Roch,5,7,12,2022,01-21,01:21
002 Com�die,5,19,24,2022,01-21,01:21
003 Esplanade,1,31,32,2022,01-21,01:21
004 H�tel de Ville,8,8,16,2022,01-21,01:21
005 Corum,12,0,12,2022,01-21,01:21
006 Place Albert 1er - St Charles,23,8,31,2022,01-21,01:21
007 Foch,2,6,8,2022,01-21,01:21
008 Halles Castellane,0,12,12,2022,01-21,01:21
009 Observatoire,7,1,8,2022,01-21,01:21
010 Rondelet,1,15,16,2022,01-21,01:21
011 Plan Cabanes,6,6,12,2022,01-21,01:21
012 Boutonnet,2,10,12,2022,01-21,01:21
013 Emile Combes,8,0,8,2022,01-21,01:21
014 Beaux-Arts,3,5,8,2022,01-21,01:21
015 Les Aubes,7,1,8,2022,01-21,01:21
016 Antigone centre,11,5,16,2022,01-21,01:21
017 M�diath�que Emile Zola,15,1,16,2022,01-21,01:21
018 Nombre d'Or,12,4,16,2022,01-21,01:21
019 Louis Blanc,14,2,16,2022,01-21,01:21
020 Gambetta,3,5,8,2022,01-21,01:21
021 Port Marianne,12,4,16,2022,01-21,01:21
022 Clemenceau,8,4,12,2022,01-21,01:21
023 Les Arceaux,3,13,16,2022,01-21,01:21
024 Cit� Mion,4,4,8,2022,01-21,01:21
025 Nouveau Saint-Roch,5,3,8,2022,01-21,01:21
026 Renouvier,3,5,8,2022,01-21,01:21
027 Odysseum,4,4,8,2022,01-21,01:21
028 Saint-Denis,5,3,8,2022,01-21,01:21
029 Richter,6,10,16,2022,01-21,01:21
030 Charles Flahault,0,8,8,2022,01-21,01:21
031 Voltaire,2,6,8,2022,01-21,01:21
032 Pr�s d'Ar�nes,4,4,8,2022,01-21,01:21
033 Garcia Lorca,7,1,8,2022,01-21,01:21
034 Vert Bois,0,16,16,2022,01-21,01:21
035 Malbosc,2,6,8,2022,01-21,01:21
036 Occitanie,3,29,32,2022,01-21,01:21
037 FacdesSciences,0,24,24,2022,01-21,01:21
038 Fac de Lettres,3,13,16,2022,01-21,01:21
039 Aiguelongue,2,6,8,2022,01-21,01:21
040 Jeu de Mail des Abb�s,2,6,8,2022,01-21,01:21
041 Eurom�decine,1,7,8,2022,01-21,01:21
042 Marie Caizergues,8,0,8,2022,01-21,01:21
043 Sabines,4,4,8,2022,01-21,01:21
044 Celleneuve,0,8,8,2022,01-21,01:21
045 Jardin de la Lironde,3,5,8,2022,01-21,01:21
046 P�re Soulas,4,4,8,2022,01-21,01:21
047 Place Viala,4,4,8,2022,01-21,01:21
048 H�tel du D�partement,6,2,8,2022,01-21,01:21
049 Tonnelles,2,6,8,2022,01-21,01:21
050 Parvis Jules Ferry - Gare Saint-Roch,6,2,8,2022,01-21,01:21
051 Pont de Lattes - Gare Saint-Roch,0,12,12,2022,01-21,01:21
053 Deux Ponts - Gare Saint-Roch,2,6,8,2022,01-21,01:21
054 Providence - Ovalie,3,5,8,2022,01-21,01:21
055 P�rols Etang de l'Or,26,42,68,2022,01-21,01:21
056 Albert 1er - Cath�drale,3,9,12,2022,01-21,01:21
057 Saint-Guilhem - Courreau,7,1,8,2022,01-21,01:21
059 Sud De France,3,5,8,2022,01-21,01:21
001 Rue Jules Ferry - Gare Saint-Roch,5,7,12,2022,01-21,01:31
002 Com�die,5,19,24,2022,01-21,01:31
003 Esplanade,2,30,32,2022,01-21,01:31
004 H�tel de Ville,8,8,16,2022,01-21,01:31
005 Corum,12,0,12,2022,01-21,01:31
006 Place Albert 1er - St Charles,23,8,31,2022,01-21,01:31
007 Foch,2,6,8,2022,01-21,01:31
008 Halles Castellane,0,12,12,2022,01-21,01:31
009 Observatoire,6,2,8,2022,01-21,01:31
010 Rondelet,1,15,16,2022,01-21,01:31
011 Plan Cabanes,6,6,12,2022,01-21,01:31
012 Boutonnet,2,10,12,2022,01-21,01:31
013 Emile Combes,8,0,8,2022,01-21,01:31
014 Beaux-Arts,3,5,8,2022,01-21,01:31
015 Les Aubes,7,1,8,2022,01-21,01:31
016 Antigone centre,12,4,16,2022,01-21,01:31
017 M�diath�que Emile Zola,15,1,16,2022,01-21,01:31
018 Nombre d'Or,12,4,16,2022,01-21,01:31
019 Louis Blanc,14,2,16,2022,01-21,01:31
020 Gambetta,3,5,8,2022,01-21,01:31
021 Port Marianne,12,4,16,2022,01-21,01:31
022 Clemenceau,8,4,12,2022,01-21,01:31
023 Les Arceaux,3,13,16,2022,01-21,01:31
024 Cit� Mion,4,4,8,2022,01-21,01:31
025 Nouveau Saint-Roch,6,2,8,2022,01-21,01:31
026 Renouvier,3,5,8,2022,01-21,01:31
027 Odysseum,4,4,8,2022,01-21,01:31
028 Saint-Denis,4,4,8,2022,01-21,01:31
029 Richter,6,10,16,2022,01-21,01:31
030 Charles Flahault,0,8,8,2022,01-21,01:31
031 Voltaire,2,6,8,2022,01-21,01:31
032 Pr�s d'Ar�nes,4,4,8,2022,01-21,01:31
033 Garcia Lorca,7,1,8,2022,01-21,01:31
034 Vert Bois,0,16,16,2022,01-21,01:31
035 Malbosc,2,6,8,2022,01-21,01:31
036 Occitanie,3,29,32,2022,01-21,01:31
037 FacdesSciences,0,24,24,2022,01-21,01:31
038 Fac de Lettres,3,13,16,2022,01-21,01:31
039 Aiguelongue,0,8,8,2022,01-21,01:31
040 Jeu de Mail des Abb�s,3,5,8,2022,01-21,01:31
041 Eurom�decine,1,7,8,2022,01-21,01:31
042 Marie Caizergues,8,0,8,2022,01-21,01:31
043 Sabines,4,4,8,2022,01-21,01:31
044 Celleneuve,0,8,8,2022,01-21,01:31
045 Jardin de la Lironde,3,5,8,2022,01-21,01:31
046 P�re Soulas,4,4,8,2022,01-21,01:31
047 Place Viala,4,4,8,2022,01-21,01:31
048 H�tel du D�partement,6,2,8,2022,01-21,01:31
049 Tonnelles,2,6,8,2022,01-21,01:31
050 Parvis Jules Ferry - Gare Saint-Roch,6,2,8,2022,01-21,01:31
051 Pont de Lattes - Gare Saint-Roch,0,12,12,2022,01-21,01:31
053 Deux Ponts - Gare Saint-Roch,2,6,8,2022,01-21,01:31
054 Providence - Ovalie,3,5,8,2022,01-21,01:31
055 P�rols Etang de l'Or,26,42,68,2022,01-21,01:31
056 Albert 1er - Cath�drale,3,9,12,2022,01-21,01:31
057 Saint-Guilhem - Courreau,7,1,8,2022,01-21,01:31
059 Sud De France,3,5,8,2022,01-21,01:31
001 Rue Jules Ferry - Gare Saint-Roch,5,7,12,2022,01-21,01:41
002 Com�die,5,19,24,2022,01-21,01:41
003 Esplanade,2,30,32,2022,01-21,01:41
004 H�tel de Ville,8,8,16,2022,01-21,01:41
005 Corum,12,0,12,2022,01-21,01:41
006 Place Albert 1er - St Charles,23,8,31,2022,01-21,01:41
007 Foch,2,6,8,2022,01-21,01:41
008 Halles Castellane,0,12,12,2022,01-21,01:41
009 Observatoire,6,2,8,2022,01-21,01:41
010 Rondelet,1,15,16,2022,01-21,01:41
011 Plan Cabanes,6,6,12,2022,01-21,01:41
012 Boutonnet,2,10,12,2022,01-21,01:41
013 Emile Combes,8,0,8,2022,01-21,01:41
014 Beaux-Arts,3,5,8,2022,01-21,01:41
015 Les Aubes,7,1,8,2022,01-21,01:41
016 Antigone centre,13,3,16,2022,01-21,01:41
017 M�diath�que Emile Zola,15,1,16,2022,01-21,01:41
018 Nombre d'Or,11,5,16,2022,01-21,01:41
019 Louis Blanc,14,2,16,2022,01-21,01:41
020 Gambetta,3,5,8,2022,01-21,01:41
021 Port Marianne,12,4,16,2022,01-21,01:41
022 Clemenceau,8,4,12,2022,01-21,01:41
023 Les Arceaux,3,13,16,2022,01-21,01:41
024 Cit� Mion,4,4,8,2022,01-21,01:41
025 Nouveau Saint-Roch,6,2,8,2022,01-21,01:41
026 Renouvier,3,5,8,2022,01-21,01:41
027 Odysseum,4,4,8,2022,01-21,01:41
028 Saint-Denis,4,4,8,2022,01-21,01:41
029 Richter,7,9,16,2022,01-21,01:41
030 Charles Flahault,0,8,8,2022,01-21,01:41
031 Voltaire,2,6,8,2022,01-21,01:41
032 Pr�s d'Ar�nes,4,4,8,2022,01-21,01:41
033 Garcia Lorca,7,1,8,2022,01-21,01:41
034 Vert Bois,0,16,16,2022,01-21,01:41
035 Malbosc,2,6,8,2022,01-21,01:41
036 Occitanie,3,29,32,2022,01-21,01:41
037 FacdesSciences,0,24,24,2022,01-21,01:41
038 Fac de Lettres,3,13,16,2022,01-21,01:41
039 Aiguelongue,1,7,8,2022,01-21,01:41
040 Jeu de Mail des Abb�s,3,5,8,2022,01-21,01:41
041 Eurom�decine,1,7,8,2022,01-21,01:41
042 Marie Caizergues,8,0,8,2022,01-21,01:41
043 Sabines,4,4,8,2022,01-21,01:41
044 Celleneuve,0,8,8,2022,01-21,01:41
045 Jardin de la Lironde,3,5,8,2022,01-21,01:41
046 P�re Soulas,4,4,8,2022,01-21,01:41
047 Place Viala,4,4,8,2022,01-21,01:41
048 H�tel du D�partement,6,2,8,2022,01-21,01:41
049 Tonnelles,2,6,8,2022,01-21,01:41
050 Parvis Jules Ferry - Gare Saint-Roch,6,2,8,2022,01-21,01:41
051 Pont de Lattes - Gare Saint-Roch,0,12,12,2022,01-21,01:41
053 Deux Ponts - Gare Saint-Roch,2,6,8,2022,01-21,01:41
054 Providence - Ovalie,3,5,8,2022,01-21,01:41
055 P�rols Etang de l'Or,26,42,68,2022,01-21,01:41
056 Albert 1er - Cath�drale,3,9,12,2022,01-21,01:41
057 Saint-Guilhem - Courreau,7,1,8,2022,01-21,01:41
059 Sud De France,3,5,8,2022,01-21,01:41
001 Rue Jules Ferry - Gare Saint-Roch,5,7,12,2022,01-21,01:51
002 Com�die,5,19,24,2022,01-21,01:51
003 Esplanade,1,31,32,2022,01-21,01:51
004 H�tel de Ville,8,8,16,2022,01-21,01:51
005 Corum,12,0,12,2022,01-21,01:51
006 Place Albert 1er - St Charles,22,9,31,2022,01-21,01:51
007 Foch,2,6,8,2022,01-21,01:51
008 Halles Castellane,0,12,12,2022,01-21,01:51
009 Observatoire,6,2,8,2022,01-21,01:51
010 Rondelet,1,15,16,2022,01-21,01:51
011 Plan Cabanes,6,6,12,2022,01-21,01:51
012 Boutonnet,2,10,12,2022,01-21,01:51
013 Emile Combes,7,1,8,2022,01-21,01:51
014 Beaux-Arts,3,5,8,2022,01-21,01:51
015 Les Aubes,7,1,8,2022,01-21,01:51
016 Antigone centre,14,2,16,2022,01-21,01:51
017 M�diath�que Emile Zola,15,1,16,2022,01-21,01:51
018 Nombre d'Or,11,5,16,2022,01-21,01:51
019 Louis Blanc,14,2,16,2022,01-21,01:51
020 Gambetta,3,5,8,2022,01-21,01:51
021 Port Marianne,12,4,16,2022,01-21,01:51
022 Clemenceau,8,4,12,2022,01-21,01:51
023 Les Arceaux,4,12,16,2022,01-21,01:51
024 Cit� Mion,4,4,8,2022,01-21,01:51
025 Nouveau Saint-Roch,5,3,8,2022,01-21,01:51
026 Renouvier,3,5,8,2022,01-21,01:51
027 Odysseum,4,4,8,2022,01-21,01:51
028 Saint-Denis,4,4,8,2022,01-21,01:51
029 Richter,7,9,16,2022,01-21,01:51
030 Charles Flahault,0,8,8,2022,01-21,01:51
031 Voltaire,1,7,8,2022,01-21,01:51
032 Pr�s d'Ar�nes,4,4,8,2022,01-21,01:51
033 Garcia Lorca,7,1,8,2022,01-21,01:51
034 Vert Bois,0,16,16,2022,01-21,01:51
035 Malbosc,2,6,8,2022,01-21,01:51
036 Occitanie,3,29,32,2022,01-21,01:51
037 FacdesSciences,0,24,24,2022,01-21,01:51
038 Fac de Lettres,3,13,16,2022,01-21,01:51
039 Aiguelongue,1,7,8,2022,01-21,01:51
040 Jeu de Mail des Abb�s,3,5,8,2022,01-21,01:51
041 Eurom�decine,1,7,8,2022,01-21,01:51
042 Marie Caizergues,8,0,8,2022,01-21,01:51
043 Sabines,4,4,8,2022,01-21,01:51
044 Celleneuve,0,8,8,2022,01-21,01:51
045 Jardin de la Lironde,3,5,8,2022,01-21,01:51
046 P�re Soulas,4,4,8,2022,01-21,01:51
047 Place Viala,4,4,8,2022,01-21,01:51
048 H�tel du D�partement,5,3,8,2022,01-21,01:51
049 Tonnelles,3,5,8,2022,01-21,01:51
050 Parvis Jules Ferry - Gare Saint-Roch,6,2,8,2022,01-21,01:51
051 Pont de Lattes - Gare Saint-Roch,0,12,12,2022,01-21,01:51
053 Deux Ponts - Gare Saint-Roch,2,6,8,2022,01-21,01:51
054 Providence - Ovalie,3,5,8,2022,01-21,01:51
055 P�rols Etang de l'Or,26,42,68,2022,01-21,01:51
056 Albert 1er - Cath�drale,3,9,12,2022,01-21,01:51
057 Saint-Guilhem - Courreau,7,1,8,2022,01-21,01:51
059 Sud De France,3,5,8,2022,01-21,01:51
001 Rue Jules Ferry - Gare Saint-Roch,5,7,12,2022,01-21,02:01
002 Com�die,5,19,24,2022,01-21,02:01
003 Esplanade,0,32,32,2022,01-21,02:01
004 H�tel de Ville,8,8,16,2022,01-21,02:01
005 Corum,12,0,12,2022,01-21,02:01
006 Place Albert 1er - St Charles,22,9,31,2022,01-21,02:01
007 Foch,2,6,8,2022,01-21,02:01
008 Halles Castellane,0,12,12,2022,01-21,02:01
009 Observatoire,6,2,8,2022,01-21,02:01
010 Rondelet,1,15,16,2022,01-21,02:01
011 Plan Cabanes,6,6,12,2022,01-21,02:01
012 Boutonnet,2,10,12,2022,01-21,02:01
013 Emile Combes,7,1,8,2022,01-21,02:01
014 Beaux-Arts,3,5,8,2022,01-21,02:01
015 Les Aubes,7,1,8,2022,01-21,02:01
016 Antigone centre,14,2,16,2022,01-21,02:01
017 M�diath�que Emile Zola,14,2,16,2022,01-21,02:01
018 Nombre d'Or,11,5,16,2022,01-21,02:01
019 Louis Blanc,13,3,16,2022,01-21,02:01
020 Gambetta,3,5,8,2022,01-21,02:01
021 Port Marianne,12,4,16,2022,01-21,02:01
022 Clemenceau,8,4,12,2022,01-21,02:01
023 Les Arceaux,4,12,16,2022,01-21,02:01
024 Cit� Mion,4,4,8,2022,01-21,02:01
025 Nouveau Saint-Roch,5,3,8,2022,01-21,02:01
026 Renouvier,3,5,8,2022,01-21,02:01
027 Odysseum,4,4,8,2022,01-21,02:01
028 Saint-Denis,4,4,8,2022,01-21,02:01
029 Richter,7,9,16,2022,01-21,02:01
030 Charles Flahault,0,8,8,2022,01-21,02:01
031 Voltaire,2,6,8,2022,01-21,02:01
032 Pr�s d'Ar�nes,4,4,8,2022,01-21,02:01
033 Garcia Lorca,7,1,8,2022,01-21,02:01
034 Vert Bois,0,16,16,2022,01-21,02:01
035 Malbosc,2,6,8,2022,01-21,02:01
036 Occitanie,3,29,32,2022,01-21,02:01
037 FacdesSciences,0,24,24,2022,01-21,02:01
038 Fac de Lettres,3,13,16,2022,01-21,02:01
039 Aiguelongue,2,6,8,2022,01-21,02:01
040 Jeu de Mail des Abb�s,3,5,8,2022,01-21,02:01
041 Eurom�decine,1,7,8,2022,01-21,02:01
042 Marie Caizergues,8,0,8,2022,01-21,02:01
043 Sabines,4,4,8,2022,01-21,02:01
044 Celleneuve,0,8,8,2022,01-21,02:01
045 Jardin de la Lironde,3,5,8,2022,01-21,02:01
046 P�re Soulas,4,4,8,2022,01-21,02:01
047 Place Viala,4,4,8,2022,01-21,02:01
048 H�tel du D�partement,5,3,8,2022,01-21,02:01
049 Tonnelles,3,5,8,2022,01-21,02:01
050 Parvis Jules Ferry - Gare Saint-Roch,6,2,8,2022,01-21,02:01
051 Pont de Lattes - Gare Saint-Roch,0,12,12,2022,01-21,02:01
053 Deux Ponts - Gare Saint-Roch,2,6,8,2022,01-21,02:01
054 Providence - Ovalie,3,5,8,2022,01-21,02:01
055 P�rols Etang de l'Or,26,42,68,2022,01-21,02:01
056 Albert 1er - Cath�drale,3,9,12,2022,01-21,02:01
057 Saint-Guilhem - Courreau,7,1,8,2022,01-21,02:01
059 Sud De France,3,5,8,2022,01-21,02:01
001 Rue Jules Ferry - Gare Saint-Roch,5,7,12,2022,01-21,02:11
002 Com�die,5,19,24,2022,01-21,02:11
003 Esplanade,0,32,32,2022,01-21,02:11
004 H�tel de Ville,8,8,16,2022,01-21,02:11
005 Corum,12,0,12,2022,01-21,02:11
006 Place Albert 1er - St Charles,22,9,31,2022,01-21,02:11
007 Foch,2,6,8,2022,01-21,02:11
008 Halles Castellane,0,12,12,2022,01-21,02:11
009 Observatoire,6,2,8,2022,01-21,02:11
010 Rondelet,1,15,16,2022,01-21,02:11
011 Plan Cabanes,6,6,12,2022,01-21,02:11
012 Boutonnet,2,10,12,2022,01-21,02:11
013 Emile Combes,7,1,8,2022,01-21,02:11
014 Beaux-Arts,3,5,8,2022,01-21,02:11
015 Les Aubes,7,1,8,2022,01-21,02:11
016 Antigone centre,14,2,16,2022,01-21,02:11
017 M�diath�que Emile Zola,14,2,16,2022,01-21,02:11
018 Nombre d'Or,11,5,16,2022,01-21,02:11
019 Louis Blanc,14,2,16,2022,01-21,02:11
020 Gambetta,3,5,8,2022,01-21,02:11
021 Port Marianne,12,4,16,2022,01-21,02:11
022 Clemenceau,8,4,12,2022,01-21,02:11
023 Les Arceaux,3,13,16,2022,01-21,02:11
024 Cit� Mion,4,4,8,2022,01-21,02:11
025 Nouveau Saint-Roch,5,3,8,2022,01-21,02:11
026 Renouvier,3,5,8,2022,01-21,02:11
027 Odysseum,4,4,8,2022,01-21,02:11
028 Saint-Denis,5,3,8,2022,01-21,02:11
029 Richter,7,9,16,2022,01-21,02:11
030 Charles Flahault,0,8,8,2022,01-21,02:11
031 Voltaire,2,6,8,2022,01-21,02:11
032 Pr�s d'Ar�nes,4,4,8,2022,01-21,02:11
033 Garcia Lorca,7,1,8,2022,01-21,02:11
034 Vert Bois,0,16,16,2022,01-21,02:11
035 Malbosc,2,6,8,2022,01-21,02:11
036 Occitanie,5,27,32,2022,01-21,02:11
037 FacdesSciences,0,24,24,2022,01-21,02:11
038 Fac de Lettres,3,13,16,2022,01-21,02:11
039 Aiguelongue,2,6,8,2022,01-21,02:11
040 Jeu de Mail des Abb�s,3,5,8,2022,01-21,02:11
041 Eurom�decine,1,7,8,2022,01-21,02:11
042 Marie Caizergues,8,0,8,2022,01-21,02:11
043 Sabines,4,4,8,2022,01-21,02:11
044 Celleneuve,0,8,8,2022,01-21,02:11
045 Jardin de la Lironde,3,5,8,2022,01-21,02:11
046 P�re Soulas,4,4,8,2022,01-21,02:11
047 Place Viala,4,4,8,2022,01-21,02:11
048 H�tel du D�partement,5,3,8,2022,01-21,02:11
049 Tonnelles,3,5,8,2022,01-21,02:11
050 Parvis Jules Ferry - Gare Saint-Roch,6,2,8,2022,01-21,02:11
051 Pont de Lattes - Gare Saint-Roch,0,12,12,2022,01-21,02:11
053 Deux Ponts - Gare Saint-Roch,2,6,8,2022,01-21,02:11
054 Providence - Ovalie,3,5,8,2022,01-21,02:11
055 P�rols Etang de l'Or,26,42,68,2022,01-21,02:11
056 Albert 1er - Cath�drale,3,9,12,2022,01-21,02:11
057 Saint-Guilhem - Courreau,7,1,8,2022,01-21,02:11
059 Sud De France,3,5,8,2022,01-21,02:11
001 Rue Jules Ferry - Gare Saint-Roch,5,7,12,2022,01-21,02:22
002 Com�die,4,20,24,2022,01-21,02:22
003 Esplanade,0,32,32,2022,01-21,02:22
004 H�tel de Ville,8,8,16,2022,01-21,02:22
005 Corum,12,0,12,2022,01-21,02:22
006 Place Albert 1er - St Charles,22,9,31,2022,01-21,02:22
007 Foch,2,6,8,2022,01-21,02:22
008 Halles Castellane,0,12,12,2022,01-21,02:22
009 Observatoire,6,2,8,2022,01-21,02:22
010 Rondelet,1,15,16,2022,01-21,02:22
011 Plan Cabanes,6,6,12,2022,01-21,02:22
012 Boutonnet,2,10,12,2022,01-21,02:22
013 Emile Combes,7,1,8,2022,01-21,02:22
014 Beaux-Arts,3,5,8,2022,01-21,02:22
015 Les Aubes,7,1,8,2022,01-21,02:22
016 Antigone centre,14,2,16,2022,01-21,02:22
017 M�diath�que Emile Zola,14,2,16,2022,01-21,02:22
018 Nombre d'Or,11,5,16,2022,01-21,02:22
019 Louis Blanc,14,2,16,2022,01-21,02:22
020 Gambetta,3,5,8,2022,01-21,02:22
021 Port Marianne,12,4,16,2022,01-21,02:22
022 Clemenceau,8,4,12,2022,01-21,02:22
023 Les Arceaux,3,13,16,2022,01-21,02:22
024 Cit� Mion,4,4,8,2022,01-21,02:22
025 Nouveau Saint-Roch,5,3,8,2022,01-21,02:22
026 Renouvier,3,5,8,2022,01-21,02:22
027 Odysseum,4,4,8,2022,01-21,02:22
028 Saint-Denis,5,3,8,2022,01-21,02:22
029 Richter,7,9,16,2022,01-21,02:22
030 Charles Flahault,0,8,8,2022,01-21,02:22
031 Voltaire,2,6,8,2022,01-21,02:22
032 Pr�s d'Ar�nes,4,4,8,2022,01-21,02:22
033 Garcia Lorca,7,1,8,2022,01-21,02:22
034 Vert Bois,0,16,16,2022,01-21,02:22
035 Malbosc,2,6,8,2022,01-21,02:22
036 Occitanie,5,27,32,2022,01-21,02:22
037 FacdesSciences,0,24,24,2022,01-21,02:22
038 Fac de Lettres,5,11,16,2022,01-21,02:22
039 Aiguelongue,2,6,8,2022,01-21,02:22
040 Jeu de Mail des Abb�s,3,5,8,2022,01-21,02:22
041 Eurom�decine,1,7,8,2022,01-21,02:22
042 Marie Caizergues,8,0,8,2022,01-21,02:22
043 Sabines,4,4,8,2022,01-21,02:22
044 Celleneuve,0,8,8,2022,01-21,02:22
045 Jardin de la Lironde,3,5,8,2022,01-21,02:22
046 P�re Soulas,4,4,8,2022,01-21,02:22
047 Place Viala,4,4,8,2022,01-21,02:22
048 H�tel du D�partement,5,3,8,2022,01-21,02:22
049 Tonnelles,3,5,8,2022,01-21,02:22
050 Parvis Jules Ferry - Gare Saint-Roch,6,2,8,2022,01-21,02:22
051 Pont de Lattes - Gare Saint-Roch,0,12,12,2022,01-21,02:22
053 Deux Ponts - Gare Saint-Roch,2,6,8,2022,01-21,02:22
054 Providence - Ovalie,3,5,8,2022,01-21,02:22
055 P�rols Etang de l'Or,26,42,68,2022,01-21,02:22
056 Albert 1er - Cath�drale,3,9,12,2022,01-21,02:22
057 Saint-Guilhem - Courreau,7,1,8,2022,01-21,02:22
059 Sud De France,3,5,8,2022,01-21,02:22
001 Rue Jules Ferry - Gare Saint-Roch,5,7,12,2022,01-21,02:32
002 Com�die,4,20,24,2022,01-21,02:32
003 Esplanade,0,32,32,2022,01-21,02:32
004 H�tel de Ville,8,8,16,2022,01-21,02:32
005 Corum,12,0,12,2022,01-21,02:32
006 Place Albert 1er - St Charles,21,10,31,2022,01-21,02:32
007 Foch,2,6,8,2022,01-21,02:32
008 Halles Castellane,0,12,12,2022,01-21,02:32
009 Observatoire,6,2,8,2022,01-21,02:32
010 Rondelet,1,15,16,2022,01-21,02:32
011 Plan Cabanes,6,6,12,2022,01-21,02:32
012 Boutonnet,4,8,12,2022,01-21,02:32
013 Emile Combes,7,1,8,2022,01-21,02:32
014 Beaux-Arts,3,5,8,2022,01-21,02:32
015 Les Aubes,7,1,8,2022,01-21,02:32
016 Antigone centre,14,2,16,2022,01-21,02:32
017 M�diath�que Emile Zola,13,3,16,2022,01-21,02:32
018 Nombre d'Or,11,5,16,2022,01-21,02:32
019 Louis Blanc,14,2,16,2022,01-21,02:32
020 Gambetta,3,5,8,2022,01-21,02:32
021 Port Marianne,12,4,16,2022,01-21,02:32
022 Clemenceau,8,4,12,2022,01-21,02:32
023 Les Arceaux,3,13,16,2022,01-21,02:32
024 Cit� Mion,4,4,8,2022,01-21,02:32
025 Nouveau Saint-Roch,5,3,8,2022,01-21,02:32
026 Renouvier,3,5,8,2022,01-21,02:32
027 Odysseum,4,4,8,2022,01-21,02:32
028 Saint-Denis,5,3,8,2022,01-21,02:32
029 Richter,7,9,16,2022,01-21,02:32
030 Charles Flahault,0,8,8,2022,01-21,02:32
031 Voltaire,2,6,8,2022,01-21,02:32
032 Pr�s d'Ar�nes,4,4,8,2022,01-21,02:32
033 Garcia Lorca,7,1,8,2022,01-21,02:32
034 Vert Bois,0,16,16,2022,01-21,02:32
035 Malbosc,2,6,8,2022,01-21,02:32
036 Occitanie,4,28,32,2022,01-21,02:32
037 FacdesSciences,0,24,24,2022,01-21,02:32
038 Fac de Lettres,5,11,16,2022,01-21,02:32
039 Aiguelongue,2,6,8,2022,01-21,02:32
040 Jeu de Mail des Abb�s,3,5,8,2022,01-21,02:32
041 Eurom�decine,1,7,8,2022,01-21,02:32
042 Marie Caizergues,8,0,8,2022,01-21,02:32
043 Sabines,4,4,8,2022,01-21,02:32
044 Celleneuve,0,8,8,2022,01-21,02:32
045 Jardin de la Lironde,3,5,8,2022,01-21,02:32
046 P�re Soulas,5,3,8,2022,01-21,02:32
047 Place Viala,4,4,8,2022,01-21,02:32
048 H�tel du D�partement,5,3,8,2022,01-21,02:32
049 Tonnelles,3,5,8,2022,01-21,02:32
050 Parvis Jules Ferry - Gare Saint-Roch,6,2,8,2022,01-21,02:32
051 Pont de Lattes - Gare Saint-Roch,0,12,12,2022,01-21,02:32
053 Deux Ponts - Gare Saint-Roch,2,6,8,2022,01-21,02:32
054 Providence - Ovalie,3,5,8,2022,01-21,02:32
055 P�rols Etang de l'Or,26,42,68,2022,01-21,02:32
056 Albert 1er - Cath�drale,3,9,12,2022,01-21,02:32
057 Saint-Guilhem - Courreau,7,1,8,2022,01-21,02:32
059 Sud De France,3,5,8,2022,01-21,02:32
001 Rue Jules Ferry - Gare Saint-Roch,5,7,12,2022,01-21,02:42
002 Com�die,4,20,24,2022,01-21,02:42
003 Esplanade,0,32,32,2022,01-21,02:42
004 H�tel de Ville,8,8,16,2022,01-21,02:42
005 Corum,12,0,12,2022,01-21,02:42
006 Place Albert 1er - St Charles,21,10,31,2022,01-21,02:42
007 Foch,2,6,8,2022,01-21,02:42
008 Halles Castellane,0,12,12,2022,01-21,02:42
009 Observatoire,6,2,8,2022,01-21,02:42
010 Rondelet,1,15,16,2022,01-21,02:42
011 Plan Cabanes,6,6,12,2022,01-21,02:42
012 Boutonnet,4,8,12,2022,01-21,02:42
013 Emile Combes,7,1,8,2022,01-21,02:42
014 Beaux-Arts,3,5,8,2022,01-21,02:42
015 Les Aubes,7,1,8,2022,01-21,02:42
016 Antigone centre,14,2,16,2022,01-21,02:42
017 M�diath�que Emile Zola,13,3,16,2022,01-21,02:42
018 Nombre d'Or,11,5,16,2022,01-21,02:42
019 Louis Blanc,14,2,16,2022,01-21,02:42
020 Gambetta,3,5,8,2022,01-21,02:42
021 Port Marianne,12,4,16,2022,01-21,02:42
022 Clemenceau,8,4,12,2022,01-21,02:42
023 Les Arceaux,3,13,16,2022,01-21,02:42
024 Cit� Mion,4,4,8,2022,01-21,02:42
025 Nouveau Saint-Roch,5,3,8,2022,01-21,02:42
026 Renouvier,3,5,8,2022,01-21,02:42
027 Odysseum,4,4,8,2022,01-21,02:42
028 Saint-Denis,5,3,8,2022,01-21,02:42
029 Richter,7,9,16,2022,01-21,02:42
030 Charles Flahault,0,8,8,2022,01-21,02:42
031 Voltaire,2,6,8,2022,01-21,02:42
032 Pr�s d'Ar�nes,4,4,8,2022,01-21,02:42
033 Garcia Lorca,8,0,8,2022,01-21,02:42
034 Vert Bois,0,16,16,2022,01-21,02:42
035 Malbosc,2,6,8,2022,01-21,02:42
036 Occitanie,6,26,32,2022,01-21,02:42
037 FacdesSciences,0,24,24,2022,01-21,02:42
038 Fac de Lettres,6,10,16,2022,01-21,02:42
039 Aiguelongue,2,6,8,2022,01-21,02:42
040 Jeu de Mail des Abb�s,3,5,8,2022,01-21,02:42
041 Eurom�decine,1,7,8,2022,01-21,02:42
042 Marie Caizergues,8,0,8,2022,01-21,02:42
043 Sabines,5,3,8,2022,01-21,02:42
044 Celleneuve,1,7,8,2022,01-21,02:42
045 Jardin de la Lironde,3,5,8,2022,01-21,02:42
046 P�re Soulas,5,3,8,2022,01-21,02:42
047 Place Viala,4,4,8,2022,01-21,02:42
048 H�tel du D�partement,5,3,8,2022,01-21,02:42
049 Tonnelles,3,5,8,2022,01-21,02:42
050 Parvis Jules Ferry - Gare Saint-Roch,6,2,8,2022,01-21,02:42
051 Pont de Lattes - Gare Saint-Roch,0,12,12,2022,01-21,02:42
053 Deux Ponts - Gare Saint-Roch,2,6,8,2022,01-21,02:42
054 Providence - Ovalie,3,5,8,2022,01-21,02:42
055 P�rols Etang de l'Or,26,42,68,2022,01-21,02:42
056 Albert 1er - Cath�drale,3,9,12,2022,01-21,02:42
057 Saint-Guilhem - Courreau,7,1,8,2022,01-21,02:42
059 Sud De France,3,5,8,2022,01-21,02:42
001 Rue Jules Ferry - Gare Saint-Roch,5,7,12,2022,01-21,02:52
002 Com�die,4,20,24,2022,01-21,02:52
003 Esplanade,0,32,32,2022,01-21,02:52
004 H�tel de Ville,8,8,16,2022,01-21,02:52
005 Corum,12,0,12,2022,01-21,02:52
006 Place Albert 1er - St Charles,21,10,31,2022,01-21,02:52
007 Foch,2,6,8,2022,01-21,02:52
008 Halles Castellane,0,12,12,2022,01-21,02:52
009 Observatoire,6,2,8,2022,01-21,02:52
010 Rondelet,1,15,16,2022,01-21,02:52
011 Plan Cabanes,6,6,12,2022,01-21,02:52
012 Boutonnet,4,8,12,2022,01-21,02:52
013 Emile Combes,7,1,8,2022,01-21,02:52
014 Beaux-Arts,3,5,8,2022,01-21,02:52
015 Les Aubes,7,1,8,2022,01-21,02:52
016 Antigone centre,14,2,16,2022,01-21,02:52
017 M�diath�que Emile Zola,13,3,16,2022,01-21,02:52
018 Nombre d'Or,11,5,16,2022,01-21,02:52
019 Louis Blanc,14,2,16,2022,01-21,02:52
020 Gambetta,2,6,8,2022,01-21,02:52
021 Port Marianne,12,4,16,2022,01-21,02:52
022 Clemenceau,8,4,12,2022,01-21,02:52
023 Les Arceaux,3,13,16,2022,01-21,02:52
024 Cit� Mion,4,4,8,2022,01-21,02:52
025 Nouveau Saint-Roch,5,3,8,2022,01-21,02:52
026 Renouvier,3,5,8,2022,01-21,02:52
027 Odysseum,4,4,8,2022,01-21,02:52
028 Saint-Denis,5,3,8,2022,01-21,02:52
029 Richter,7,9,16,2022,01-21,02:52
030 Charles Flahault,0,8,8,2022,01-21,02:52
031 Voltaire,2,6,8,2022,01-21,02:52
032 Pr�s d'Ar�nes,4,4,8,2022,01-21,02:52
033 Garcia Lorca,8,0,8,2022,01-21,02:52
034 Vert Bois,0,16,16,2022,01-21,02:52
035 Malbosc,2,6,8,2022,01-21,02:52
036 Occitanie,6,26,32,2022,01-21,02:52
037 FacdesSciences,0,24,24,2022,01-21,02:52
038 Fac de Lettres,6,10,16,2022,01-21,02:52
039 Aiguelongue,2,6,8,2022,01-21,02:52
040 Jeu de Mail des Abb�s,3,5,8,2022,01-21,02:52
041 Eurom�decine,1,7,8,2022,01-21,02:52
042 Marie Caizergues,8,0,8,2022,01-21,02:52
043 Sabines,5,3,8,2022,01-21,02:52
044 Celleneuve,1,7,8,2022,01-21,02:52
045 Jardin de la Lironde,3,5,8,2022,01-21,02:52
046 P�re Soulas,5,3,8,2022,01-21,02:52
047 Place Viala,4,4,8,2022,01-21,02:52
048 H�tel du D�partement,5,3,8,2022,01-21,02:52
049 Tonnelles,3,5,8,2022,01-21,02:52
050 Parvis Jules Ferry - Gare Saint-Roch,6,2,8,2022,01-21,02:52
051 Pont de Lattes - Gare Saint-Roch,0,12,12,2022,01-21,02:52
053 Deux Ponts - Gare Saint-Roch,2,6,8,2022,01-21,02:52
054 Providence - Ovalie,3,5,8,2022,01-21,02:52
055 P�rols Etang de l'Or,26,42,68,2022,01-21,02:52
056 Albert 1er - Cath�drale,3,9,12,2022,01-21,02:52
057 Saint-Guilhem - Courreau,7,1,8,2022,01-21,02:52
059 Sud De France,3,5,8,2022,01-21,02:52
001 Rue Jules Ferry - Gare Saint-Roch,5,7,12,2022,01-21,03:02
002 Com�die,4,20,24,2022,01-21,03:02
003 Esplanade,0,32,32,2022,01-21,03:02
004 H�tel de Ville,8,8,16,2022,01-21,03:02
005 Corum,12,0,12,2022,01-21,03:02
006 Place Albert 1er - St Charles,21,10,31,2022,01-21,03:02
007 Foch,2,6,8,2022,01-21,03:02
008 Halles Castellane,0,12,12,2022,01-21,03:02
009 Observatoire,6,2,8,2022,01-21,03:02
010 Rondelet,1,15,16,2022,01-21,03:02
011 Plan Cabanes,6,6,12,2022,01-21,03:02
012 Boutonnet,2,10,12,2022,01-21,03:02
013 Emile Combes,7,1,8,2022,01-21,03:02
014 Beaux-Arts,3,5,8,2022,01-21,03:02
015 Les Aubes,7,1,8,2022,01-21,03:02
016 Antigone centre,14,2,16,2022,01-21,03:02
017 M�diath�que Emile Zola,13,3,16,2022,01-21,03:02
018 Nombre d'Or,11,5,16,2022,01-21,03:02
019 Louis Blanc,14,2,16,2022,01-21,03:02
020 Gambetta,2,6,8,2022,01-21,03:02
021 Port Marianne,12,4,16,2022,01-21,03:02
022 Clemenceau,8,4,12,2022,01-21,03:02
023 Les Arceaux,3,13,16,2022,01-21,03:02
024 Cit� Mion,4,4,8,2022,01-21,03:02
025 Nouveau Saint-Roch,5,3,8,2022,01-21,03:02
026 Renouvier,3,5,8,2022,01-21,03:02
027 Odysseum,4,4,8,2022,01-21,03:02
028 Saint-Denis,5,3,8,2022,01-21,03:02
029 Richter,7,9,16,2022,01-21,03:02
030 Charles Flahault,0,8,8,2022,01-21,03:02
031 Voltaire,2,6,8,2022,01-21,03:02
032 Pr�s d'Ar�nes,4,4,8,2022,01-21,03:02
033 Garcia Lorca,8,0,8,2022,01-21,03:02
034 Vert Bois,0,16,16,2022,01-21,03:02
035 Malbosc,2,6,8,2022,01-21,03:02
036 Occitanie,6,26,32,2022,01-21,03:02
037 FacdesSciences,0,24,24,2022,01-21,03:02
038 Fac de Lettres,6,10,16,2022,01-21,03:02
039 Aiguelongue,2,6,8,2022,01-21,03:02
040 Jeu de Mail des Abb�s,3,5,8,2022,01-21,03:02
041 Eurom�decine,1,7,8,2022,01-21,03:02
042 Marie Caizergues,8,0,8,2022,01-21,03:02
043 Sabines,5,3,8,2022,01-21,03:02
044 Celleneuve,1,7,8,2022,01-21,03:02
045 Jardin de la Lironde,3,5,8,2022,01-21,03:02
046 P�re Soulas,5,3,8,2022,01-21,03:02
047 Place Viala,5,3,8,2022,01-21,03:02
048 H�tel du D�partement,5,3,8,2022,01-21,03:02
049 Tonnelles,3,5,8,2022,01-21,03:02
050 Parvis Jules Ferry - Gare Saint-Roch,6,2,8,2022,01-21,03:02
051 Pont de Lattes - Gare Saint-Roch,0,12,12,2022,01-21,03:02
053 Deux Ponts - Gare Saint-Roch,2,6,8,2022,01-21,03:02
054 Providence - Ovalie,3,5,8,2022,01-21,03:02
055 P�rols Etang de l'Or,26,42,68,2022,01-21,03:02
056 Albert 1er - Cath�drale,3,9,12,2022,01-21,03:02
057 Saint-Guilhem - Courreau,7,1,8,2022,01-21,03:02
059 Sud De France,3,5,8,2022,01-21,03:02
001 Rue Jules Ferry - Gare Saint-Roch,5,7,12,2022,01-21,03:13
002 Com�die,4,20,24,2022,01-21,03:13
003 Esplanade,0,32,32,2022,01-21,03:13
004 H�tel de Ville,8,8,16,2022,01-21,03:13
005 Corum,12,0,12,2022,01-21,03:13
006 Place Albert 1er - St Charles,21,10,31,2022,01-21,03:13
007 Foch,2,6,8,2022,01-21,03:13
008 Halles Castellane,0,12,12,2022,01-21,03:13
009 Observatoire,4,4,8,2022,01-21,03:13
010 Rondelet,1,15,16,2022,01-21,03:13
011 Plan Cabanes,6,6,12,2022,01-21,03:13
012 Boutonnet,2,10,12,2022,01-21,03:13
013 Emile Combes,7,1,8,2022,01-21,03:13
014 Beaux-Arts,3,5,8,2022,01-21,03:13
015 Les Aubes,7,1,8,2022,01-21,03:13
016 Antigone centre,14,2,16,2022,01-21,03:13
017 M�diath�que Emile Zola,13,3,16,2022,01-21,03:13
018 Nombre d'Or,11,5,16,2022,01-21,03:13
019 Louis Blanc,14,2,16,2022,01-21,03:13
020 Gambetta,2,6,8,2022,01-21,03:13
021 Port Marianne,12,4,16,2022,01-21,03:13
022 Clemenceau,8,4,12,2022,01-21,03:13
023 Les Arceaux,3,13,16,2022,01-21,03:13
024 Cit� Mion,4,4,8,2022,01-21,03:13
025 Nouveau Saint-Roch,5,3,8,2022,01-21,03:13
026 Renouvier,3,5,8,2022,01-21,03:13
027 Odysseum,4,4,8,2022,01-21,03:13
028 Saint-Denis,5,3,8,2022,01-21,03:13
029 Richter,7,9,16,2022,01-21,03:13
030 Charles Flahault,0,8,8,2022,01-21,03:13
031 Voltaire,2,6,8,2022,01-21,03:13
032 Pr�s d'Ar�nes,4,4,8,2022,01-21,03:13
033 Garcia Lorca,8,0,8,2022,01-21,03:13
034 Vert Bois,0,16,16,2022,01-21,03:13
035 Malbosc,2,6,8,2022,01-21,03:13
036 Occitanie,6,26,32,2022,01-21,03:13
037 FacdesSciences,0,24,24,2022,01-21,03:13
038 Fac de Lettres,6,10,16,2022,01-21,03:13
039 Aiguelongue,2,6,8,2022,01-21,03:13
040 Jeu de Mail des Abb�s,3,5,8,2022,01-21,03:13
041 Eurom�decine,1,7,8,2022,01-21,03:13
042 Marie Caizergues,8,0,8,2022,01-21,03:13
043 Sabines,5,3,8,2022,01-21,03:13
044 Celleneuve,1,7,8,2022,01-21,03:13
045 Jardin de la Lironde,3,5,8,2022,01-21,03:13
046 P�re Soulas,5,3,8,2022,01-21,03:13
047 Place Viala,5,3,8,2022,01-21,03:13
048 H�tel du D�partement,5,3,8,2022,01-21,03:13
049 Tonnelles,3,5,8,2022,01-21,03:13
050 Parvis Jules Ferry - Gare Saint-Roch,6,2,8,2022,01-21,03:13
051 Pont de Lattes - Gare Saint-Roch,0,12,12,2022,01-21,03:13
053 Deux Ponts - Gare Saint-Roch,2,6,8,2022,01-21,03:13
054 Providence - Ovalie,3,5,8,2022,01-21,03:13
055 P�rols Etang de l'Or,26,42,68,2022,01-21,03:13
056 Albert 1er - Cath�drale,0,12,12,2022,01-21,03:13
057 Saint-Guilhem - Courreau,1,7,8,2022,01-21,03:13
059 Sud De France,3,5,8,2022,01-21,03:13
001 Rue Jules Ferry - Gare Saint-Roch,5,7,12,2022,01-21,03:23
002 Com�die,4,20,24,2022,01-21,03:23
003 Esplanade,0,32,32,2022,01-21,03:23
004 H�tel de Ville,8,8,16,2022,01-21,03:23
005 Corum,12,0,12,2022,01-21,03:23
006 Place Albert 1er - St Charles,21,10,31,2022,01-21,03:23
007 Foch,2,6,8,2022,01-21,03:23
008 Halles Castellane,0,12,12,2022,01-21,03:23
009 Observatoire,4,4,8,2022,01-21,03:23
010 Rondelet,1,15,16,2022,01-21,03:23
011 Plan Cabanes,5,7,12,2022,01-21,03:23
012 Boutonnet,2,10,12,2022,01-21,03:23
013 Emile Combes,7,1,8,2022,01-21,03:23
014 Beaux-Arts,3,5,8,2022,01-21,03:23
015 Les Aubes,7,1,8,2022,01-21,03:23
016 Antigone centre,14,2,16,2022,01-21,03:23
017 M�diath�que Emile Zola,13,3,16,2022,01-21,03:23
018 Nombre d'Or,11,5,16,2022,01-21,03:23
019 Louis Blanc,14,2,16,2022,01-21,03:23
020 Gambetta,2,6,8,2022,01-21,03:23
021 Port Marianne,12,4,16,2022,01-21,03:23
022 Clemenceau,8,4,12,2022,01-21,03:23
023 Les Arceaux,3,13,16,2022,01-21,03:23
024 Cit� Mion,4,4,8,2022,01-21,03:23
025 Nouveau Saint-Roch,5,3,8,2022,01-21,03:23
026 Renouvier,3,5,8,2022,01-21,03:23
027 Odysseum,4,4,8,2022,01-21,03:23
028 Saint-Denis,5,3,8,2022,01-21,03:23
029 Richter,7,9,16,2022,01-21,03:23
030 Charles Flahault,0,8,8,2022,01-21,03:23
031 Voltaire,2,6,8,2022,01-21,03:23
032 Pr�s d'Ar�nes,4,4,8,2022,01-21,03:23
033 Garcia Lorca,8,0,8,2022,01-21,03:23
034 Vert Bois,0,16,16,2022,01-21,03:23
035 Malbosc,2,6,8,2022,01-21,03:23
036 Occitanie,5,27,32,2022,01-21,03:23
037 FacdesSciences,0,24,24,2022,01-21,03:23
038 Fac de Lettres,6,10,16,2022,01-21,03:23
039 Aiguelongue,2,6,8,2022,01-21,03:23
040 Jeu de Mail des Abb�s,3,5,8,2022,01-21,03:23
041 Eurom�decine,1,7,8,2022,01-21,03:23
042 Marie Caizergues,8,0,8,2022,01-21,03:23
043 Sabines,5,3,8,2022,01-21,03:23
044 Celleneuve,1,7,8,2022,01-21,03:23
045 Jardin de la Lironde,3,5,8,2022,01-21,03:23
046 P�re Soulas,5,3,8,2022,01-21,03:23
047 Place Viala,5,3,8,2022,01-21,03:23
048 H�tel du D�partement,5,3,8,2022,01-21,03:23
049 Tonnelles,3,5,8,2022,01-21,03:23
050 Parvis Jules Ferry - Gare Saint-Roch,6,2,8,2022,01-21,03:23
051 Pont de Lattes - Gare Saint-Roch,0,12,12,2022,01-21,03:23
053 Deux Ponts - Gare Saint-Roch,2,6,8,2022,01-21,03:23
054 Providence - Ovalie,3,5,8,2022,01-21,03:23
055 P�rols Etang de l'Or,26,42,68,2022,01-21,03:23
056 Albert 1er - Cath�drale,0,12,12,2022,01-21,03:23
057 Saint-Guilhem - Courreau,1,7,8,2022,01-21,03:23
059 Sud De France,3,5,8,2022,01-21,03:23
001 Rue Jules Ferry - Gare Saint-Roch,5,7,12,2022,01-21,03:33
002 Com�die,4,20,24,2022,01-21,03:33
003 Esplanade,0,32,32,2022,01-21,03:33
004 H�tel de Ville,8,8,16,2022,01-21,03:33
005 Corum,12,0,12,2022,01-21,03:33
006 Place Albert 1er - St Charles,23,8,31,2022,01-21,03:33
007 Foch,2,6,8,2022,01-21,03:33
008 Halles Castellane,0,12,12,2022,01-21,03:33
009 Observatoire,4,4,8,2022,01-21,03:33
010 Rondelet,1,15,16,2022,01-21,03:33
011 Plan Cabanes,5,7,12,2022,01-21,03:33
012 Boutonnet,2,10,12,2022,01-21,03:33
013 Emile Combes,7,1,8,2022,01-21,03:33
014 Beaux-Arts,3,5,8,2022,01-21,03:33
015 Les Aubes,7,1,8,2022,01-21,03:33
016 Antigone centre,14,2,16,2022,01-21,03:33
017 M�diath�que Emile Zola,15,1,16,2022,01-21,03:33
018 Nombre d'Or,11,5,16,2022,01-21,03:33
019 Louis Blanc,14,2,16,2022,01-21,03:33
020 Gambetta,2,6,8,2022,01-21,03:33
021 Port Marianne,12,4,16,2022,01-21,03:33
022 Clemenceau,8,4,12,2022,01-21,03:33
023 Les Arceaux,3,13,16,2022,01-21,03:33
024 Cit� Mion,4,4,8,2022,01-21,03:33
025 Nouveau Saint-Roch,5,3,8,2022,01-21,03:33
026 Renouvier,3,5,8,2022,01-21,03:33
027 Odysseum,4,4,8,2022,01-21,03:33
028 Saint-Denis,5,3,8,2022,01-21,03:33
029 Richter,7,9,16,2022,01-21,03:33
030 Charles Flahault,0,8,8,2022,01-21,03:33
031 Voltaire,4,4,8,2022,01-21,03:33
032 Pr�s d'Ar�nes,4,4,8,2022,01-21,03:33
033 Garcia Lorca,8,0,8,2022,01-21,03:33
034 Vert Bois,0,16,16,2022,01-21,03:33
035 Malbosc,3,5,8,2022,01-21,03:33
036 Occitanie,5,27,32,2022,01-21,03:33
037 FacdesSciences,1,23,24,2022,01-21,03:33
038 Fac de Lettres,6,10,16,2022,01-21,03:33
039 Aiguelongue,2,6,8,2022,01-21,03:33
040 Jeu de Mail des Abb�s,3,5,8,2022,01-21,03:33
041 Eurom�decine,2,6,8,2022,01-21,03:33
042 Marie Caizergues,8,0,8,2022,01-21,03:33
043 Sabines,5,3,8,2022,01-21,03:33
044 Celleneuve,1,7,8,2022,01-21,03:33
045 Jardin de la Lironde,5,3,8,2022,01-21,03:33
046 P�re Soulas,7,1,8,2022,01-21,03:33
047 Place Viala,5,3,8,2022,01-21,03:33
048 H�tel du D�partement,5,3,8,2022,01-21,03:33
049 Tonnelles,3,5,8,2022,01-21,03:33
050 Parvis Jules Ferry - Gare Saint-Roch,6,2,8,2022,01-21,03:33
051 Pont de Lattes - Gare Saint-Roch,0,12,12,2022,01-21,03:33
053 Deux Ponts - Gare Saint-Roch,2,6,8,2022,01-21,03:33
054 Providence - Ovalie,3,5,8,2022,01-21,03:33
055 P�rols Etang de l'Or,26,42,68,2022,01-21,03:33
056 Albert 1er - Cath�drale,0,12,12,2022,01-21,03:33
057 Saint-Guilhem - Courreau,1,7,8,2022,01-21,03:33
059 Sud De France,3,5,8,2022,01-21,03:33
001 Rue Jules Ferry - Gare Saint-Roch,5,7,12,2022,01-21,03:43
002 Com�die,4,20,24,2022,01-21,03:43
003 Esplanade,0,32,32,2022,01-21,03:43
004 H�tel de Ville,8,8,16,2022,01-21,03:43
005 Corum,12,0,12,2022,01-21,03:43
006 Place Albert 1er - St Charles,23,8,31,2022,01-21,03:43
007 Foch,2,6,8,2022,01-21,03:43
008 Halles Castellane,0,12,12,2022,01-21,03:43
009 Observatoire,4,4,8,2022,01-21,03:43
010 Rondelet,1,15,16,2022,01-21,03:43
011 Plan Cabanes,5,7,12,2022,01-21,03:43
012 Boutonnet,2,10,12,2022,01-21,03:43
013 Emile Combes,7,1,8,2022,01-21,03:43
014 Beaux-Arts,3,5,8,2022,01-21,03:43
015 Les Aubes,7,1,8,2022,01-21,03:43
016 Antigone centre,14,2,16,2022,01-21,03:43
017 M�diath�que Emile Zola,15,1,16,2022,01-21,03:43
018 Nombre d'Or,11,5,16,2022,01-21,03:43
019 Louis Blanc,14,2,16,2022,01-21,03:43
020 Gambetta,2,6,8,2022,01-21,03:43
021 Port Marianne,12,4,16,2022,01-21,03:43
022 Clemenceau,8,4,12,2022,01-21,03:43
023 Les Arceaux,3,13,16,2022,01-21,03:43
024 Cit� Mion,4,4,8,2022,01-21,03:43
025 Nouveau Saint-Roch,5,3,8,2022,01-21,03:43
026 Renouvier,3,5,8,2022,01-21,03:43
027 Odysseum,4,4,8,2022,01-21,03:43
028 Saint-Denis,5,3,8,2022,01-21,03:43
029 Richter,7,9,16,2022,01-21,03:43
030 Charles Flahault,0,8,8,2022,01-21,03:43
031 Voltaire,5,3,8,2022,01-21,03:43
032 Pr�s d'Ar�nes,4,4,8,2022,01-21,03:43
033 Garcia Lorca,8,0,8,2022,01-21,03:43
034 Vert Bois,0,16,16,2022,01-21,03:43
035 Malbosc,3,5,8,2022,01-21,03:43
036 Occitanie,5,27,32,2022,01-21,03:43
037 FacdesSciences,2,22,24,2022,01-21,03:43
038 Fac de Lettres,6,10,16,2022,01-21,03:43
039 Aiguelongue,2,6,8,2022,01-21,03:43
040 Jeu de Mail des Abb�s,3,5,8,2022,01-21,03:43
041 Eurom�decine,2,6,8,2022,01-21,03:43
042 Marie Caizergues,8,0,8,2022,01-21,03:43
043 Sabines,5,3,8,2022,01-21,03:43
044 Celleneuve,1,7,8,2022,01-21,03:43
045 Jardin de la Lironde,5,3,8,2022,01-21,03:43
046 P�re Soulas,7,1,8,2022,01-21,03:43
047 Place Viala,5,3,8,2022,01-21,03:43
048 H�tel du D�partement,5,3,8,2022,01-21,03:43
049 Tonnelles,3,5,8,2022,01-21,03:43
050 Parvis Jules Ferry - Gare Saint-Roch,6,2,8,2022,01-21,03:43
051 Pont de Lattes - Gare Saint-Roch,0,12,12,2022,01-21,03:43
053 Deux Ponts - Gare Saint-Roch,2,6,8,2022,01-21,03:43
054 Providence - Ovalie,3,5,8,2022,01-21,03:43
055 P�rols Etang de l'Or,26,42,68,2022,01-21,03:43
056 Albert 1er - Cath�drale,0,12,12,2022,01-21,03:43
057 Saint-Guilhem - Courreau,1,7,8,2022,01-21,03:43
059 Sud De France,3,5,8,2022,01-21,03:43
001 Rue Jules Ferry - Gare Saint-Roch,5,7,12,2022,01-21,03:53
002 Com�die,4,20,24,2022,01-21,03:53
003 Esplanade,0,32,32,2022,01-21,03:53
004 H�tel de Ville,8,8,16,2022,01-21,03:53
005 Corum,12,0,12,2022,01-21,03:53
006 Place Albert 1er - St Charles,23,8,31,2022,01-21,03:53
007 Foch,2,6,8,2022,01-21,03:53
008 Halles Castellane,0,12,12,2022,01-21,03:53
009 Observatoire,4,4,8,2022,01-21,03:53
010 Rondelet,1,15,16,2022,01-21,03:53
011 Plan Cabanes,4,8,12,2022,01-21,03:53
012 Boutonnet,2,10,12,2022,01-21,03:53
013 Emile Combes,7,1,8,2022,01-21,03:53
014 Beaux-Arts,3,5,8,2022,01-21,03:53
015 Les Aubes,7,1,8,2022,01-21,03:53
016 Antigone centre,14,2,16,2022,01-21,03:53
017 M�diath�que Emile Zola,15,1,16,2022,01-21,03:53
018 Nombre d'Or,11,5,16,2022,01-21,03:53
019 Louis Blanc,14,2,16,2022,01-21,03:53
020 Gambetta,2,6,8,2022,01-21,03:53
021 Port Marianne,12,4,16,2022,01-21,03:53
022 Clemenceau,8,4,12,2022,01-21,03:53
023 Les Arceaux,3,13,16,2022,01-21,03:53
024 Cit� Mion,4,4,8,2022,01-21,03:53
025 Nouveau Saint-Roch,6,2,8,2022,01-21,03:53
026 Renouvier,3,5,8,2022,01-21,03:53
027 Odysseum,4,4,8,2022,01-21,03:53
028 Saint-Denis,5,3,8,2022,01-21,03:53
029 Richter,7,9,16,2022,01-21,03:53
030 Charles Flahault,0,8,8,2022,01-21,03:53
031 Voltaire,5,3,8,2022,01-21,03:53
032 Pr�s d'Ar�nes,4,4,8,2022,01-21,03:53
033 Garcia Lorca,8,0,8,2022,01-21,03:53
034 Vert Bois,0,16,16,2022,01-21,03:53
035 Malbosc,3,5,8,2022,01-21,03:53
036 Occitanie,5,27,32,2022,01-21,03:53
037 FacdesSciences,2,22,24,2022,01-21,03:53
038 Fac de Lettres,6,10,16,2022,01-21,03:53
039 Aiguelongue,2,6,8,2022,01-21,03:53
040 Jeu de Mail des Abb�s,3,5,8,2022,01-21,03:53
041 Eurom�decine,2,6,8,2022,01-21,03:53
042 Marie Caizergues,8,0,8,2022,01-21,03:53
043 Sabines,5,3,8,2022,01-21,03:53
044 Celleneuve,1,7,8,2022,01-21,03:53
045 Jardin de la Lironde,5,3,8,2022,01-21,03:53
046 P�re Soulas,7,1,8,2022,01-21,03:53
047 Place Viala,5,3,8,2022,01-21,03:53
048 H�tel du D�partement,5,3,8,2022,01-21,03:53
049 Tonnelles,3,5,8,2022,01-21,03:53
050 Parvis Jules Ferry - Gare Saint-Roch,6,2,8,2022,01-21,03:53
051 Pont de Lattes - Gare Saint-Roch,0,12,12,2022,01-21,03:53
053 Deux Ponts - Gare Saint-Roch,2,6,8,2022,01-21,03:53
054 Providence - Ovalie,3,5,8,2022,01-21,03:53
055 P�rols Etang de l'Or,26,42,68,2022,01-21,03:53
056 Albert 1er - Cath�drale,0,12,12,2022,01-21,03:53
057 Saint-Guilhem - Courreau,1,7,8,2022,01-21,03:53
059 Sud De France,3,5,8,2022,01-21,03:53
001 Rue Jules Ferry - Gare Saint-Roch,5,7,12,2022,01-21,04:03
002 Com�die,4,20,24,2022,01-21,04:03
003 Esplanade,0,32,32,2022,01-21,04:03
004 H�tel de Ville,8,8,16,2022,01-21,04:03
005 Corum,12,0,12,2022,01-21,04:03
006 Place Albert 1er - St Charles,23,8,31,2022,01-21,04:03
007 Foch,2,6,8,2022,01-21,04:03
008 Halles Castellane,0,12,12,2022,01-21,04:03
009 Observatoire,4,4,8,2022,01-21,04:03
010 Rondelet,1,15,16,2022,01-21,04:03
011 Plan Cabanes,4,8,12,2022,01-21,04:03
012 Boutonnet,2,10,12,2022,01-21,04:03
013 Emile Combes,7,1,8,2022,01-21,04:03
014 Beaux-Arts,3,5,8,2022,01-21,04:03
015 Les Aubes,7,1,8,2022,01-21,04:03
016 Antigone centre,14,2,16,2022,01-21,04:03
017 M�diath�que Emile Zola,15,1,16,2022,01-21,04:03
018 Nombre d'Or,11,5,16,2022,01-21,04:03
019 Louis Blanc,14,2,16,2022,01-21,04:03
020 Gambetta,2,6,8,2022,01-21,04:03
021 Port Marianne,12,4,16,2022,01-21,04:03
022 Clemenceau,8,4,12,2022,01-21,04:03
023 Les Arceaux,3,13,16,2022,01-21,04:03
024 Cit� Mion,4,4,8,2022,01-21,04:03
025 Nouveau Saint-Roch,6,2,8,2022,01-21,04:03
026 Renouvier,3,5,8,2022,01-21,04:03
027 Odysseum,4,4,8,2022,01-21,04:03
028 Saint-Denis,5,3,8,2022,01-21,04:03
029 Richter,7,9,16,2022,01-21,04:03
030 Charles Flahault,0,8,8,2022,01-21,04:03
031 Voltaire,4,4,8,2022,01-21,04:03
032 Pr�s d'Ar�nes,4,4,8,2022,01-21,04:03
033 Garcia Lorca,8,0,8,2022,01-21,04:03
034 Vert Bois,0,16,16,2022,01-21,04:03
035 Malbosc,3,5,8,2022,01-21,04:03
036 Occitanie,5,27,32,2022,01-21,04:03
037 FacdesSciences,2,22,24,2022,01-21,04:03
038 Fac de Lettres,6,10,16,2022,01-21,04:03
039 Aiguelongue,2,6,8,2022,01-21,04:03
040 Jeu de Mail des Abb�s,3,5,8,2022,01-21,04:03
041 Eurom�decine,2,6,8,2022,01-21,04:03
042 Marie Caizergues,8,0,8,2022,01-21,04:03
043 Sabines,5,3,8,2022,01-21,04:03
044 Celleneuve,1,7,8,2022,01-21,04:03
045 Jardin de la Lironde,5,3,8,2022,01-21,04:03
046 P�re Soulas,7,1,8,2022,01-21,04:03
047 Place Viala,5,3,8,2022,01-21,04:03
048 H�tel du D�partement,5,3,8,2022,01-21,04:03
049 Tonnelles,3,5,8,2022,01-21,04:03
050 Parvis Jules Ferry - Gare Saint-Roch,6,2,8,2022,01-21,04:03
051 Pont de Lattes - Gare Saint-Roch,0,12,12,2022,01-21,04:03
053 Deux Ponts - Gare Saint-Roch,2,6,8,2022,01-21,04:03
054 Providence - Ovalie,3,5,8,2022,01-21,04:03
055 P�rols Etang de l'Or,26,42,68,2022,01-21,04:03
056 Albert 1er - Cath�drale,0,12,12,2022,01-21,04:03
057 Saint-Guilhem - Courreau,1,7,8,2022,01-21,04:03
059 Sud De France,3,5,8,2022,01-21,04:03
001 Rue Jules Ferry - Gare Saint-Roch,5,7,12,2022,01-21,04:14
002 Com�die,4,20,24,2022,01-21,04:14
003 Esplanade,0,32,32,2022,01-21,04:14
004 H�tel de Ville,8,8,16,2022,01-21,04:14
005 Corum,12,0,12,2022,01-21,04:14
006 Place Albert 1er - St Charles,23,8,31,2022,01-21,04:14
007 Foch,2,6,8,2022,01-21,04:14
008 Halles Castellane,0,12,12,2022,01-21,04:14
009 Observatoire,4,4,8,2022,01-21,04:14
010 Rondelet,1,15,16,2022,01-21,04:14
011 Plan Cabanes,4,8,12,2022,01-21,04:14
012 Boutonnet,3,9,12,2022,01-21,04:14
013 Emile Combes,7,1,8,2022,01-21,04:14
014 Beaux-Arts,3,5,8,2022,01-21,04:14
015 Les Aubes,7,1,8,2022,01-21,04:14
016 Antigone centre,14,2,16,2022,01-21,04:14
017 M�diath�que Emile Zola,15,1,16,2022,01-21,04:14
018 Nombre d'Or,10,6,16,2022,01-21,04:14
019 Louis Blanc,14,2,16,2022,01-21,04:14
020 Gambetta,2,6,8,2022,01-21,04:14
021 Port Marianne,12,4,16,2022,01-21,04:14
022 Clemenceau,8,4,12,2022,01-21,04:14
023 Les Arceaux,4,12,16,2022,01-21,04:14
024 Cit� Mion,4,4,8,2022,01-21,04:14
025 Nouveau Saint-Roch,6,2,8,2022,01-21,04:14
026 Renouvier,3,5,8,2022,01-21,04:14
027 Odysseum,4,4,8,2022,01-21,04:14
028 Saint-Denis,5,3,8,2022,01-21,04:14
029 Richter,7,9,16,2022,01-21,04:14
030 Charles Flahault,0,8,8,2022,01-21,04:14
031 Voltaire,4,4,8,2022,01-21,04:14
032 Pr�s d'Ar�nes,4,4,8,2022,01-21,04:14
033 Garcia Lorca,8,0,8,2022,01-21,04:14
034 Vert Bois,0,16,16,2022,01-21,04:14
035 Malbosc,3,5,8,2022,01-21,04:14
036 Occitanie,5,27,32,2022,01-21,04:14
037 FacdesSciences,2,22,24,2022,01-21,04:14
038 Fac de Lettres,6,10,16,2022,01-21,04:14
039 Aiguelongue,2,6,8,2022,01-21,04:14
040 Jeu de Mail des Abb�s,3,5,8,2022,01-21,04:14
041 Eurom�decine,2,6,8,2022,01-21,04:14
042 Marie Caizergues,6,2,8,2022,01-21,04:14
043 Sabines,5,3,8,2022,01-21,04:14
044 Celleneuve,1,7,8,2022,01-21,04:14
045 Jardin de la Lironde,5,3,8,2022,01-21,04:14
046 P�re Soulas,7,1,8,2022,01-21,04:14
047 Place Viala,5,3,8,2022,01-21,04:14
048 H�tel du D�partement,5,3,8,2022,01-21,04:14
049 Tonnelles,3,5,8,2022,01-21,04:14
050 Parvis Jules Ferry - Gare Saint-Roch,7,1,8,2022,01-21,04:14
051 Pont de Lattes - Gare Saint-Roch,0,12,12,2022,01-21,04:14
053 Deux Ponts - Gare Saint-Roch,2,6,8,2022,01-21,04:14
054 Providence - Ovalie,3,5,8,2022,01-21,04:14
055 P�rols Etang de l'Or,26,42,68,2022,01-21,04:14
056 Albert 1er - Cath�drale,0,12,12,2022,01-21,04:14
057 Saint-Guilhem - Courreau,1,7,8,2022,01-21,04:14
059 Sud De France,3,5,8,2022,01-21,04:14
001 Rue Jules Ferry - Gare Saint-Roch,5,7,12,2022,01-21,04:24
002 Com�die,4,20,24,2022,01-21,04:24
003 Esplanade,0,32,32,2022,01-21,04:24
004 H�tel de Ville,8,8,16,2022,01-21,04:24
005 Corum,12,0,12,2022,01-21,04:24
006 Place Albert 1er - St Charles,23,8,31,2022,01-21,04:24
007 Foch,2,6,8,2022,01-21,04:24
008 Halles Castellane,0,12,12,2022,01-21,04:24
009 Observatoire,4,4,8,2022,01-21,04:24
010 Rondelet,1,15,16,2022,01-21,04:24
011 Plan Cabanes,4,8,12,2022,01-21,04:24
012 Boutonnet,3,9,12,2022,01-21,04:24
013 Emile Combes,7,1,8,2022,01-21,04:24
014 Beaux-Arts,3,5,8,2022,01-21,04:24
015 Les Aubes,7,1,8,2022,01-21,04:24
016 Antigone centre,14,2,16,2022,01-21,04:24
017 M�diath�que Emile Zola,15,1,16,2022,01-21,04:24
018 Nombre d'Or,10,6,16,2022,01-21,04:24
019 Louis Blanc,15,1,16,2022,01-21,04:24
020 Gambetta,2,6,8,2022,01-21,04:24
021 Port Marianne,12,4,16,2022,01-21,04:24
022 Clemenceau,8,4,12,2022,01-21,04:24
023 Les Arceaux,4,12,16,2022,01-21,04:24
024 Cit� Mion,4,4,8,2022,01-21,04:24
025 Nouveau Saint-Roch,6,2,8,2022,01-21,04:24
026 Renouvier,3,5,8,2022,01-21,04:24
027 Odysseum,4,4,8,2022,01-21,04:24
028 Saint-Denis,5,3,8,2022,01-21,04:24
029 Richter,7,9,16,2022,01-21,04:24
030 Charles Flahault,0,8,8,2022,01-21,04:24
031 Voltaire,4,4,8,2022,01-21,04:24
032 Pr�s d'Ar�nes,4,4,8,2022,01-21,04:24
033 Garcia Lorca,8,0,8,2022,01-21,04:24
034 Vert Bois,0,16,16,2022,01-21,04:24
035 Malbosc,3,5,8,2022,01-21,04:24
036 Occitanie,5,27,32,2022,01-21,04:24
037 FacdesSciences,2,22,24,2022,01-21,04:24
038 Fac de Lettres,6,10,16,2022,01-21,04:24
039 Aiguelongue,2,6,8,2022,01-21,04:24
040 Jeu de Mail des Abb�s,3,5,8,2022,01-21,04:24
041 Eurom�decine,2,6,8,2022,01-21,04:24
042 Marie Caizergues,6,2,8,2022,01-21,04:24
043 Sabines,5,3,8,2022,01-21,04:24
044 Celleneuve,1,7,8,2022,01-21,04:24
045 Jardin de la Lironde,5,3,8,2022,01-21,04:24
046 P�re Soulas,7,1,8,2022,01-21,04:24
047 Place Viala,5,3,8,2022,01-21,04:24
048 H�tel du D�partement,5,3,8,2022,01-21,04:24
049 Tonnelles,3,5,8,2022,01-21,04:24
050 Parvis Jules Ferry - Gare Saint-Roch,7,1,8,2022,01-21,04:24
051 Pont de Lattes - Gare Saint-Roch,0,12,12,2022,01-21,04:24
053 Deux Ponts - Gare Saint-Roch,2,6,8,2022,01-21,04:24
054 Providence - Ovalie,3,5,8,2022,01-21,04:24
055 P�rols Etang de l'Or,26,42,68,2022,01-21,04:24
056 Albert 1er - Cath�drale,0,12,12,2022,01-21,04:24
057 Saint-Guilhem - Courreau,1,7,8,2022,01-21,04:24
059 Sud De France,3,5,8,2022,01-21,04:24
001 Rue Jules Ferry - Gare Saint-Roch,5,7,12,2022,01-21,04:34
002 Com�die,4,20,24,2022,01-21,04:34
003 Esplanade,0,32,32,2022,01-21,04:34
004 H�tel de Ville,8,8,16,2022,01-21,04:34
005 Corum,12,0,12,2022,01-21,04:34
006 Place Albert 1er - St Charles,23,8,31,2022,01-21,04:34
007 Foch,2,6,8,2022,01-21,04:34
008 Halles Castellane,0,12,12,2022,01-21,04:34
009 Observatoire,4,4,8,2022,01-21,04:34
010 Rondelet,1,15,16,2022,01-21,04:34
011 Plan Cabanes,4,8,12,2022,01-21,04:34
012 Boutonnet,3,9,12,2022,01-21,04:34
013 Emile Combes,7,1,8,2022,01-21,04:34
014 Beaux-Arts,3,5,8,2022,01-21,04:34
015 Les Aubes,7,1,8,2022,01-21,04:34
016 Antigone centre,14,2,16,2022,01-21,04:34
017 M�diath�que Emile Zola,15,1,16,2022,01-21,04:34
018 Nombre d'Or,10,6,16,2022,01-21,04:34
019 Louis Blanc,15,1,16,2022,01-21,04:34
020 Gambetta,2,6,8,2022,01-21,04:34
021 Port Marianne,12,4,16,2022,01-21,04:34
022 Clemenceau,8,4,12,2022,01-21,04:34
023 Les Arceaux,4,12,16,2022,01-21,04:34
024 Cit� Mion,4,4,8,2022,01-21,04:34
025 Nouveau Saint-Roch,6,2,8,2022,01-21,04:34
026 Renouvier,3,5,8,2022,01-21,04:34
027 Odysseum,4,4,8,2022,01-21,04:34
028 Saint-Denis,5,3,8,2022,01-21,04:34
029 Richter,7,9,16,2022,01-21,04:34
030 Charles Flahault,0,8,8,2022,01-21,04:34
031 Voltaire,4,4,8,2022,01-21,04:34
032 Pr�s d'Ar�nes,4,4,8,2022,01-21,04:34
033 Garcia Lorca,8,0,8,2022,01-21,04:34
034 Vert Bois,0,16,16,2022,01-21,04:34
035 Malbosc,3,5,8,2022,01-21,04:34
036 Occitanie,5,27,32,2022,01-21,04:34
037 FacdesSciences,2,22,24,2022,01-21,04:34
038 Fac de Lettres,6,10,16,2022,01-21,04:34
039 Aiguelongue,2,6,8,2022,01-21,04:34
040 Jeu de Mail des Abb�s,3,5,8,2022,01-21,04:34
041 Eurom�decine,2,6,8,2022,01-21,04:34
042 Marie Caizergues,7,1,8,2022,01-21,04:34
043 Sabines,5,3,8,2022,01-21,04:34
044 Celleneuve,1,7,8,2022,01-21,04:34
045 Jardin de la Lironde,5,3,8,2022,01-21,04:34
046 P�re Soulas,7,1,8,2022,01-21,04:34
047 Place Viala,5,3,8,2022,01-21,04:34
048 H�tel du D�partement,5,3,8,2022,01-21,04:34
049 Tonnelles,3,5,8,2022,01-21,04:34
050 Parvis Jules Ferry - Gare Saint-Roch,7,1,8,2022,01-21,04:34
051 Pont de Lattes - Gare Saint-Roch,0,12,12,2022,01-21,04:34
053 Deux Ponts - Gare Saint-Roch,2,6,8,2022,01-21,04:34
054 Providence - Ovalie,3,5,8,2022,01-21,04:34
055 P�rols Etang de l'Or,26,42,68,2022,01-21,04:34
056 Albert 1er - Cath�drale,0,12,12,2022,01-21,04:34
057 Saint-Guilhem - Courreau,1,7,8,2022,01-21,04:34
059 Sud De France,3,5,8,2022,01-21,04:34
001 Rue Jules Ferry - Gare Saint-Roch,5,7,12,2022,01-21,04:44
002 Com�die,4,20,24,2022,01-21,04:44
003 Esplanade,0,32,32,2022,01-21,04:44
004 H�tel de Ville,8,8,16,2022,01-21,04:44
005 Corum,12,0,12,2022,01-21,04:44
006 Place Albert 1er - St Charles,23,8,31,2022,01-21,04:44
007 Foch,2,6,8,2022,01-21,04:44
008 Halles Castellane,0,12,12,2022,01-21,04:44
009 Observatoire,4,4,8,2022,01-21,04:44
010 Rondelet,1,15,16,2022,01-21,04:44
011 Plan Cabanes,4,8,12,2022,01-21,04:44
012 Boutonnet,3,9,12,2022,01-21,04:44
013 Emile Combes,7,1,8,2022,01-21,04:44
014 Beaux-Arts,3,5,8,2022,01-21,04:44
015 Les Aubes,7,1,8,2022,01-21,04:44
016 Antigone centre,14,2,16,2022,01-21,04:44
017 M�diath�que Emile Zola,15,1,16,2022,01-21,04:44
018 Nombre d'Or,10,6,16,2022,01-21,04:44
019 Louis Blanc,15,1,16,2022,01-21,04:44
020 Gambetta,2,6,8,2022,01-21,04:44
021 Port Marianne,12,4,16,2022,01-21,04:44
022 Clemenceau,8,4,12,2022,01-21,04:44
023 Les Arceaux,4,12,16,2022,01-21,04:44
024 Cit� Mion,4,4,8,2022,01-21,04:44
025 Nouveau Saint-Roch,6,2,8,2022,01-21,04:44
026 Renouvier,3,5,8,2022,01-21,04:44
027 Odysseum,4,4,8,2022,01-21,04:44
028 Saint-Denis,5,3,8,2022,01-21,04:44
029 Richter,7,9,16,2022,01-21,04:44
030 Charles Flahault,0,8,8,2022,01-21,04:44
031 Voltaire,4,4,8,2022,01-21,04:44
032 Pr�s d'Ar�nes,4,4,8,2022,01-21,04:44
033 Garcia Lorca,8,0,8,2022,01-21,04:44
034 Vert Bois,0,16,16,2022,01-21,04:44
035 Malbosc,3,5,8,2022,01-21,04:44
036 Occitanie,5,27,32,2022,01-21,04:44
037 FacdesSciences,2,22,24,2022,01-21,04:44
038 Fac de Lettres,6,10,16,2022,01-21,04:44
039 Aiguelongue,2,6,8,2022,01-21,04:44
040 Jeu de Mail des Abb�s,3,5,8,2022,01-21,04:44
041 Eurom�decine,2,6,8,2022,01-21,04:44
042 Marie Caizergues,7,1,8,2022,01-21,04:44
043 Sabines,5,3,8,2022,01-21,04:44
044 Celleneuve,1,7,8,2022,01-21,04:44
045 Jardin de la Lironde,5,3,8,2022,01-21,04:44
046 P�re Soulas,7,1,8,2022,01-21,04:44
047 Place Viala,5,3,8,2022,01-21,04:44
048 H�tel du D�partement,5,3,8,2022,01-21,04:44
049 Tonnelles,3,5,8,2022,01-21,04:44
050 Parvis Jules Ferry - Gare Saint-Roch,7,1,8,2022,01-21,04:44
051 Pont de Lattes - Gare Saint-Roch,0,12,12,2022,01-21,04:44
053 Deux Ponts - Gare Saint-Roch,2,6,8,2022,01-21,04:44
054 Providence - Ovalie,3,5,8,2022,01-21,04:44
055 P�rols Etang de l'Or,26,42,68,2022,01-21,04:44
056 Albert 1er - Cath�drale,0,12,12,2022,01-21,04:44
057 Saint-Guilhem - Courreau,1,7,8,2022,01-21,04:44
059 Sud De France,3,5,8,2022,01-21,04:44
001 Rue Jules Ferry - Gare Saint-Roch,5,7,12,2022,01-21,04:54
002 Com�die,4,20,24,2022,01-21,04:54
003 Esplanade,0,32,32,2022,01-21,04:54
004 H�tel de Ville,8,8,16,2022,01-21,04:54
005 Corum,12,0,12,2022,01-21,04:54
006 Place Albert 1er - St Charles,23,8,31,2022,01-21,04:54
007 Foch,2,6,8,2022,01-21,04:54
008 Halles Castellane,0,12,12,2022,01-21,04:54
009 Observatoire,4,4,8,2022,01-21,04:54
010 Rondelet,1,15,16,2022,01-21,04:54
011 Plan Cabanes,4,8,12,2022,01-21,04:54
012 Boutonnet,3,9,12,2022,01-21,04:54
013 Emile Combes,7,1,8,2022,01-21,04:54
014 Beaux-Arts,3,5,8,2022,01-21,04:54
015 Les Aubes,7,1,8,2022,01-21,04:54
016 Antigone centre,14,2,16,2022,01-21,04:54
017 M�diath�que Emile Zola,15,1,16,2022,01-21,04:54
018 Nombre d'Or,10,6,16,2022,01-21,04:54
019 Louis Blanc,15,1,16,2022,01-21,04:54
020 Gambetta,2,6,8,2022,01-21,04:54
021 Port Marianne,11,5,16,2022,01-21,04:54
022 Clemenceau,8,4,12,2022,01-21,04:54
023 Les Arceaux,4,12,16,2022,01-21,04:54
024 Cit� Mion,4,4,8,2022,01-21,04:54
025 Nouveau Saint-Roch,6,2,8,2022,01-21,04:54
026 Renouvier,3,5,8,2022,01-21,04:54
027 Odysseum,4,4,8,2022,01-21,04:54
028 Saint-Denis,5,3,8,2022,01-21,04:54
029 Richter,7,9,16,2022,01-21,04:54
030 Charles Flahault,0,8,8,2022,01-21,04:54
031 Voltaire,4,4,8,2022,01-21,04:54
032 Pr�s d'Ar�nes,4,4,8,2022,01-21,04:54
033 Garcia Lorca,8,0,8,2022,01-21,04:54
034 Vert Bois,0,16,16,2022,01-21,04:54
035 Malbosc,3,5,8,2022,01-21,04:54
036 Occitanie,5,27,32,2022,01-21,04:54
037 FacdesSciences,2,22,24,2022,01-21,04:54
038 Fac de Lettres,6,10,16,2022,01-21,04:54
039 Aiguelongue,2,6,8,2022,01-21,04:54
040 Jeu de Mail des Abb�s,3,5,8,2022,01-21,04:54
041 Eurom�decine,2,6,8,2022,01-21,04:54
042 Marie Caizergues,7,1,8,2022,01-21,04:54
043 Sabines,5,3,8,2022,01-21,04:54
044 Celleneuve,1,7,8,2022,01-21,04:54
045 Jardin de la Lironde,5,3,8,2022,01-21,04:54
046 P�re Soulas,7,1,8,2022,01-21,04:54
047 Place Viala,5,3,8,2022,01-21,04:54
048 H�tel du D�partement,5,3,8,2022,01-21,04:54
049 Tonnelles,3,5,8,2022,01-21,04:54
050 Parvis Jules Ferry - Gare Saint-Roch,7,1,8,2022,01-21,04:54
051 Pont de Lattes - Gare Saint-Roch,0,12,12,2022,01-21,04:54
053 Deux Ponts - Gare Saint-Roch,2,6,8,2022,01-21,04:54
054 Providence - Ovalie,3,5,8,2022,01-21,04:54
055 P�rols Etang de l'Or,26,42,68,2022,01-21,04:54
056 Albert 1er - Cath�drale,0,12,12,2022,01-21,04:54
057 Saint-Guilhem - Courreau,1,7,8,2022,01-21,04:54
059 Sud De France,3,5,8,2022,01-21,04:54
001 Rue Jules Ferry - Gare Saint-Roch,5,7,12,2022,01-21,05:04
002 Com�die,4,20,24,2022,01-21,05:04
003 Esplanade,0,32,32,2022,01-21,05:04
004 H�tel de Ville,8,8,16,2022,01-21,05:04
005 Corum,12,0,12,2022,01-21,05:04
006 Place Albert 1er - St Charles,23,8,31,2022,01-21,05:04
007 Foch,2,6,8,2022,01-21,05:04
008 Halles Castellane,0,12,12,2022,01-21,05:04
009 Observatoire,4,4,8,2022,01-21,05:04
010 Rondelet,1,15,16,2022,01-21,05:04
011 Plan Cabanes,4,8,12,2022,01-21,05:04
012 Boutonnet,3,9,12,2022,01-21,05:04
013 Emile Combes,7,1,8,2022,01-21,05:04
014 Beaux-Arts,3,5,8,2022,01-21,05:04
015 Les Aubes,7,1,8,2022,01-21,05:04
016 Antigone centre,14,2,16,2022,01-21,05:04
017 M�diath�que Emile Zola,15,1,16,2022,01-21,05:04
018 Nombre d'Or,10,6,16,2022,01-21,05:04
019 Louis Blanc,15,1,16,2022,01-21,05:04
020 Gambetta,2,6,8,2022,01-21,05:04
021 Port Marianne,11,5,16,2022,01-21,05:04
022 Clemenceau,8,4,12,2022,01-21,05:04
023 Les Arceaux,4,12,16,2022,01-21,05:04
024 Cit� Mion,4,4,8,2022,01-21,05:04
025 Nouveau Saint-Roch,6,2,8,2022,01-21,05:04
026 Renouvier,3,5,8,2022,01-21,05:04
027 Odysseum,4,4,8,2022,01-21,05:04
028 Saint-Denis,5,3,8,2022,01-21,05:04
029 Richter,7,9,16,2022,01-21,05:04
030 Charles Flahault,0,8,8,2022,01-21,05:04
031 Voltaire,4,4,8,2022,01-21,05:04
032 Pr�s d'Ar�nes,4,4,8,2022,01-21,05:04
033 Garcia Lorca,8,0,8,2022,01-21,05:04
034 Vert Bois,0,16,16,2022,01-21,05:04
035 Malbosc,3,5,8,2022,01-21,05:04
036 Occitanie,5,27,32,2022,01-21,05:04
037 FacdesSciences,2,22,24,2022,01-21,05:04
038 Fac de Lettres,6,10,16,2022,01-21,05:04
039 Aiguelongue,2,6,8,2022,01-21,05:04
040 Jeu de Mail des Abb�s,3,5,8,2022,01-21,05:04
041 Eurom�decine,2,6,8,2022,01-21,05:04
042 Marie Caizergues,7,1,8,2022,01-21,05:04
043 Sabines,5,3,8,2022,01-21,05:04
044 Celleneuve,1,7,8,2022,01-21,05:04
045 Jardin de la Lironde,5,3,8,2022,01-21,05:04
046 P�re Soulas,7,1,8,2022,01-21,05:04
047 Place Viala,5,3,8,2022,01-21,05:04
048 H�tel du D�partement,5,3,8,2022,01-21,05:04
049 Tonnelles,3,5,8,2022,01-21,05:04
050 Parvis Jules Ferry - Gare Saint-Roch,7,1,8,2022,01-21,05:04
051 Pont de Lattes - Gare Saint-Roch,0,12,12,2022,01-21,05:04
053 Deux Ponts - Gare Saint-Roch,2,6,8,2022,01-21,05:04
054 Providence - Ovalie,3,5,8,2022,01-21,05:04
055 P�rols Etang de l'Or,26,42,68,2022,01-21,05:04
056 Albert 1er - Cath�drale,0,12,12,2022,01-21,05:04
057 Saint-Guilhem - Courreau,1,7,8,2022,01-21,05:04
059 Sud De France,3,5,8,2022,01-21,05:04
001 Rue Jules Ferry - Gare Saint-Roch,5,7,12,2022,01-21,05:15
002 Com�die,4,20,24,2022,01-21,05:15
003 Esplanade,0,32,32,2022,01-21,05:15
004 H�tel de Ville,8,8,16,2022,01-21,05:15
005 Corum,12,0,12,2022,01-21,05:15
006 Place Albert 1er - St Charles,23,8,31,2022,01-21,05:15
007 Foch,2,6,8,2022,01-21,05:15
008 Halles Castellane,0,12,12,2022,01-21,05:15
009 Observatoire,4,4,8,2022,01-21,05:15
010 Rondelet,1,15,16,2022,01-21,05:15
011 Plan Cabanes,4,8,12,2022,01-21,05:15
012 Boutonnet,3,9,12,2022,01-21,05:15
013 Emile Combes,7,1,8,2022,01-21,05:15
014 Beaux-Arts,3,5,8,2022,01-21,05:15
015 Les Aubes,7,1,8,2022,01-21,05:15
016 Antigone centre,14,2,16,2022,01-21,05:15
017 M�diath�que Emile Zola,15,1,16,2022,01-21,05:15
018 Nombre d'Or,10,6,16,2022,01-21,05:15
019 Louis Blanc,15,1,16,2022,01-21,05:15
020 Gambetta,2,6,8,2022,01-21,05:15
021 Port Marianne,11,5,16,2022,01-21,05:15
022 Clemenceau,8,4,12,2022,01-21,05:15
023 Les Arceaux,4,12,16,2022,01-21,05:15
024 Cit� Mion,4,4,8,2022,01-21,05:15
025 Nouveau Saint-Roch,6,2,8,2022,01-21,05:15
026 Renouvier,3,5,8,2022,01-21,05:15
027 Odysseum,4,4,8,2022,01-21,05:15
028 Saint-Denis,5,3,8,2022,01-21,05:15
029 Richter,7,9,16,2022,01-21,05:15
030 Charles Flahault,0,8,8,2022,01-21,05:15
031 Voltaire,4,4,8,2022,01-21,05:15
032 Pr�s d'Ar�nes,4,4,8,2022,01-21,05:15
033 Garcia Lorca,8,0,8,2022,01-21,05:15
034 Vert Bois,0,16,16,2022,01-21,05:15
035 Malbosc,3,5,8,2022,01-21,05:15
036 Occitanie,5,27,32,2022,01-21,05:15
037 FacdesSciences,2,22,24,2022,01-21,05:15
038 Fac de Lettres,6,10,16,2022,01-21,05:15
039 Aiguelongue,2,6,8,2022,01-21,05:15
040 Jeu de Mail des Abb�s,3,5,8,2022,01-21,05:15
041 Eurom�decine,2,6,8,2022,01-21,05:15
042 Marie Caizergues,7,1,8,2022,01-21,05:15
043 Sabines,5,3,8,2022,01-21,05:15
044 Celleneuve,1,7,8,2022,01-21,05:15
045 Jardin de la Lironde,5,3,8,2022,01-21,05:15
046 P�re Soulas,7,1,8,2022,01-21,05:15
047 Place Viala,5,3,8,2022,01-21,05:15
048 H�tel du D�partement,5,3,8,2022,01-21,05:15
049 Tonnelles,3,5,8,2022,01-21,05:15
050 Parvis Jules Ferry - Gare Saint-Roch,7,1,8,2022,01-21,05:15
051 Pont de Lattes - Gare Saint-Roch,0,12,12,2022,01-21,05:15
053 Deux Ponts - Gare Saint-Roch,2,6,8,2022,01-21,05:15
054 Providence - Ovalie,3,5,8,2022,01-21,05:15
055 P�rols Etang de l'Or,26,42,68,2022,01-21,05:15
056 Albert 1er - Cath�drale,0,12,12,2022,01-21,05:15
057 Saint-Guilhem - Courreau,1,7,8,2022,01-21,05:15
059 Sud De France,3,5,8,2022,01-21,05:15
001 Rue Jules Ferry - Gare Saint-Roch,5,7,12,2022,01-21,05:25
002 Com�die,4,20,24,2022,01-21,05:25
003 Esplanade,0,32,32,2022,01-21,05:25
004 H�tel de Ville,8,8,16,2022,01-21,05:25
005 Corum,12,0,12,2022,01-21,05:25
006 Place Albert 1er - St Charles,23,8,31,2022,01-21,05:25
007 Foch,2,6,8,2022,01-21,05:25
008 Halles Castellane,0,12,12,2022,01-21,05:25
009 Observatoire,4,4,8,2022,01-21,05:25
010 Rondelet,1,15,16,2022,01-21,05:25
011 Plan Cabanes,4,8,12,2022,01-21,05:25
012 Boutonnet,3,9,12,2022,01-21,05:25
013 Emile Combes,7,1,8,2022,01-21,05:25
014 Beaux-Arts,3,5,8,2022,01-21,05:25
015 Les Aubes,7,1,8,2022,01-21,05:25
016 Antigone centre,14,2,16,2022,01-21,05:25
017 M�diath�que Emile Zola,14,2,16,2022,01-21,05:25
018 Nombre d'Or,10,6,16,2022,01-21,05:25
019 Louis Blanc,15,1,16,2022,01-21,05:25
020 Gambetta,2,6,8,2022,01-21,05:25
021 Port Marianne,11,5,16,2022,01-21,05:25
022 Clemenceau,8,4,12,2022,01-21,05:25
023 Les Arceaux,4,12,16,2022,01-21,05:25
024 Cit� Mion,4,4,8,2022,01-21,05:25
025 Nouveau Saint-Roch,6,2,8,2022,01-21,05:25
026 Renouvier,3,5,8,2022,01-21,05:25
027 Odysseum,4,4,8,2022,01-21,05:25
028 Saint-Denis,5,3,8,2022,01-21,05:25
029 Richter,7,9,16,2022,01-21,05:25
030 Charles Flahault,0,8,8,2022,01-21,05:25
031 Voltaire,4,4,8,2022,01-21,05:25
032 Pr�s d'Ar�nes,4,4,8,2022,01-21,05:25
033 Garcia Lorca,8,0,8,2022,01-21,05:25
034 Vert Bois,0,16,16,2022,01-21,05:25
035 Malbosc,3,5,8,2022,01-21,05:25
036 Occitanie,5,27,32,2022,01-21,05:25
037 FacdesSciences,2,22,24,2022,01-21,05:25
038 Fac de Lettres,6,10,16,2022,01-21,05:25
039 Aiguelongue,2,6,8,2022,01-21,05:25
040 Jeu de Mail des Abb�s,3,5,8,2022,01-21,05:25
041 Eurom�decine,2,6,8,2022,01-21,05:25
042 Marie Caizergues,7,1,8,2022,01-21,05:25
043 Sabines,5,3,8,2022,01-21,05:25
044 Celleneuve,1,7,8,2022,01-21,05:25
045 Jardin de la Lironde,5,3,8,2022,01-21,05:25
046 P�re Soulas,7,1,8,2022,01-21,05:25
047 Place Viala,5,3,8,2022,01-21,05:25
048 H�tel du D�partement,5,3,8,2022,01-21,05:25
049 Tonnelles,3,5,8,2022,01-21,05:25
050 Parvis Jules Ferry - Gare Saint-Roch,7,1,8,2022,01-21,05:25
051 Pont de Lattes - Gare Saint-Roch,0,12,12,2022,01-21,05:25
053 Deux Ponts - Gare Saint-Roch,2,6,8,2022,01-21,05:25
054 Providence - Ovalie,3,5,8,2022,01-21,05:25
055 P�rols Etang de l'Or,26,42,68,2022,01-21,05:25
056 Albert 1er - Cath�drale,0,12,12,2022,01-21,05:25
057 Saint-Guilhem - Courreau,1,7,8,2022,01-21,05:25
059 Sud De France,3,5,8,2022,01-21,05:25
001 Rue Jules Ferry - Gare Saint-Roch,5,7,12,2022,01-21,05:35
002 Com�die,4,20,24,2022,01-21,05:35
003 Esplanade,0,32,32,2022,01-21,05:35
004 H�tel de Ville,8,8,16,2022,01-21,05:35
005 Corum,12,0,12,2022,01-21,05:35
006 Place Albert 1er - St Charles,23,8,31,2022,01-21,05:35
007 Foch,2,6,8,2022,01-21,05:35
008 Halles Castellane,0,12,12,2022,01-21,05:35
009 Observatoire,4,4,8,2022,01-21,05:35
010 Rondelet,1,15,16,2022,01-21,05:35
011 Plan Cabanes,4,8,12,2022,01-21,05:35
012 Boutonnet,3,9,12,2022,01-21,05:35
013 Emile Combes,7,1,8,2022,01-21,05:35
014 Beaux-Arts,3,5,8,2022,01-21,05:35
015 Les Aubes,7,1,8,2022,01-21,05:35
016 Antigone centre,14,2,16,2022,01-21,05:35
017 M�diath�que Emile Zola,14,2,16,2022,01-21,05:35
018 Nombre d'Or,10,6,16,2022,01-21,05:35
019 Louis Blanc,15,1,16,2022,01-21,05:35
020 Gambetta,2,6,8,2022,01-21,05:35
021 Port Marianne,11,5,16,2022,01-21,05:35
022 Clemenceau,8,4,12,2022,01-21,05:35
023 Les Arceaux,4,12,16,2022,01-21,05:35
024 Cit� Mion,4,4,8,2022,01-21,05:35
025 Nouveau Saint-Roch,6,2,8,2022,01-21,05:35
026 Renouvier,3,5,8,2022,01-21,05:35
027 Odysseum,4,4,8,2022,01-21,05:35
028 Saint-Denis,5,3,8,2022,01-21,05:35
029 Richter,7,9,16,2022,01-21,05:35
030 Charles Flahault,0,8,8,2022,01-21,05:35
031 Voltaire,4,4,8,2022,01-21,05:35
032 Pr�s d'Ar�nes,4,4,8,2022,01-21,05:35
033 Garcia Lorca,8,0,8,2022,01-21,05:35
034 Vert Bois,0,16,16,2022,01-21,05:35
035 Malbosc,3,5,8,2022,01-21,05:35
036 Occitanie,5,27,32,2022,01-21,05:35
037 FacdesSciences,2,22,24,2022,01-21,05:35
038 Fac de Lettres,6,10,16,2022,01-21,05:35
039 Aiguelongue,2,6,8,2022,01-21,05:35
040 Jeu de Mail des Abb�s,3,5,8,2022,01-21,05:35
041 Eurom�decine,2,6,8,2022,01-21,05:35
042 Marie Caizergues,7,1,8,2022,01-21,05:35
043 Sabines,5,3,8,2022,01-21,05:35
044 Celleneuve,1,7,8,2022,01-21,05:35
045 Jardin de la Lironde,5,3,8,2022,01-21,05:35
046 P�re Soulas,7,1,8,2022,01-21,05:35
047 Place Viala,5,3,8,2022,01-21,05:35
048 H�tel du D�partement,5,3,8,2022,01-21,05:35
049 Tonnelles,3,5,8,2022,01-21,05:35
050 Parvis Jules Ferry - Gare Saint-Roch,7,1,8,2022,01-21,05:35
051 Pont de Lattes - Gare Saint-Roch,0,12,12,2022,01-21,05:35
053 Deux Ponts - Gare Saint-Roch,2,6,8,2022,01-21,05:35
054 Providence - Ovalie,3,5,8,2022,01-21,05:35
055 P�rols Etang de l'Or,26,42,68,2022,01-21,05:35
056 Albert 1er - Cath�drale,0,12,12,2022,01-21,05:35
057 Saint-Guilhem - Courreau,1,7,8,2022,01-21,05:35
059 Sud De France,3,5,8,2022,01-21,05:35
001 Rue Jules Ferry - Gare Saint-Roch,5,7,12,2022,01-21,05:45
002 Com�die,4,20,24,2022,01-21,05:45
003 Esplanade,0,32,32,2022,01-21,05:45
004 H�tel de Ville,8,8,16,2022,01-21,05:45
005 Corum,12,0,12,2022,01-21,05:45
006 Place Albert 1er - St Charles,23,8,31,2022,01-21,05:45
007 Foch,2,6,8,2022,01-21,05:45
008 Halles Castellane,0,12,12,2022,01-21,05:45
009 Observatoire,4,4,8,2022,01-21,05:45
010 Rondelet,1,15,16,2022,01-21,05:45
011 Plan Cabanes,4,8,12,2022,01-21,05:45
012 Boutonnet,3,9,12,2022,01-21,05:45
013 Emile Combes,7,1,8,2022,01-21,05:45
014 Beaux-Arts,3,5,8,2022,01-21,05:45
015 Les Aubes,7,1,8,2022,01-21,05:45
016 Antigone centre,14,2,16,2022,01-21,05:45
017 M�diath�que Emile Zola,14,2,16,2022,01-21,05:45
018 Nombre d'Or,10,6,16,2022,01-21,05:45
019 Louis Blanc,15,1,16,2022,01-21,05:45
020 Gambetta,2,6,8,2022,01-21,05:45
021 Port Marianne,11,5,16,2022,01-21,05:45
022 Clemenceau,8,4,12,2022,01-21,05:45
023 Les Arceaux,4,12,16,2022,01-21,05:45
024 Cit� Mion,4,4,8,2022,01-21,05:45
025 Nouveau Saint-Roch,6,2,8,2022,01-21,05:45
026 Renouvier,3,5,8,2022,01-21,05:45
027 Odysseum,4,4,8,2022,01-21,05:45
028 Saint-Denis,5,3,8,2022,01-21,05:45
029 Richter,7,9,16,2022,01-21,05:45
030 Charles Flahault,0,8,8,2022,01-21,05:45
031 Voltaire,4,4,8,2022,01-21,05:45
032 Pr�s d'Ar�nes,4,4,8,2022,01-21,05:45
033 Garcia Lorca,8,0,8,2022,01-21,05:45
034 Vert Bois,0,16,16,2022,01-21,05:45
035 Malbosc,3,5,8,2022,01-21,05:45
036 Occitanie,5,27,32,2022,01-21,05:45
037 FacdesSciences,2,22,24,2022,01-21,05:45
038 Fac de Lettres,6,10,16,2022,01-21,05:45
039 Aiguelongue,1,7,8,2022,01-21,05:45
040 Jeu de Mail des Abb�s,3,5,8,2022,01-21,05:45
041 Eurom�decine,2,6,8,2022,01-21,05:45
042 Marie Caizergues,8,0,8,2022,01-21,05:45
043 Sabines,5,3,8,2022,01-21,05:45
044 Celleneuve,1,7,8,2022,01-21,05:45
045 Jardin de la Lironde,5,3,8,2022,01-21,05:45
046 P�re Soulas,7,1,8,2022,01-21,05:45
047 Place Viala,5,3,8,2022,01-21,05:45
048 H�tel du D�partement,5,3,8,2022,01-21,05:45
049 Tonnelles,3,5,8,2022,01-21,05:45
050 Parvis Jules Ferry - Gare Saint-Roch,7,1,8,2022,01-21,05:45
051 Pont de Lattes - Gare Saint-Roch,0,12,12,2022,01-21,05:45
053 Deux Ponts - Gare Saint-Roch,2,6,8,2022,01-21,05:45
054 Providence - Ovalie,3,5,8,2022,01-21,05:45
055 P�rols Etang de l'Or,26,42,68,2022,01-21,05:45
056 Albert 1er - Cath�drale,0,12,12,2022,01-21,05:45
057 Saint-Guilhem - Courreau,1,7,8,2022,01-21,05:45
059 Sud De France,3,5,8,2022,01-21,05:45
001 Rue Jules Ferry - Gare Saint-Roch,5,7,12,2022,01-21,05:55
002 Com�die,4,20,24,2022,01-21,05:55
003 Esplanade,0,32,32,2022,01-21,05:55
004 H�tel de Ville,8,8,16,2022,01-21,05:55
005 Corum,12,0,12,2022,01-21,05:55
006 Place Albert 1er - St Charles,23,8,31,2022,01-21,05:55
007 Foch,2,6,8,2022,01-21,05:55
008 Halles Castellane,0,12,12,2022,01-21,05:55
009 Observatoire,4,4,8,2022,01-21,05:55
010 Rondelet,1,15,16,2022,01-21,05:55
011 Plan Cabanes,4,8,12,2022,01-21,05:55
012 Boutonnet,3,9,12,2022,01-21,05:55
013 Emile Combes,7,1,8,2022,01-21,05:55
014 Beaux-Arts,3,5,8,2022,01-21,05:55
015 Les Aubes,7,1,8,2022,01-21,05:55
016 Antigone centre,14,2,16,2022,01-21,05:55
017 M�diath�que Emile Zola,15,1,16,2022,01-21,05:55
018 Nombre d'Or,10,6,16,2022,01-21,05:55
019 Louis Blanc,15,1,16,2022,01-21,05:55
020 Gambetta,2,6,8,2022,01-21,05:55
021 Port Marianne,11,5,16,2022,01-21,05:55
022 Clemenceau,8,4,12,2022,01-21,05:55
023 Les Arceaux,4,12,16,2022,01-21,05:55
024 Cit� Mion,4,4,8,2022,01-21,05:55
025 Nouveau Saint-Roch,6,2,8,2022,01-21,05:55
026 Renouvier,3,5,8,2022,01-21,05:55
027 Odysseum,4,4,8,2022,01-21,05:55
028 Saint-Denis,5,3,8,2022,01-21,05:55
029 Richter,7,9,16,2022,01-21,05:55
030 Charles Flahault,0,8,8,2022,01-21,05:55
031 Voltaire,4,4,8,2022,01-21,05:55
032 Pr�s d'Ar�nes,4,4,8,2022,01-21,05:55
033 Garcia Lorca,8,0,8,2022,01-21,05:55
034 Vert Bois,0,16,16,2022,01-21,05:55
035 Malbosc,3,5,8,2022,01-21,05:55
036 Occitanie,5,27,32,2022,01-21,05:55
037 FacdesSciences,2,22,24,2022,01-21,05:55
038 Fac de Lettres,6,10,16,2022,01-21,05:55
039 Aiguelongue,1,7,8,2022,01-21,05:55
040 Jeu de Mail des Abb�s,3,5,8,2022,01-21,05:55
041 Eurom�decine,2,6,8,2022,01-21,05:55
042 Marie Caizergues,8,0,8,2022,01-21,05:55
043 Sabines,5,3,8,2022,01-21,05:55
044 Celleneuve,1,7,8,2022,01-21,05:55
045 Jardin de la Lironde,5,3,8,2022,01-21,05:55
046 P�re Soulas,6,2,8,2022,01-21,05:55
047 Place Viala,5,3,8,2022,01-21,05:55
048 H�tel du D�partement,5,3,8,2022,01-21,05:55
049 Tonnelles,3,5,8,2022,01-21,05:55
050 Parvis Jules Ferry - Gare Saint-Roch,7,1,8,2022,01-21,05:55
051 Pont de Lattes - Gare Saint-Roch,0,12,12,2022,01-21,05:55
053 Deux Ponts - Gare Saint-Roch,2,6,8,2022,01-21,05:55
054 Providence - Ovalie,3,5,8,2022,01-21,05:55
055 P�rols Etang de l'Or,26,42,68,2022,01-21,05:55
056 Albert 1er - Cath�drale,0,12,12,2022,01-21,05:55
057 Saint-Guilhem - Courreau,1,7,8,2022,01-21,05:55
059 Sud De France,3,5,8,2022,01-21,05:55
001 Rue Jules Ferry - Gare Saint-Roch,5,7,12,2022,01-21,06:05
002 Com�die,4,20,24,2022,01-21,06:05
003 Esplanade,1,31,32,2022,01-21,06:05
004 H�tel de Ville,8,8,16,2022,01-21,06:05
005 Corum,12,0,12,2022,01-21,06:05
006 Place Albert 1er - St Charles,23,8,31,2022,01-21,06:05
007 Foch,2,6,8,2022,01-21,06:05
008 Halles Castellane,0,12,12,2022,01-21,06:05
009 Observatoire,4,4,8,2022,01-21,06:05
010 Rondelet,1,15,16,2022,01-21,06:05
011 Plan Cabanes,4,8,12,2022,01-21,06:05
012 Boutonnet,3,9,12,2022,01-21,06:05
013 Emile Combes,7,1,8,2022,01-21,06:05
014 Beaux-Arts,3,5,8,2022,01-21,06:05
015 Les Aubes,7,1,8,2022,01-21,06:05
016 Antigone centre,14,2,16,2022,01-21,06:05
017 M�diath�que Emile Zola,15,1,16,2022,01-21,06:05
018 Nombre d'Or,10,6,16,2022,01-21,06:05
019 Louis Blanc,15,1,16,2022,01-21,06:05
020 Gambetta,2,6,8,2022,01-21,06:05
021 Port Marianne,11,5,16,2022,01-21,06:05
022 Clemenceau,8,4,12,2022,01-21,06:05
023 Les Arceaux,4,12,16,2022,01-21,06:05
024 Cit� Mion,4,4,8,2022,01-21,06:05
025 Nouveau Saint-Roch,6,2,8,2022,01-21,06:05
026 Renouvier,3,5,8,2022,01-21,06:05
027 Odysseum,4,4,8,2022,01-21,06:05
028 Saint-Denis,5,3,8,2022,01-21,06:05
029 Richter,7,9,16,2022,01-21,06:05
030 Charles Flahault,0,8,8,2022,01-21,06:05
031 Voltaire,4,4,8,2022,01-21,06:05
032 Pr�s d'Ar�nes,4,4,8,2022,01-21,06:05
033 Garcia Lorca,8,0,8,2022,01-21,06:05
034 Vert Bois,0,16,16,2022,01-21,06:05
035 Malbosc,3,5,8,2022,01-21,06:05
036 Occitanie,5,27,32,2022,01-21,06:05
037 FacdesSciences,3,21,24,2022,01-21,06:05
038 Fac de Lettres,6,10,16,2022,01-21,06:05
039 Aiguelongue,1,7,8,2022,01-21,06:05
040 Jeu de Mail des Abb�s,3,5,8,2022,01-21,06:05
041 Eurom�decine,2,6,8,2022,01-21,06:05
042 Marie Caizergues,8,0,8,2022,01-21,06:05
043 Sabines,5,3,8,2022,01-21,06:05
044 Celleneuve,1,7,8,2022,01-21,06:05
045 Jardin de la Lironde,5,3,8,2022,01-21,06:05
046 P�re Soulas,6,2,8,2022,01-21,06:05
047 Place Viala,5,3,8,2022,01-21,06:05
048 H�tel du D�partement,5,3,8,2022,01-21,06:05
049 Tonnelles,3,5,8,2022,01-21,06:05
050 Parvis Jules Ferry - Gare Saint-Roch,7,1,8,2022,01-21,06:05
051 Pont de Lattes - Gare Saint-Roch,0,12,12,2022,01-21,06:05
053 Deux Ponts - Gare Saint-Roch,2,6,8,2022,01-21,06:05
054 Providence - Ovalie,3,5,8,2022,01-21,06:05
055 P�rols Etang de l'Or,26,42,68,2022,01-21,06:05
056 Albert 1er - Cath�drale,0,12,12,2022,01-21,06:05
057 Saint-Guilhem - Courreau,1,7,8,2022,01-21,06:05
059 Sud De France,3,5,8,2022,01-21,06:05
001 Rue Jules Ferry - Gare Saint-Roch,5,7,12,2022,01-21,06:16
002 Com�die,4,20,24,2022,01-21,06:16
003 Esplanade,1,31,32,2022,01-21,06:16
004 H�tel de Ville,8,8,16,2022,01-21,06:16
005 Corum,12,0,12,2022,01-21,06:16
006 Place Albert 1er - St Charles,23,8,31,2022,01-21,06:16
007 Foch,2,6,8,2022,01-21,06:16
008 Halles Castellane,0,12,12,2022,01-21,06:16
009 Observatoire,4,4,8,2022,01-21,06:16
010 Rondelet,1,15,16,2022,01-21,06:16
011 Plan Cabanes,4,8,12,2022,01-21,06:16
012 Boutonnet,3,9,12,2022,01-21,06:16
013 Emile Combes,7,1,8,2022,01-21,06:16
014 Beaux-Arts,3,5,8,2022,01-21,06:16
015 Les Aubes,7,1,8,2022,01-21,06:16
016 Antigone centre,14,2,16,2022,01-21,06:16
017 M�diath�que Emile Zola,15,1,16,2022,01-21,06:16
018 Nombre d'Or,10,6,16,2022,01-21,06:16
019 Louis Blanc,15,1,16,2022,01-21,06:16
020 Gambetta,2,6,8,2022,01-21,06:16
021 Port Marianne,11,5,16,2022,01-21,06:16
022 Clemenceau,8,4,12,2022,01-21,06:16
023 Les Arceaux,4,12,16,2022,01-21,06:16
024 Cit� Mion,4,4,8,2022,01-21,06:16
025 Nouveau Saint-Roch,6,2,8,2022,01-21,06:16
026 Renouvier,3,5,8,2022,01-21,06:16
027 Odysseum,4,4,8,2022,01-21,06:16
028 Saint-Denis,5,3,8,2022,01-21,06:16
029 Richter,7,9,16,2022,01-21,06:16
030 Charles Flahault,0,8,8,2022,01-21,06:16
031 Voltaire,4,4,8,2022,01-21,06:16
032 Pr�s d'Ar�nes,4,4,8,2022,01-21,06:16
033 Garcia Lorca,8,0,8,2022,01-21,06:16
034 Vert Bois,0,16,16,2022,01-21,06:16
035 Malbosc,3,5,8,2022,01-21,06:16
036 Occitanie,5,27,32,2022,01-21,06:16
037 FacdesSciences,3,21,24,2022,01-21,06:16
038 Fac de Lettres,6,10,16,2022,01-21,06:16
039 Aiguelongue,1,7,8,2022,01-21,06:16
040 Jeu de Mail des Abb�s,3,5,8,2022,01-21,06:16
041 Eurom�decine,2,6,8,2022,01-21,06:16
042 Marie Caizergues,8,0,8,2022,01-21,06:16
043 Sabines,5,3,8,2022,01-21,06:16
044 Celleneuve,1,7,8,2022,01-21,06:16
045 Jardin de la Lironde,5,3,8,2022,01-21,06:16
046 P�re Soulas,6,2,8,2022,01-21,06:16
047 Place Viala,5,3,8,2022,01-21,06:16
048 H�tel du D�partement,5,3,8,2022,01-21,06:16
049 Tonnelles,3,5,8,2022,01-21,06:16
050 Parvis Jules Ferry - Gare Saint-Roch,7,1,8,2022,01-21,06:16
051 Pont de Lattes - Gare Saint-Roch,0,12,12,2022,01-21,06:16
053 Deux Ponts - Gare Saint-Roch,2,6,8,2022,01-21,06:16
054 Providence - Ovalie,3,5,8,2022,01-21,06:16
055 P�rols Etang de l'Or,26,42,68,2022,01-21,06:16
056 Albert 1er - Cath�drale,0,12,12,2022,01-21,06:16
057 Saint-Guilhem - Courreau,1,7,8,2022,01-21,06:16
059 Sud De France,3,5,8,2022,01-21,06:16
001 Rue Jules Ferry - Gare Saint-Roch,5,7,12,2022,01-21,06:26
002 Com�die,4,20,24,2022,01-21,06:26
003 Esplanade,1,31,32,2022,01-21,06:26
004 H�tel de Ville,8,8,16,2022,01-21,06:26
005 Corum,12,0,12,2022,01-21,06:26
006 Place Albert 1er - St Charles,23,8,31,2022,01-21,06:26
007 Foch,2,6,8,2022,01-21,06:26
008 Halles Castellane,0,12,12,2022,01-21,06:26
009 Observatoire,4,4,8,2022,01-21,06:26
010 Rondelet,1,15,16,2022,01-21,06:26
011 Plan Cabanes,4,8,12,2022,01-21,06:26
012 Boutonnet,3,9,12,2022,01-21,06:26
013 Emile Combes,7,1,8,2022,01-21,06:26
014 Beaux-Arts,3,5,8,2022,01-21,06:26
015 Les Aubes,7,1,8,2022,01-21,06:26
016 Antigone centre,14,2,16,2022,01-21,06:26
017 M�diath�que Emile Zola,15,1,16,2022,01-21,06:26
018 Nombre d'Or,10,6,16,2022,01-21,06:26
019 Louis Blanc,15,1,16,2022,01-21,06:26
020 Gambetta,2,6,8,2022,01-21,06:26
021 Port Marianne,11,5,16,2022,01-21,06:26
022 Clemenceau,8,4,12,2022,01-21,06:26
023 Les Arceaux,4,12,16,2022,01-21,06:26
024 Cit� Mion,4,4,8,2022,01-21,06:26
025 Nouveau Saint-Roch,6,2,8,2022,01-21,06:26
026 Renouvier,3,5,8,2022,01-21,06:26
027 Odysseum,4,4,8,2022,01-21,06:26
028 Saint-Denis,5,3,8,2022,01-21,06:26
029 Richter,7,9,16,2022,01-21,06:26
030 Charles Flahault,0,8,8,2022,01-21,06:26
031 Voltaire,4,4,8,2022,01-21,06:26
032 Pr�s d'Ar�nes,4,4,8,2022,01-21,06:26
033 Garcia Lorca,8,0,8,2022,01-21,06:26
034 Vert Bois,0,16,16,2022,01-21,06:26
035 Malbosc,3,5,8,2022,01-21,06:26
036 Occitanie,5,27,32,2022,01-21,06:26
037 FacdesSciences,3,21,24,2022,01-21,06:26
038 Fac de Lettres,6,10,16,2022,01-21,06:26
039 Aiguelongue,1,7,8,2022,01-21,06:26
040 Jeu de Mail des Abb�s,3,5,8,2022,01-21,06:26
041 Eurom�decine,2,6,8,2022,01-21,06:26
042 Marie Caizergues,8,0,8,2022,01-21,06:26
043 Sabines,5,3,8,2022,01-21,06:26
044 Celleneuve,1,7,8,2022,01-21,06:26
045 Jardin de la Lironde,5,3,8,2022,01-21,06:26
046 P�re Soulas,6,2,8,2022,01-21,06:26
047 Place Viala,5,3,8,2022,01-21,06:26
048 H�tel du D�partement,5,3,8,2022,01-21,06:26
049 Tonnelles,3,5,8,2022,01-21,06:26
050 Parvis Jules Ferry - Gare Saint-Roch,7,1,8,2022,01-21,06:26
051 Pont de Lattes - Gare Saint-Roch,0,12,12,2022,01-21,06:26
053 Deux Ponts - Gare Saint-Roch,2,6,8,2022,01-21,06:26
054 Providence - Ovalie,3,5,8,2022,01-21,06:26
055 P�rols Etang de l'Or,26,42,68,2022,01-21,06:26
056 Albert 1er - Cath�drale,0,12,12,2022,01-21,06:26
057 Saint-Guilhem - Courreau,1,7,8,2022,01-21,06:26
059 Sud De France,3,5,8,2022,01-21,06:26
001 Rue Jules Ferry - Gare Saint-Roch,5,7,12,2022,01-21,06:36
002 Com�die,4,20,24,2022,01-21,06:36
003 Esplanade,1,31,32,2022,01-21,06:36
004 H�tel de Ville,8,8,16,2022,01-21,06:36
005 Corum,12,0,12,2022,01-21,06:36
006 Place Albert 1er - St Charles,23,8,31,2022,01-21,06:36
007 Foch,2,6,8,2022,01-21,06:36
008 Halles Castellane,0,12,12,2022,01-21,06:36
009 Observatoire,4,4,8,2022,01-21,06:36
010 Rondelet,1,15,16,2022,01-21,06:36
011 Plan Cabanes,4,8,12,2022,01-21,06:36
012 Boutonnet,3,9,12,2022,01-21,06:36
013 Emile Combes,7,1,8,2022,01-21,06:36
014 Beaux-Arts,3,5,8,2022,01-21,06:36
015 Les Aubes,7,1,8,2022,01-21,06:36
016 Antigone centre,14,2,16,2022,01-21,06:36
017 M�diath�que Emile Zola,15,1,16,2022,01-21,06:36
018 Nombre d'Or,10,6,16,2022,01-21,06:36
019 Louis Blanc,15,1,16,2022,01-21,06:36
020 Gambetta,2,6,8,2022,01-21,06:36
021 Port Marianne,11,5,16,2022,01-21,06:36
022 Clemenceau,8,4,12,2022,01-21,06:36
023 Les Arceaux,4,12,16,2022,01-21,06:36
024 Cit� Mion,4,4,8,2022,01-21,06:36
025 Nouveau Saint-Roch,6,2,8,2022,01-21,06:36
026 Renouvier,3,5,8,2022,01-21,06:36
027 Odysseum,4,4,8,2022,01-21,06:36
028 Saint-Denis,5,3,8,2022,01-21,06:36
029 Richter,7,9,16,2022,01-21,06:36
030 Charles Flahault,0,8,8,2022,01-21,06:36
031 Voltaire,4,4,8,2022,01-21,06:36
032 Pr�s d'Ar�nes,4,4,8,2022,01-21,06:36
033 Garcia Lorca,8,0,8,2022,01-21,06:36
034 Vert Bois,0,16,16,2022,01-21,06:36
035 Malbosc,3,5,8,2022,01-21,06:36
036 Occitanie,5,27,32,2022,01-21,06:36
037 FacdesSciences,3,21,24,2022,01-21,06:36
038 Fac de Lettres,6,10,16,2022,01-21,06:36
039 Aiguelongue,1,7,8,2022,01-21,06:36
040 Jeu de Mail des Abb�s,3,5,8,2022,01-21,06:36
041 Eurom�decine,2,6,8,2022,01-21,06:36
042 Marie Caizergues,8,0,8,2022,01-21,06:36
043 Sabines,5,3,8,2022,01-21,06:36
044 Celleneuve,1,7,8,2022,01-21,06:36
045 Jardin de la Lironde,5,3,8,2022,01-21,06:36
046 P�re Soulas,6,2,8,2022,01-21,06:36
047 Place Viala,5,3,8,2022,01-21,06:36
048 H�tel du D�partement,5,3,8,2022,01-21,06:36
049 Tonnelles,3,5,8,2022,01-21,06:36
050 Parvis Jules Ferry - Gare Saint-Roch,7,1,8,2022,01-21,06:36
051 Pont de Lattes - Gare Saint-Roch,0,12,12,2022,01-21,06:36
053 Deux Ponts - Gare Saint-Roch,2,6,8,2022,01-21,06:36
054 Providence - Ovalie,3,5,8,2022,01-21,06:36
055 P�rols Etang de l'Or,26,42,68,2022,01-21,06:36
056 Albert 1er - Cath�drale,0,12,12,2022,01-21,06:36
057 Saint-Guilhem - Courreau,1,7,8,2022,01-21,06:36
059 Sud De France,3,5,8,2022,01-21,06:36
001 Rue Jules Ferry - Gare Saint-Roch,5,7,12,2022,01-21,06:46
002 Com�die,4,20,24,2022,01-21,06:46
003 Esplanade,1,31,32,2022,01-21,06:46
004 H�tel de Ville,8,8,16,2022,01-21,06:46
005 Corum,12,0,12,2022,01-21,06:46
006 Place Albert 1er - St Charles,23,8,31,2022,01-21,06:46
007 Foch,2,6,8,2022,01-21,06:46
008 Halles Castellane,0,12,12,2022,01-21,06:46
009 Observatoire,4,4,8,2022,01-21,06:46
010 Rondelet,1,15,16,2022,01-21,06:46
011 Plan Cabanes,4,8,12,2022,01-21,06:46
012 Boutonnet,3,9,12,2022,01-21,06:46
013 Emile Combes,7,1,8,2022,01-21,06:46
014 Beaux-Arts,3,5,8,2022,01-21,06:46
015 Les Aubes,7,1,8,2022,01-21,06:46
016 Antigone centre,14,2,16,2022,01-21,06:46
017 M�diath�que Emile Zola,15,1,16,2022,01-21,06:46
018 Nombre d'Or,10,6,16,2022,01-21,06:46
019 Louis Blanc,15,1,16,2022,01-21,06:46
020 Gambetta,2,6,8,2022,01-21,06:46
021 Port Marianne,11,5,16,2022,01-21,06:46
022 Clemenceau,8,4,12,2022,01-21,06:46
023 Les Arceaux,4,12,16,2022,01-21,06:46
024 Cit� Mion,4,4,8,2022,01-21,06:46
025 Nouveau Saint-Roch,6,2,8,2022,01-21,06:46
026 Renouvier,3,5,8,2022,01-21,06:46
027 Odysseum,4,4,8,2022,01-21,06:46
028 Saint-Denis,5,3,8,2022,01-21,06:46
029 Richter,7,9,16,2022,01-21,06:46
030 Charles Flahault,0,8,8,2022,01-21,06:46
031 Voltaire,4,4,8,2022,01-21,06:46
032 Pr�s d'Ar�nes,4,4,8,2022,01-21,06:46
033 Garcia Lorca,8,0,8,2022,01-21,06:46
034 Vert Bois,0,16,16,2022,01-21,06:46
035 Malbosc,3,5,8,2022,01-21,06:46
036 Occitanie,5,27,32,2022,01-21,06:46
037 FacdesSciences,3,21,24,2022,01-21,06:46
038 Fac de Lettres,6,10,16,2022,01-21,06:46
039 Aiguelongue,1,7,8,2022,01-21,06:46
040 Jeu de Mail des Abb�s,3,5,8,2022,01-21,06:46
041 Eurom�decine,2,6,8,2022,01-21,06:46
042 Marie Caizergues,8,0,8,2022,01-21,06:46
043 Sabines,5,3,8,2022,01-21,06:46
044 Celleneuve,1,7,8,2022,01-21,06:46
045 Jardin de la Lironde,5,3,8,2022,01-21,06:46
046 P�re Soulas,6,2,8,2022,01-21,06:46
047 Place Viala,5,3,8,2022,01-21,06:46
048 H�tel du D�partement,5,3,8,2022,01-21,06:46
049 Tonnelles,3,5,8,2022,01-21,06:46
050 Parvis Jules Ferry - Gare Saint-Roch,7,1,8,2022,01-21,06:46
051 Pont de Lattes - Gare Saint-Roch,0,12,12,2022,01-21,06:46
053 Deux Ponts - Gare Saint-Roch,2,6,8,2022,01-21,06:46
054 Providence - Ovalie,3,5,8,2022,01-21,06:46
055 P�rols Etang de l'Or,26,42,68,2022,01-21,06:46
056 Albert 1er - Cath�drale,0,12,12,2022,01-21,06:46
057 Saint-Guilhem - Courreau,1,7,8,2022,01-21,06:46
059 Sud De France,3,5,8,2022,01-21,06:46
001 Rue Jules Ferry - Gare Saint-Roch,5,7,12,2022,01-21,06:56
002 Com�die,4,20,24,2022,01-21,06:56
003 Esplanade,1,31,32,2022,01-21,06:56
004 H�tel de Ville,8,8,16,2022,01-21,06:56
005 Corum,12,0,12,2022,01-21,06:56
006 Place Albert 1er - St Charles,23,8,31,2022,01-21,06:56
007 Foch,2,6,8,2022,01-21,06:56
008 Halles Castellane,0,12,12,2022,01-21,06:56
009 Observatoire,4,4,8,2022,01-21,06:56
010 Rondelet,1,15,16,2022,01-21,06:56
011 Plan Cabanes,4,8,12,2022,01-21,06:56
012 Boutonnet,3,9,12,2022,01-21,06:56
013 Emile Combes,7,1,8,2022,01-21,06:56
014 Beaux-Arts,3,5,8,2022,01-21,06:56
015 Les Aubes,7,1,8,2022,01-21,06:56
016 Antigone centre,14,2,16,2022,01-21,06:56
017 M�diath�que Emile Zola,15,1,16,2022,01-21,06:56
018 Nombre d'Or,10,6,16,2022,01-21,06:56
019 Louis Blanc,15,1,16,2022,01-21,06:56
020 Gambetta,2,6,8,2022,01-21,06:56
021 Port Marianne,11,5,16,2022,01-21,06:56
022 Clemenceau,8,4,12,2022,01-21,06:56
023 Les Arceaux,4,12,16,2022,01-21,06:56
024 Cit� Mion,4,4,8,2022,01-21,06:56
025 Nouveau Saint-Roch,6,2,8,2022,01-21,06:56
026 Renouvier,3,5,8,2022,01-21,06:56
027 Odysseum,4,4,8,2022,01-21,06:56
028 Saint-Denis,5,3,8,2022,01-21,06:56
029 Richter,7,9,16,2022,01-21,06:56
030 Charles Flahault,0,8,8,2022,01-21,06:56
031 Voltaire,4,4,8,2022,01-21,06:56
032 Pr�s d'Ar�nes,3,5,8,2022,01-21,06:56
033 Garcia Lorca,8,0,8,2022,01-21,06:56
034 Vert Bois,0,16,16,2022,01-21,06:56
035 Malbosc,3,5,8,2022,01-21,06:56
036 Occitanie,5,27,32,2022,01-21,06:56
037 FacdesSciences,3,21,24,2022,01-21,06:56
038 Fac de Lettres,6,10,16,2022,01-21,06:56
039 Aiguelongue,1,7,8,2022,01-21,06:56
040 Jeu de Mail des Abb�s,3,5,8,2022,01-21,06:56
041 Eurom�decine,2,6,8,2022,01-21,06:56
042 Marie Caizergues,8,0,8,2022,01-21,06:56
043 Sabines,5,3,8,2022,01-21,06:56
044 Celleneuve,1,7,8,2022,01-21,06:56
045 Jardin de la Lironde,5,3,8,2022,01-21,06:56
046 P�re Soulas,6,2,8,2022,01-21,06:56
047 Place Viala,5,3,8,2022,01-21,06:56
048 H�tel du D�partement,5,3,8,2022,01-21,06:56
049 Tonnelles,3,5,8,2022,01-21,06:56
050 Parvis Jules Ferry - Gare Saint-Roch,7,1,8,2022,01-21,06:56
051 Pont de Lattes - Gare Saint-Roch,0,12,12,2022,01-21,06:56
053 Deux Ponts - Gare Saint-Roch,2,6,8,2022,01-21,06:56
054 Providence - Ovalie,3,5,8,2022,01-21,06:56
055 P�rols Etang de l'Or,26,42,68,2022,01-21,06:56
056 Albert 1er - Cath�drale,0,12,12,2022,01-21,06:56
057 Saint-Guilhem - Courreau,1,7,8,2022,01-21,06:56
059 Sud De France,3,5,8,2022,01-21,06:56
001 Rue Jules Ferry - Gare Saint-Roch,5,7,12,2022,01-21,07:06
002 Com�die,4,20,24,2022,01-21,07:06
003 Esplanade,1,31,32,2022,01-21,07:06
004 H�tel de Ville,8,8,16,2022,01-21,07:06
005 Corum,8,4,12,2022,01-21,07:06
006 Place Albert 1er - St Charles,23,8,31,2022,01-21,07:06
007 Foch,2,6,8,2022,01-21,07:06
008 Halles Castellane,0,12,12,2022,01-21,07:06
009 Observatoire,4,4,8,2022,01-21,07:06
010 Rondelet,1,15,16,2022,01-21,07:06
011 Plan Cabanes,4,8,12,2022,01-21,07:06
012 Boutonnet,3,9,12,2022,01-21,07:06
013 Emile Combes,7,1,8,2022,01-21,07:06
014 Beaux-Arts,3,5,8,2022,01-21,07:06
015 Les Aubes,7,1,8,2022,01-21,07:06
016 Antigone centre,15,1,16,2022,01-21,07:06
017 M�diath�que Emile Zola,15,1,16,2022,01-21,07:06
018 Nombre d'Or,10,6,16,2022,01-21,07:06
019 Louis Blanc,15,1,16,2022,01-21,07:06
020 Gambetta,2,6,8,2022,01-21,07:06
021 Port Marianne,11,5,16,2022,01-21,07:06
022 Clemenceau,8,4,12,2022,01-21,07:06
023 Les Arceaux,3,13,16,2022,01-21,07:06
024 Cit� Mion,4,4,8,2022,01-21,07:06
025 Nouveau Saint-Roch,6,2,8,2022,01-21,07:06
026 Renouvier,3,5,8,2022,01-21,07:06
027 Odysseum,4,4,8,2022,01-21,07:06
028 Saint-Denis,5,3,8,2022,01-21,07:06
029 Richter,7,9,16,2022,01-21,07:06
030 Charles Flahault,0,8,8,2022,01-21,07:06
031 Voltaire,4,4,8,2022,01-21,07:06
032 Pr�s d'Ar�nes,3,5,8,2022,01-21,07:06
033 Garcia Lorca,8,0,8,2022,01-21,07:06
034 Vert Bois,0,16,16,2022,01-21,07:06
035 Malbosc,3,5,8,2022,01-21,07:06
036 Occitanie,5,27,32,2022,01-21,07:06
037 FacdesSciences,3,21,24,2022,01-21,07:06
038 Fac de Lettres,6,10,16,2022,01-21,07:06
039 Aiguelongue,1,7,8,2022,01-21,07:06
040 Jeu de Mail des Abb�s,3,5,8,2022,01-21,07:06
041 Eurom�decine,2,6,8,2022,01-21,07:06
042 Marie Caizergues,8,0,8,2022,01-21,07:06
043 Sabines,5,3,8,2022,01-21,07:06
044 Celleneuve,1,7,8,2022,01-21,07:06
045 Jardin de la Lironde,5,3,8,2022,01-21,07:06
046 P�re Soulas,5,3,8,2022,01-21,07:06
047 Place Viala,5,3,8,2022,01-21,07:06
048 H�tel du D�partement,5,3,8,2022,01-21,07:06
049 Tonnelles,3,5,8,2022,01-21,07:06
050 Parvis Jules Ferry - Gare Saint-Roch,7,1,8,2022,01-21,07:06
051 Pont de Lattes - Gare Saint-Roch,0,12,12,2022,01-21,07:06
053 Deux Ponts - Gare Saint-Roch,2,6,8,2022,01-21,07:06
054 Providence - Ovalie,3,5,8,2022,01-21,07:06
055 P�rols Etang de l'Or,26,42,68,2022,01-21,07:06
056 Albert 1er - Cath�drale,0,12,12,2022,01-21,07:06
057 Saint-Guilhem - Courreau,1,7,8,2022,01-21,07:06
059 Sud De France,3,5,8,2022,01-21,07:06
001 Rue Jules Ferry - Gare Saint-Roch,5,7,12,2022,01-21,07:17
002 Com�die,4,20,24,2022,01-21,07:17
003 Esplanade,1,31,32,2022,01-21,07:17
004 H�tel de Ville,8,8,16,2022,01-21,07:17
005 Corum,4,8,12,2022,01-21,07:17
006 Place Albert 1er - St Charles,23,8,31,2022,01-21,07:17
007 Foch,2,6,8,2022,01-21,07:17
008 Halles Castellane,0,12,12,2022,01-21,07:17
009 Observatoire,4,4,8,2022,01-21,07:17
010 Rondelet,1,15,16,2022,01-21,07:17
011 Plan Cabanes,4,8,12,2022,01-21,07:17
012 Boutonnet,3,9,12,2022,01-21,07:17
013 Emile Combes,7,1,8,2022,01-21,07:17
014 Beaux-Arts,3,5,8,2022,01-21,07:17
015 Les Aubes,7,1,8,2022,01-21,07:17
016 Antigone centre,15,1,16,2022,01-21,07:17
017 M�diath�que Emile Zola,14,2,16,2022,01-21,07:17
018 Nombre d'Or,10,6,16,2022,01-21,07:17
019 Louis Blanc,15,1,16,2022,01-21,07:17
020 Gambetta,2,6,8,2022,01-21,07:17
021 Port Marianne,11,5,16,2022,01-21,07:17
022 Clemenceau,8,4,12,2022,01-21,07:17
023 Les Arceaux,3,13,16,2022,01-21,07:17
024 Cit� Mion,4,4,8,2022,01-21,07:17
025 Nouveau Saint-Roch,6,2,8,2022,01-21,07:17
026 Renouvier,3,5,8,2022,01-21,07:17
027 Odysseum,4,4,8,2022,01-21,07:17
028 Saint-Denis,5,3,8,2022,01-21,07:17
029 Richter,7,9,16,2022,01-21,07:17
030 Charles Flahault,0,8,8,2022,01-21,07:17
031 Voltaire,4,4,8,2022,01-21,07:17
032 Pr�s d'Ar�nes,3,5,8,2022,01-21,07:17
033 Garcia Lorca,8,0,8,2022,01-21,07:17
034 Vert Bois,0,16,16,2022,01-21,07:17
035 Malbosc,3,5,8,2022,01-21,07:17
036 Occitanie,5,27,32,2022,01-21,07:17
037 FacdesSciences,3,21,24,2022,01-21,07:17
038 Fac de Lettres,6,10,16,2022,01-21,07:17
039 Aiguelongue,2,6,8,2022,01-21,07:17
040 Jeu de Mail des Abb�s,3,5,8,2022,01-21,07:17
041 Eurom�decine,2,6,8,2022,01-21,07:17
042 Marie Caizergues,8,0,8,2022,01-21,07:17
043 Sabines,5,3,8,2022,01-21,07:17
044 Celleneuve,1,7,8,2022,01-21,07:17
045 Jardin de la Lironde,5,3,8,2022,01-21,07:17
046 P�re Soulas,5,3,8,2022,01-21,07:17
047 Place Viala,5,3,8,2022,01-21,07:17
048 H�tel du D�partement,5,3,8,2022,01-21,07:17
049 Tonnelles,3,5,8,2022,01-21,07:17
050 Parvis Jules Ferry - Gare Saint-Roch,7,1,8,2022,01-21,07:17
051 Pont de Lattes - Gare Saint-Roch,0,12,12,2022,01-21,07:17
053 Deux Ponts - Gare Saint-Roch,2,6,8,2022,01-21,07:17
054 Providence - Ovalie,3,5,8,2022,01-21,07:17
055 P�rols Etang de l'Or,26,42,68,2022,01-21,07:17
056 Albert 1er - Cath�drale,0,12,12,2022,01-21,07:17
057 Saint-Guilhem - Courreau,1,7,8,2022,01-21,07:17
059 Sud De France,3,5,8,2022,01-21,07:17
001 Rue Jules Ferry - Gare Saint-Roch,5,7,12,2022,01-21,07:27
002 Com�die,4,20,24,2022,01-21,07:27
003 Esplanade,1,31,32,2022,01-21,07:27
004 H�tel de Ville,8,8,16,2022,01-21,07:27
005 Corum,4,8,12,2022,01-21,07:27
006 Place Albert 1er - St Charles,23,8,31,2022,01-21,07:27
007 Foch,2,6,8,2022,01-21,07:27
008 Halles Castellane,10,2,12,2022,01-21,07:27
009 Observatoire,4,4,8,2022,01-21,07:27
010 Rondelet,1,15,16,2022,01-21,07:27
011 Plan Cabanes,4,8,12,2022,01-21,07:27
012 Boutonnet,3,9,12,2022,01-21,07:27
013 Emile Combes,7,1,8,2022,01-21,07:27
014 Beaux-Arts,3,5,8,2022,01-21,07:27
015 Les Aubes,7,1,8,2022,01-21,07:27
016 Antigone centre,12,4,16,2022,01-21,07:27
017 M�diath�que Emile Zola,14,2,16,2022,01-21,07:27
018 Nombre d'Or,10,6,16,2022,01-21,07:27
019 Louis Blanc,15,1,16,2022,01-21,07:27
020 Gambetta,2,6,8,2022,01-21,07:27
021 Port Marianne,11,5,16,2022,01-21,07:27
022 Clemenceau,8,4,12,2022,01-21,07:27
023 Les Arceaux,3,13,16,2022,01-21,07:27
024 Cit� Mion,4,4,8,2022,01-21,07:27
025 Nouveau Saint-Roch,6,2,8,2022,01-21,07:27
026 Renouvier,3,5,8,2022,01-21,07:27
027 Odysseum,4,4,8,2022,01-21,07:27
028 Saint-Denis,5,3,8,2022,01-21,07:27
029 Richter,7,9,16,2022,01-21,07:27
030 Charles Flahault,0,8,8,2022,01-21,07:27
031 Voltaire,4,4,8,2022,01-21,07:27
032 Pr�s d'Ar�nes,3,5,8,2022,01-21,07:27
033 Garcia Lorca,8,0,8,2022,01-21,07:27
034 Vert Bois,0,16,16,2022,01-21,07:27
035 Malbosc,2,6,8,2022,01-21,07:27
036 Occitanie,5,27,32,2022,01-21,07:27
037 FacdesSciences,3,21,24,2022,01-21,07:27
038 Fac de Lettres,6,10,16,2022,01-21,07:27
039 Aiguelongue,2,6,8,2022,01-21,07:27
040 Jeu de Mail des Abb�s,3,5,8,2022,01-21,07:27
041 Eurom�decine,2,6,8,2022,01-21,07:27
042 Marie Caizergues,8,0,8,2022,01-21,07:27
043 Sabines,5,3,8,2022,01-21,07:27
044 Celleneuve,1,7,8,2022,01-21,07:27
045 Jardin de la Lironde,5,3,8,2022,01-21,07:27
046 P�re Soulas,5,3,8,2022,01-21,07:27
047 Place Viala,5,3,8,2022,01-21,07:27
048 H�tel du D�partement,5,3,8,2022,01-21,07:27
049 Tonnelles,3,5,8,2022,01-21,07:27
050 Parvis Jules Ferry - Gare Saint-Roch,7,1,8,2022,01-21,07:27
051 Pont de Lattes - Gare Saint-Roch,0,12,12,2022,01-21,07:27
053 Deux Ponts - Gare Saint-Roch,2,6,8,2022,01-21,07:27
054 Providence - Ovalie,3,5,8,2022,01-21,07:27
055 P�rols Etang de l'Or,26,42,68,2022,01-21,07:27
056 Albert 1er - Cath�drale,0,12,12,2022,01-21,07:27
057 Saint-Guilhem - Courreau,1,7,8,2022,01-21,07:27
059 Sud De France,3,5,8,2022,01-21,07:27
001 Rue Jules Ferry - Gare Saint-Roch,5,7,12,2022,01-21,07:37
002 Com�die,4,20,24,2022,01-21,07:37
003 Esplanade,1,31,32,2022,01-21,07:37
004 H�tel de Ville,8,8,16,2022,01-21,07:37
005 Corum,4,8,12,2022,01-21,07:37
006 Place Albert 1er - St Charles,23,8,31,2022,01-21,07:37
007 Foch,2,6,8,2022,01-21,07:37
008 Halles Castellane,10,2,12,2022,01-21,07:37
009 Observatoire,4,4,8,2022,01-21,07:37
010 Rondelet,1,15,16,2022,01-21,07:37
011 Plan Cabanes,4,8,12,2022,01-21,07:37
012 Boutonnet,3,9,12,2022,01-21,07:37
013 Emile Combes,7,1,8,2022,01-21,07:37
014 Beaux-Arts,3,5,8,2022,01-21,07:37
015 Les Aubes,7,1,8,2022,01-21,07:37
016 Antigone centre,6,10,16,2022,01-21,07:37
017 M�diath�que Emile Zola,14,2,16,2022,01-21,07:37
018 Nombre d'Or,10,6,16,2022,01-21,07:37
019 Louis Blanc,15,1,16,2022,01-21,07:37
020 Gambetta,2,6,8,2022,01-21,07:37
021 Port Marianne,11,5,16,2022,01-21,07:37
022 Clemenceau,7,5,12,2022,01-21,07:37
023 Les Arceaux,3,13,16,2022,01-21,07:37
024 Cit� Mion,4,4,8,2022,01-21,07:37
025 Nouveau Saint-Roch,6,2,8,2022,01-21,07:37
026 Renouvier,3,5,8,2022,01-21,07:37
027 Odysseum,4,4,8,2022,01-21,07:37
028 Saint-Denis,5,3,8,2022,01-21,07:37
029 Richter,7,9,16,2022,01-21,07:37
030 Charles Flahault,0,8,8,2022,01-21,07:37
031 Voltaire,4,4,8,2022,01-21,07:37
032 Pr�s d'Ar�nes,3,5,8,2022,01-21,07:37
033 Garcia Lorca,8,0,8,2022,01-21,07:37
034 Vert Bois,0,16,16,2022,01-21,07:37
035 Malbosc,2,6,8,2022,01-21,07:37
036 Occitanie,5,27,32,2022,01-21,07:37
037 FacdesSciences,3,21,24,2022,01-21,07:37
038 Fac de Lettres,6,10,16,2022,01-21,07:37
039 Aiguelongue,2,6,8,2022,01-21,07:37
040 Jeu de Mail des Abb�s,3,5,8,2022,01-21,07:37
041 Eurom�decine,2,6,8,2022,01-21,07:37
042 Marie Caizergues,8,0,8,2022,01-21,07:37
043 Sabines,5,3,8,2022,01-21,07:37
044 Celleneuve,1,7,8,2022,01-21,07:37
045 Jardin de la Lironde,5,3,8,2022,01-21,07:37
046 P�re Soulas,5,3,8,2022,01-21,07:37
047 Place Viala,5,3,8,2022,01-21,07:37
048 H�tel du D�partement,5,3,8,2022,01-21,07:37
049 Tonnelles,3,5,8,2022,01-21,07:37
050 Parvis Jules Ferry - Gare Saint-Roch,7,1,8,2022,01-21,07:37
051 Pont de Lattes - Gare Saint-Roch,0,12,12,2022,01-21,07:37
053 Deux Ponts - Gare Saint-Roch,2,6,8,2022,01-21,07:37
054 Providence - Ovalie,3,5,8,2022,01-21,07:37
055 P�rols Etang de l'Or,26,42,68,2022,01-21,07:37
056 Albert 1er - Cath�drale,0,12,12,2022,01-21,07:37
057 Saint-Guilhem - Courreau,1,7,8,2022,01-21,07:37
059 Sud De France,3,5,8,2022,01-21,07:37
001 Rue Jules Ferry - Gare Saint-Roch,5,7,12,2022,01-21,07:47
002 Com�die,4,20,24,2022,01-21,07:47
003 Esplanade,1,31,32,2022,01-21,07:47
004 H�tel de Ville,8,8,16,2022,01-21,07:47
005 Corum,4,8,12,2022,01-21,07:47
006 Place Albert 1er - St Charles,23,8,31,2022,01-21,07:47
007 Foch,2,6,8,2022,01-21,07:47
008 Halles Castellane,10,2,12,2022,01-21,07:47
009 Observatoire,4,4,8,2022,01-21,07:47
010 Rondelet,1,15,16,2022,01-21,07:47
011 Plan Cabanes,4,8,12,2022,01-21,07:47
012 Boutonnet,2,10,12,2022,01-21,07:47
013 Emile Combes,7,1,8,2022,01-21,07:47
014 Beaux-Arts,3,5,8,2022,01-21,07:47
015 Les Aubes,7,1,8,2022,01-21,07:47
016 Antigone centre,6,10,16,2022,01-21,07:47
017 M�diath�que Emile Zola,6,10,16,2022,01-21,07:47
018 Nombre d'Or,10,6,16,2022,01-21,07:47
019 Louis Blanc,15,1,16,2022,01-21,07:47
020 Gambetta,2,6,8,2022,01-21,07:47
021 Port Marianne,11,5,16,2022,01-21,07:47
022 Clemenceau,7,5,12,2022,01-21,07:47
023 Les Arceaux,3,13,16,2022,01-21,07:47
024 Cit� Mion,4,4,8,2022,01-21,07:47
025 Nouveau Saint-Roch,6,2,8,2022,01-21,07:47
026 Renouvier,2,6,8,2022,01-21,07:47
027 Odysseum,4,4,8,2022,01-21,07:47
028 Saint-Denis,5,3,8,2022,01-21,07:47
029 Richter,7,9,16,2022,01-21,07:47
030 Charles Flahault,0,8,8,2022,01-21,07:47
031 Voltaire,4,4,8,2022,01-21,07:47
032 Pr�s d'Ar�nes,3,5,8,2022,01-21,07:47
033 Garcia Lorca,8,0,8,2022,01-21,07:47
034 Vert Bois,0,16,16,2022,01-21,07:47
035 Malbosc,2,6,8,2022,01-21,07:47
036 Occitanie,5,27,32,2022,01-21,07:47
037 FacdesSciences,2,22,24,2022,01-21,07:47
038 Fac de Lettres,6,10,16,2022,01-21,07:47
039 Aiguelongue,1,7,8,2022,01-21,07:47
040 Jeu de Mail des Abb�s,3,5,8,2022,01-21,07:47
041 Eurom�decine,2,6,8,2022,01-21,07:47
042 Marie Caizergues,8,0,8,2022,01-21,07:47
043 Sabines,5,3,8,2022,01-21,07:47
044 Celleneuve,1,7,8,2022,01-21,07:47
045 Jardin de la Lironde,5,3,8,2022,01-21,07:47
046 P�re Soulas,5,3,8,2022,01-21,07:47
047 Place Viala,5,3,8,2022,01-21,07:47
048 H�tel du D�partement,5,3,8,2022,01-21,07:47
049 Tonnelles,3,5,8,2022,01-21,07:47
050 Parvis Jules Ferry - Gare Saint-Roch,7,1,8,2022,01-21,07:47
051 Pont de Lattes - Gare Saint-Roch,0,12,12,2022,01-21,07:47
053 Deux Ponts - Gare Saint-Roch,2,6,8,2022,01-21,07:47
054 Providence - Ovalie,3,5,8,2022,01-21,07:47
055 P�rols Etang de l'Or,26,42,68,2022,01-21,07:47
056 Albert 1er - Cath�drale,0,12,12,2022,01-21,07:47
057 Saint-Guilhem - Courreau,1,7,8,2022,01-21,07:47
059 Sud De France,3,5,8,2022,01-21,07:47
001 Rue Jules Ferry - Gare Saint-Roch,5,7,12,2022,01-21,07:57
002 Com�die,4,20,24,2022,01-21,07:57
003 Esplanade,2,30,32,2022,01-21,07:57
004 H�tel de Ville,7,9,16,2022,01-21,07:57
005 Corum,4,8,12,2022,01-21,07:57
006 Place Albert 1er - St Charles,23,8,31,2022,01-21,07:57
007 Foch,2,6,8,2022,01-21,07:57
008 Halles Castellane,10,2,12,2022,01-21,07:57
009 Observatoire,4,4,8,2022,01-21,07:57
010 Rondelet,1,15,16,2022,01-21,07:57
011 Plan Cabanes,4,8,12,2022,01-21,07:57
012 Boutonnet,2,10,12,2022,01-21,07:57
013 Emile Combes,7,1,8,2022,01-21,07:57
014 Beaux-Arts,3,5,8,2022,01-21,07:57
015 Les Aubes,7,1,8,2022,01-21,07:57
016 Antigone centre,7,9,16,2022,01-21,07:57
017 M�diath�que Emile Zola,6,10,16,2022,01-21,07:57
018 Nombre d'Or,10,6,16,2022,01-21,07:57
019 Louis Blanc,15,1,16,2022,01-21,07:57
020 Gambetta,2,6,8,2022,01-21,07:57
021 Port Marianne,11,5,16,2022,01-21,07:57
022 Clemenceau,7,5,12,2022,01-21,07:57
023 Les Arceaux,3,13,16,2022,01-21,07:57
024 Cit� Mion,4,4,8,2022,01-21,07:57
025 Nouveau Saint-Roch,6,2,8,2022,01-21,07:57
026 Renouvier,2,6,8,2022,01-21,07:57
027 Odysseum,4,4,8,2022,01-21,07:57
028 Saint-Denis,5,3,8,2022,01-21,07:57
029 Richter,7,9,16,2022,01-21,07:57
030 Charles Flahault,0,8,8,2022,01-21,07:57
031 Voltaire,4,4,8,2022,01-21,07:57
032 Pr�s d'Ar�nes,3,5,8,2022,01-21,07:57
033 Garcia Lorca,8,0,8,2022,01-21,07:57
034 Vert Bois,0,16,16,2022,01-21,07:57
035 Malbosc,2,6,8,2022,01-21,07:57
036 Occitanie,5,27,32,2022,01-21,07:57
037 FacdesSciences,5,19,24,2022,01-21,07:57
038 Fac de Lettres,6,10,16,2022,01-21,07:57
039 Aiguelongue,1,7,8,2022,01-21,07:57
040 Jeu de Mail des Abb�s,3,5,8,2022,01-21,07:57
041 Eurom�decine,2,6,8,2022,01-21,07:57
042 Marie Caizergues,8,0,8,2022,01-21,07:57
043 Sabines,5,3,8,2022,01-21,07:57
044 Celleneuve,1,7,8,2022,01-21,07:57
045 Jardin de la Lironde,5,3,8,2022,01-21,07:57
046 P�re Soulas,5,3,8,2022,01-21,07:57
047 Place Viala,5,3,8,2022,01-21,07:57
048 H�tel du D�partement,5,3,8,2022,01-21,07:57
049 Tonnelles,3,5,8,2022,01-21,07:57
050 Parvis Jules Ferry - Gare Saint-Roch,7,1,8,2022,01-21,07:57
051 Pont de Lattes - Gare Saint-Roch,0,12,12,2022,01-21,07:57
053 Deux Ponts - Gare Saint-Roch,2,6,8,2022,01-21,07:57
054 Providence - Ovalie,3,5,8,2022,01-21,07:57
055 P�rols Etang de l'Or,26,42,68,2022,01-21,07:57
056 Albert 1er - Cath�drale,0,12,12,2022,01-21,07:57
057 Saint-Guilhem - Courreau,1,7,8,2022,01-21,07:57
059 Sud De France,3,5,8,2022,01-21,07:57
001 Rue Jules Ferry - Gare Saint-Roch,3,9,12,2022,01-21,08:07
002 Com�die,4,20,24,2022,01-21,08:07
003 Esplanade,19,13,32,2022,01-21,08:07
004 H�tel de Ville,7,9,16,2022,01-21,08:07
005 Corum,4,8,12,2022,01-21,08:07
006 Place Albert 1er - St Charles,22,9,31,2022,01-21,08:07
007 Foch,2,6,8,2022,01-21,08:07
008 Halles Castellane,10,2,12,2022,01-21,08:07
009 Observatoire,4,4,8,2022,01-21,08:07
010 Rondelet,1,15,16,2022,01-21,08:07
011 Plan Cabanes,4,8,12,2022,01-21,08:07
012 Boutonnet,2,10,12,2022,01-21,08:07
013 Emile Combes,7,1,8,2022,01-21,08:07
014 Beaux-Arts,3,5,8,2022,01-21,08:07
015 Les Aubes,7,1,8,2022,01-21,08:07
016 Antigone centre,7,9,16,2022,01-21,08:07
017 M�diath�que Emile Zola,6,10,16,2022,01-21,08:07
018 Nombre d'Or,10,6,16,2022,01-21,08:07
019 Louis Blanc,15,1,16,2022,01-21,08:07
020 Gambetta,2,6,8,2022,01-21,08:07
021 Port Marianne,11,5,16,2022,01-21,08:07
022 Clemenceau,7,5,12,2022,01-21,08:07
023 Les Arceaux,3,13,16,2022,01-21,08:07
024 Cit� Mion,4,4,8,2022,01-21,08:07
025 Nouveau Saint-Roch,6,2,8,2022,01-21,08:07
026 Renouvier,2,6,8,2022,01-21,08:07
027 Odysseum,4,4,8,2022,01-21,08:07
028 Saint-Denis,5,3,8,2022,01-21,08:07
029 Richter,7,9,16,2022,01-21,08:07
030 Charles Flahault,0,8,8,2022,01-21,08:07
031 Voltaire,4,4,8,2022,01-21,08:07
032 Pr�s d'Ar�nes,4,4,8,2022,01-21,08:07
033 Garcia Lorca,8,0,8,2022,01-21,08:07
034 Vert Bois,0,16,16,2022,01-21,08:07
035 Malbosc,2,6,8,2022,01-21,08:07
036 Occitanie,4,28,32,2022,01-21,08:07
037 FacdesSciences,5,19,24,2022,01-21,08:07
038 Fac de Lettres,6,10,16,2022,01-21,08:07
039 Aiguelongue,1,7,8,2022,01-21,08:07
040 Jeu de Mail des Abb�s,3,5,8,2022,01-21,08:07
041 Eurom�decine,2,6,8,2022,01-21,08:07
042 Marie Caizergues,8,0,8,2022,01-21,08:07
043 Sabines,5,3,8,2022,01-21,08:07
044 Celleneuve,1,7,8,2022,01-21,08:07
045 Jardin de la Lironde,5,3,8,2022,01-21,08:07
046 P�re Soulas,4,4,8,2022,01-21,08:07
047 Place Viala,5,3,8,2022,01-21,08:07
048 H�tel du D�partement,5,3,8,2022,01-21,08:07
049 Tonnelles,3,5,8,2022,01-21,08:07
050 Parvis Jules Ferry - Gare Saint-Roch,7,1,8,2022,01-21,08:07
051 Pont de Lattes - Gare Saint-Roch,0,12,12,2022,01-21,08:07
053 Deux Ponts - Gare Saint-Roch,2,6,8,2022,01-21,08:07
054 Providence - Ovalie,3,5,8,2022,01-21,08:07
055 P�rols Etang de l'Or,26,42,68,2022,01-21,08:07
056 Albert 1er - Cath�drale,0,12,12,2022,01-21,08:07
057 Saint-Guilhem - Courreau,1,7,8,2022,01-21,08:07
059 Sud De France,3,5,8,2022,01-21,08:07
001 Rue Jules Ferry - Gare Saint-Roch,3,9,12,2022,01-21,08:18
002 Com�die,4,20,24,2022,01-21,08:18
003 Esplanade,19,13,32,2022,01-21,08:18
004 H�tel de Ville,7,9,16,2022,01-21,08:18
005 Corum,4,8,12,2022,01-21,08:18
006 Place Albert 1er - St Charles,22,9,31,2022,01-21,08:18
007 Foch,2,6,8,2022,01-21,08:18
008 Halles Castellane,10,2,12,2022,01-21,08:18
009 Observatoire,4,4,8,2022,01-21,08:18
010 Rondelet,1,15,16,2022,01-21,08:18
011 Plan Cabanes,4,8,12,2022,01-21,08:18
012 Boutonnet,2,10,12,2022,01-21,08:18
013 Emile Combes,7,1,8,2022,01-21,08:18
014 Beaux-Arts,3,5,8,2022,01-21,08:18
015 Les Aubes,5,3,8,2022,01-21,08:18
016 Antigone centre,7,9,16,2022,01-21,08:18
017 M�diath�que Emile Zola,6,10,16,2022,01-21,08:18
018 Nombre d'Or,10,6,16,2022,01-21,08:18
019 Louis Blanc,15,1,16,2022,01-21,08:18
020 Gambetta,2,6,8,2022,01-21,08:18
021 Port Marianne,11,5,16,2022,01-21,08:18
022 Clemenceau,7,5,12,2022,01-21,08:18
023 Les Arceaux,3,13,16,2022,01-21,08:18
024 Cit� Mion,4,4,8,2022,01-21,08:18
025 Nouveau Saint-Roch,6,2,8,2022,01-21,08:18
026 Renouvier,2,6,8,2022,01-21,08:18
027 Odysseum,4,4,8,2022,01-21,08:18
028 Saint-Denis,5,3,8,2022,01-21,08:18
029 Richter,7,9,16,2022,01-21,08:18
030 Charles Flahault,0,8,8,2022,01-21,08:18
031 Voltaire,4,4,8,2022,01-21,08:18
032 Pr�s d'Ar�nes,4,4,8,2022,01-21,08:18
033 Garcia Lorca,7,1,8,2022,01-21,08:18
034 Vert Bois,0,16,16,2022,01-21,08:18
035 Malbosc,2,6,8,2022,01-21,08:18
036 Occitanie,4,28,32,2022,01-21,08:18
037 FacdesSciences,5,19,24,2022,01-21,08:18
038 Fac de Lettres,6,10,16,2022,01-21,08:18
039 Aiguelongue,1,7,8,2022,01-21,08:18
040 Jeu de Mail des Abb�s,4,4,8,2022,01-21,08:18
041 Eurom�decine,2,6,8,2022,01-21,08:18
042 Marie Caizergues,7,1,8,2022,01-21,08:18
043 Sabines,5,3,8,2022,01-21,08:18
044 Celleneuve,0,8,8,2022,01-21,08:18
045 Jardin de la Lironde,5,3,8,2022,01-21,08:18
046 P�re Soulas,4,4,8,2022,01-21,08:18
047 Place Viala,5,3,8,2022,01-21,08:18
048 H�tel du D�partement,5,3,8,2022,01-21,08:18
049 Tonnelles,3,5,8,2022,01-21,08:18
050 Parvis Jules Ferry - Gare Saint-Roch,7,1,8,2022,01-21,08:18
051 Pont de Lattes - Gare Saint-Roch,0,12,12,2022,01-21,08:18
053 Deux Ponts - Gare Saint-Roch,2,6,8,2022,01-21,08:18
054 Providence - Ovalie,3,5,8,2022,01-21,08:18
055 P�rols Etang de l'Or,26,42,68,2022,01-21,08:18
056 Albert 1er - Cath�drale,0,12,12,2022,01-21,08:18
057 Saint-Guilhem - Courreau,1,7,8,2022,01-21,08:18
059 Sud De France,3,5,8,2022,01-21,08:18
001 Rue Jules Ferry - Gare Saint-Roch,4,8,12,2022,01-21,08:28
002 Com�die,4,20,24,2022,01-21,08:28
003 Esplanade,19,13,32,2022,01-21,08:28
004 H�tel de Ville,7,9,16,2022,01-21,08:28
005 Corum,5,7,12,2022,01-21,08:28
006 Place Albert 1er - St Charles,22,9,31,2022,01-21,08:28
007 Foch,2,6,8,2022,01-21,08:28
008 Halles Castellane,11,1,12,2022,01-21,08:28
009 Observatoire,4,4,8,2022,01-21,08:28
010 Rondelet,1,15,16,2022,01-21,08:28
011 Plan Cabanes,4,8,12,2022,01-21,08:28
012 Boutonnet,2,10,12,2022,01-21,08:28
013 Emile Combes,7,1,8,2022,01-21,08:28
014 Beaux-Arts,3,5,8,2022,01-21,08:28
015 Les Aubes,5,3,8,2022,01-21,08:28
016 Antigone centre,7,9,16,2022,01-21,08:28
017 M�diath�que Emile Zola,7,9,16,2022,01-21,08:28
018 Nombre d'Or,10,6,16,2022,01-21,08:28
019 Louis Blanc,15,1,16,2022,01-21,08:28
020 Gambetta,3,5,8,2022,01-21,08:28
021 Port Marianne,11,5,16,2022,01-21,08:28
022 Clemenceau,7,5,12,2022,01-21,08:28
023 Les Arceaux,3,13,16,2022,01-21,08:28
024 Cit� Mion,4,4,8,2022,01-21,08:28
025 Nouveau Saint-Roch,6,2,8,2022,01-21,08:28
026 Renouvier,2,6,8,2022,01-21,08:28
027 Odysseum,4,4,8,2022,01-21,08:28
028 Saint-Denis,5,3,8,2022,01-21,08:28
029 Richter,7,9,16,2022,01-21,08:28
030 Charles Flahault,0,8,8,2022,01-21,08:28
031 Voltaire,4,4,8,2022,01-21,08:28
032 Pr�s d'Ar�nes,4,4,8,2022,01-21,08:28
033 Garcia Lorca,2,6,8,2022,01-21,08:28
034 Vert Bois,0,16,16,2022,01-21,08:28
035 Malbosc,2,6,8,2022,01-21,08:28
036 Occitanie,4,28,32,2022,01-21,08:28
037 FacdesSciences,4,20,24,2022,01-21,08:28
038 Fac de Lettres,6,10,16,2022,01-21,08:28
039 Aiguelongue,1,7,8,2022,01-21,08:28
040 Jeu de Mail des Abb�s,4,4,8,2022,01-21,08:28
041 Eurom�decine,2,6,8,2022,01-21,08:28
042 Marie Caizergues,7,1,8,2022,01-21,08:28
043 Sabines,5,3,8,2022,01-21,08:28
044 Celleneuve,1,7,8,2022,01-21,08:28
045 Jardin de la Lironde,5,3,8,2022,01-21,08:28
046 P�re Soulas,4,4,8,2022,01-21,08:28
047 Place Viala,5,3,8,2022,01-21,08:28
048 H�tel du D�partement,5,3,8,2022,01-21,08:28
049 Tonnelles,3,5,8,2022,01-21,08:28
050 Parvis Jules Ferry - Gare Saint-Roch,8,0,8,2022,01-21,08:28
051 Pont de Lattes - Gare Saint-Roch,0,12,12,2022,01-21,08:28
053 Deux Ponts - Gare Saint-Roch,2,6,8,2022,01-21,08:28
054 Providence - Ovalie,3,5,8,2022,01-21,08:28
055 P�rols Etang de l'Or,26,42,68,2022,01-21,08:28
056 Albert 1er - Cath�drale,0,12,12,2022,01-21,08:28
057 Saint-Guilhem - Courreau,0,8,8,2022,01-21,08:28
059 Sud De France,3,5,8,2022,01-21,08:28
001 Rue Jules Ferry - Gare Saint-Roch,3,9,12,2022,01-21,08:38
002 Com�die,4,20,24,2022,01-21,08:38
003 Esplanade,18,14,32,2022,01-21,08:38
004 H�tel de Ville,7,9,16,2022,01-21,08:38
005 Corum,5,7,12,2022,01-21,08:38
006 Place Albert 1er - St Charles,22,9,31,2022,01-21,08:38
007 Foch,2,6,8,2022,01-21,08:38
008 Halles Castellane,11,1,12,2022,01-21,08:38
009 Observatoire,4,4,8,2022,01-21,08:38
010 Rondelet,1,15,16,2022,01-21,08:38
011 Plan Cabanes,4,8,12,2022,01-21,08:38
012 Boutonnet,2,10,12,2022,01-21,08:38
013 Emile Combes,7,1,8,2022,01-21,08:38
014 Beaux-Arts,3,5,8,2022,01-21,08:38
015 Les Aubes,5,3,8,2022,01-21,08:38
016 Antigone centre,7,9,16,2022,01-21,08:38
017 M�diath�que Emile Zola,6,10,16,2022,01-21,08:38
018 Nombre d'Or,11,5,16,2022,01-21,08:38
019 Louis Blanc,14,2,16,2022,01-21,08:38
020 Gambetta,3,5,8,2022,01-21,08:38
021 Port Marianne,11,5,16,2022,01-21,08:38
022 Clemenceau,7,5,12,2022,01-21,08:38
023 Les Arceaux,3,13,16,2022,01-21,08:38
024 Cit� Mion,4,4,8,2022,01-21,08:38
025 Nouveau Saint-Roch,6,2,8,2022,01-21,08:38
026 Renouvier,1,7,8,2022,01-21,08:38
027 Odysseum,4,4,8,2022,01-21,08:38
028 Saint-Denis,5,3,8,2022,01-21,08:38
029 Richter,8,8,16,2022,01-21,08:38
030 Charles Flahault,0,8,8,2022,01-21,08:38
031 Voltaire,4,4,8,2022,01-21,08:38
032 Pr�s d'Ar�nes,4,4,8,2022,01-21,08:38
033 Garcia Lorca,2,6,8,2022,01-21,08:38
034 Vert Bois,0,16,16,2022,01-21,08:38
035 Malbosc,2,6,8,2022,01-21,08:38
036 Occitanie,4,28,32,2022,01-21,08:38
037 FacdesSciences,4,20,24,2022,01-21,08:38
038 Fac de Lettres,6,10,16,2022,01-21,08:38
039 Aiguelongue,1,7,8,2022,01-21,08:38
040 Jeu de Mail des Abb�s,4,4,8,2022,01-21,08:38
041 Eurom�decine,2,6,8,2022,01-21,08:38
042 Marie Caizergues,7,1,8,2022,01-21,08:38
043 Sabines,5,3,8,2022,01-21,08:38
044 Celleneuve,1,7,8,2022,01-21,08:38
045 Jardin de la Lironde,4,4,8,2022,01-21,08:38
046 P�re Soulas,4,4,8,2022,01-21,08:38
047 Place Viala,4,4,8,2022,01-21,08:38
048 H�tel du D�partement,5,3,8,2022,01-21,08:38
049 Tonnelles,3,5,8,2022,01-21,08:38
050 Parvis Jules Ferry - Gare Saint-Roch,8,0,8,2022,01-21,08:38
051 Pont de Lattes - Gare Saint-Roch,0,12,12,2022,01-21,08:38
053 Deux Ponts - Gare Saint-Roch,2,6,8,2022,01-21,08:38
054 Providence - Ovalie,3,5,8,2022,01-21,08:38
055 P�rols Etang de l'Or,26,42,68,2022,01-21,08:38
056 Albert 1er - Cath�drale,0,12,12,2022,01-21,08:38
057 Saint-Guilhem - Courreau,0,8,8,2022,01-21,08:38
059 Sud De France,3,5,8,2022,01-21,08:38
001 Rue Jules Ferry - Gare Saint-Roch,3,9,12,2022,01-21,08:48
002 Com�die,13,11,24,2022,01-21,08:48
003 Esplanade,18,14,32,2022,01-21,08:48
004 H�tel de Ville,7,9,16,2022,01-21,08:48
005 Corum,5,7,12,2022,01-21,08:48
006 Place Albert 1er - St Charles,22,9,31,2022,01-21,08:48
007 Foch,2,6,8,2022,01-21,08:48
008 Halles Castellane,9,3,12,2022,01-21,08:48
009 Observatoire,4,4,8,2022,01-21,08:48
010 Rondelet,1,15,16,2022,01-21,08:48
011 Plan Cabanes,2,10,12,2022,01-21,08:48
012 Boutonnet,2,10,12,2022,01-21,08:48
013 Emile Combes,7,1,8,2022,01-21,08:48
014 Beaux-Arts,3,5,8,2022,01-21,08:48
015 Les Aubes,5,3,8,2022,01-21,08:48
016 Antigone centre,6,10,16,2022,01-21,08:48
017 M�diath�que Emile Zola,7,9,16,2022,01-21,08:48
018 Nombre d'Or,11,5,16,2022,01-21,08:48
019 Louis Blanc,13,3,16,2022,01-21,08:48
020 Gambetta,3,5,8,2022,01-21,08:48
021 Port Marianne,12,4,16,2022,01-21,08:48
022 Clemenceau,7,5,12,2022,01-21,08:48
023 Les Arceaux,2,14,16,2022,01-21,08:48
024 Cit� Mion,4,4,8,2022,01-21,08:48
025 Nouveau Saint-Roch,5,3,8,2022,01-21,08:48
026 Renouvier,1,7,8,2022,01-21,08:48
027 Odysseum,4,4,8,2022,01-21,08:48
028 Saint-Denis,5,3,8,2022,01-21,08:48
029 Richter,8,8,16,2022,01-21,08:48
030 Charles Flahault,1,7,8,2022,01-21,08:48
031 Voltaire,3,5,8,2022,01-21,08:48
032 Pr�s d'Ar�nes,4,4,8,2022,01-21,08:48
033 Garcia Lorca,2,6,8,2022,01-21,08:48
034 Vert Bois,0,16,16,2022,01-21,08:48
035 Malbosc,2,6,8,2022,01-21,08:48
036 Occitanie,4,28,32,2022,01-21,08:48
037 FacdesSciences,4,20,24,2022,01-21,08:48
038 Fac de Lettres,7,9,16,2022,01-21,08:48
039 Aiguelongue,1,7,8,2022,01-21,08:48
040 Jeu de Mail des Abb�s,4,4,8,2022,01-21,08:48
041 Eurom�decine,2,6,8,2022,01-21,08:48
042 Marie Caizergues,7,1,8,2022,01-21,08:48
043 Sabines,5,3,8,2022,01-21,08:48
044 Celleneuve,1,7,8,2022,01-21,08:48
045 Jardin de la Lironde,4,4,8,2022,01-21,08:48
046 P�re Soulas,4,4,8,2022,01-21,08:48
047 Place Viala,4,4,8,2022,01-21,08:48
048 H�tel du D�partement,5,3,8,2022,01-21,08:48
049 Tonnelles,3,5,8,2022,01-21,08:48
050 Parvis Jules Ferry - Gare Saint-Roch,8,0,8,2022,01-21,08:48
051 Pont de Lattes - Gare Saint-Roch,0,12,12,2022,01-21,08:48
053 Deux Ponts - Gare Saint-Roch,2,6,8,2022,01-21,08:48
054 Providence - Ovalie,3,5,8,2022,01-21,08:48
055 P�rols Etang de l'Or,26,42,68,2022,01-21,08:48
056 Albert 1er - Cath�drale,0,12,12,2022,01-21,08:48
057 Saint-Guilhem - Courreau,0,8,8,2022,01-21,08:48
059 Sud De France,3,5,8,2022,01-21,08:48
001 Rue Jules Ferry - Gare Saint-Roch,3,9,12,2022,01-21,08:58
002 Com�die,13,11,24,2022,01-21,08:58
003 Esplanade,18,14,32,2022,01-21,08:58
004 H�tel de Ville,7,9,16,2022,01-21,08:58
005 Corum,5,7,12,2022,01-21,08:58
006 Place Albert 1er - St Charles,22,9,31,2022,01-21,08:58
007 Foch,2,6,8,2022,01-21,08:58
008 Halles Castellane,9,3,12,2022,01-21,08:58
009 Observatoire,4,4,8,2022,01-21,08:58
010 Rondelet,1,15,16,2022,01-21,08:58
011 Plan Cabanes,2,10,12,2022,01-21,08:58
012 Boutonnet,2,10,12,2022,01-21,08:58
013 Emile Combes,7,1,8,2022,01-21,08:58
014 Beaux-Arts,3,5,8,2022,01-21,08:58
015 Les Aubes,5,3,8,2022,01-21,08:58
016 Antigone centre,6,10,16,2022,01-21,08:58
017 M�diath�que Emile Zola,7,9,16,2022,01-21,08:58
018 Nombre d'Or,11,5,16,2022,01-21,08:58
019 Louis Blanc,9,7,16,2022,01-21,08:58
020 Gambetta,3,5,8,2022,01-21,08:58
021 Port Marianne,13,3,16,2022,01-21,08:58
022 Clemenceau,7,5,12,2022,01-21,08:58
023 Les Arceaux,2,14,16,2022,01-21,08:58
024 Cit� Mion,4,4,8,2022,01-21,08:58
025 Nouveau Saint-Roch,5,3,8,2022,01-21,08:58
026 Renouvier,1,7,8,2022,01-21,08:58
027 Odysseum,4,4,8,2022,01-21,08:58
028 Saint-Denis,5,3,8,2022,01-21,08:58
029 Richter,8,8,16,2022,01-21,08:58
030 Charles Flahault,1,7,8,2022,01-21,08:58
031 Voltaire,3,5,8,2022,01-21,08:58
032 Pr�s d'Ar�nes,4,4,8,2022,01-21,08:58
033 Garcia Lorca,2,6,8,2022,01-21,08:58
034 Vert Bois,0,16,16,2022,01-21,08:58
035 Malbosc,3,5,8,2022,01-21,08:58
036 Occitanie,4,28,32,2022,01-21,08:58
037 FacdesSciences,4,20,24,2022,01-21,08:58
038 Fac de Lettres,7,9,16,2022,01-21,08:58
039 Aiguelongue,1,7,8,2022,01-21,08:58
040 Jeu de Mail des Abb�s,6,2,8,2022,01-21,08:58
041 Eurom�decine,2,6,8,2022,01-21,08:58
042 Marie Caizergues,7,1,8,2022,01-21,08:58
043 Sabines,5,3,8,2022,01-21,08:58
044 Celleneuve,1,7,8,2022,01-21,08:58
045 Jardin de la Lironde,6,2,8,2022,01-21,08:58
046 P�re Soulas,4,4,8,2022,01-21,08:58
047 Place Viala,4,4,8,2022,01-21,08:58
048 H�tel du D�partement,5,3,8,2022,01-21,08:58
049 Tonnelles,3,5,8,2022,01-21,08:58
050 Parvis Jules Ferry - Gare Saint-Roch,8,0,8,2022,01-21,08:58
051 Pont de Lattes - Gare Saint-Roch,0,12,12,2022,01-21,08:58
053 Deux Ponts - Gare Saint-Roch,2,6,8,2022,01-21,08:58
054 Providence - Ovalie,3,5,8,2022,01-21,08:58
055 P�rols Etang de l'Or,26,42,68,2022,01-21,08:58
056 Albert 1er - Cath�drale,0,12,12,2022,01-21,08:58
057 Saint-Guilhem - Courreau,1,7,8,2022,01-21,08:58
059 Sud De France,3,5,8,2022,01-21,08:58
001 Rue Jules Ferry - Gare Saint-Roch,3,9,12,2022,01-21,09:08
002 Com�die,13,11,24,2022,01-21,09:08
003 Esplanade,18,14,32,2022,01-21,09:08
004 H�tel de Ville,7,9,16,2022,01-21,09:08
005 Corum,5,7,12,2022,01-21,09:08
006 Place Albert 1er - St Charles,22,9,31,2022,01-21,09:08
007 Foch,2,6,8,2022,01-21,09:08
008 Halles Castellane,9,3,12,2022,01-21,09:08
009 Observatoire,4,4,8,2022,01-21,09:08
010 Rondelet,1,15,16,2022,01-21,09:08
011 Plan Cabanes,2,10,12,2022,01-21,09:08
012 Boutonnet,2,10,12,2022,01-21,09:08
013 Emile Combes,7,1,8,2022,01-21,09:08
014 Beaux-Arts,3,5,8,2022,01-21,09:08
015 Les Aubes,5,3,8,2022,01-21,09:08
016 Antigone centre,6,10,16,2022,01-21,09:08
017 M�diath�que Emile Zola,7,9,16,2022,01-21,09:08
018 Nombre d'Or,11,5,16,2022,01-21,09:08
019 Louis Blanc,6,10,16,2022,01-21,09:08
020 Gambetta,3,5,8,2022,01-21,09:08
021 Port Marianne,13,3,16,2022,01-21,09:08
022 Clemenceau,7,5,12,2022,01-21,09:08
023 Les Arceaux,2,14,16,2022,01-21,09:08
024 Cit� Mion,4,4,8,2022,01-21,09:08
025 Nouveau Saint-Roch,5,3,8,2022,01-21,09:08
026 Renouvier,1,7,8,2022,01-21,09:08
027 Odysseum,4,4,8,2022,01-21,09:08
028 Saint-Denis,5,3,8,2022,01-21,09:08
029 Richter,8,8,16,2022,01-21,09:08
030 Charles Flahault,1,7,8,2022,01-21,09:08
031 Voltaire,3,5,8,2022,01-21,09:08
032 Pr�s d'Ar�nes,4,4,8,2022,01-21,09:08
033 Garcia Lorca,2,6,8,2022,01-21,09:08
034 Vert Bois,0,16,16,2022,01-21,09:08
035 Malbosc,3,5,8,2022,01-21,09:08
036 Occitanie,4,28,32,2022,01-21,09:08
037 FacdesSciences,4,20,24,2022,01-21,09:08
038 Fac de Lettres,8,8,16,2022,01-21,09:08
039 Aiguelongue,1,7,8,2022,01-21,09:08
040 Jeu de Mail des Abb�s,6,2,8,2022,01-21,09:08
041 Eurom�decine,2,6,8,2022,01-21,09:08
042 Marie Caizergues,7,1,8,2022,01-21,09:08
043 Sabines,5,3,8,2022,01-21,09:08
044 Celleneuve,1,7,8,2022,01-21,09:08
045 Jardin de la Lironde,6,2,8,2022,01-21,09:08
046 P�re Soulas,4,4,8,2022,01-21,09:08
047 Place Viala,5,3,8,2022,01-21,09:08
048 H�tel du D�partement,5,3,8,2022,01-21,09:08
049 Tonnelles,3,5,8,2022,01-21,09:08
050 Parvis Jules Ferry - Gare Saint-Roch,8,0,8,2022,01-21,09:08
051 Pont de Lattes - Gare Saint-Roch,0,12,12,2022,01-21,09:08
053 Deux Ponts - Gare Saint-Roch,2,6,8,2022,01-21,09:08
054 Providence - Ovalie,3,5,8,2022,01-21,09:08
055 P�rols Etang de l'Or,26,42,68,2022,01-21,09:08
056 Albert 1er - Cath�drale,6,6,12,2022,01-21,09:08
057 Saint-Guilhem - Courreau,2,6,8,2022,01-21,09:08
059 Sud De France,3,5,8,2022,01-21,09:08
001 Rue Jules Ferry - Gare Saint-Roch,3,9,12,2022,01-21,09:19
002 Com�die,13,11,24,2022,01-21,09:19
003 Esplanade,18,14,32,2022,01-21,09:19
004 H�tel de Ville,7,9,16,2022,01-21,09:19
005 Corum,5,7,12,2022,01-21,09:19
006 Place Albert 1er - St Charles,22,9,31,2022,01-21,09:19
007 Foch,2,6,8,2022,01-21,09:19
008 Halles Castellane,9,3,12,2022,01-21,09:19
009 Observatoire,4,4,8,2022,01-21,09:19
010 Rondelet,1,15,16,2022,01-21,09:19
011 Plan Cabanes,2,10,12,2022,01-21,09:19
012 Boutonnet,2,10,12,2022,01-21,09:19
013 Emile Combes,7,1,8,2022,01-21,09:19
014 Beaux-Arts,3,5,8,2022,01-21,09:19
015 Les Aubes,4,4,8,2022,01-21,09:19
016 Antigone centre,6,10,16,2022,01-21,09:19
017 M�diath�que Emile Zola,7,9,16,2022,01-21,09:19
018 Nombre d'Or,10,6,16,2022,01-21,09:19
019 Louis Blanc,6,10,16,2022,01-21,09:19
020 Gambetta,3,5,8,2022,01-21,09:19
021 Port Marianne,13,3,16,2022,01-21,09:19
022 Clemenceau,7,5,12,2022,01-21,09:19
023 Les Arceaux,2,14,16,2022,01-21,09:19
024 Cit� Mion,4,4,8,2022,01-21,09:19
025 Nouveau Saint-Roch,6,2,8,2022,01-21,09:19
026 Renouvier,1,7,8,2022,01-21,09:19
027 Odysseum,4,4,8,2022,01-21,09:19
028 Saint-Denis,5,3,8,2022,01-21,09:19
029 Richter,8,8,16,2022,01-21,09:19
030 Charles Flahault,1,7,8,2022,01-21,09:19
031 Voltaire,3,5,8,2022,01-21,09:19
032 Pr�s d'Ar�nes,3,5,8,2022,01-21,09:19
033 Garcia Lorca,2,6,8,2022,01-21,09:19
034 Vert Bois,0,16,16,2022,01-21,09:19
035 Malbosc,3,5,8,2022,01-21,09:19
036 Occitanie,4,28,32,2022,01-21,09:19
037 FacdesSciences,4,20,24,2022,01-21,09:19
038 Fac de Lettres,8,8,16,2022,01-21,09:19
039 Aiguelongue,1,7,8,2022,01-21,09:19
040 Jeu de Mail des Abb�s,6,2,8,2022,01-21,09:19
041 Eurom�decine,2,6,8,2022,01-21,09:19
042 Marie Caizergues,7,1,8,2022,01-21,09:19
043 Sabines,5,3,8,2022,01-21,09:19
044 Celleneuve,1,7,8,2022,01-21,09:19
045 Jardin de la Lironde,6,2,8,2022,01-21,09:19
046 P�re Soulas,4,4,8,2022,01-21,09:19
047 Place Viala,5,3,8,2022,01-21,09:19
048 H�tel du D�partement,5,3,8,2022,01-21,09:19
049 Tonnelles,3,5,8,2022,01-21,09:19
050 Parvis Jules Ferry - Gare Saint-Roch,8,0,8,2022,01-21,09:19
051 Pont de Lattes - Gare Saint-Roch,0,12,12,2022,01-21,09:19
053 Deux Ponts - Gare Saint-Roch,2,6,8,2022,01-21,09:19
054 Providence - Ovalie,3,5,8,2022,01-21,09:19
055 P�rols Etang de l'Or,26,42,68,2022,01-21,09:19
056 Albert 1er - Cath�drale,6,6,12,2022,01-21,09:19
057 Saint-Guilhem - Courreau,1,7,8,2022,01-21,09:19
059 Sud De France,3,5,8,2022,01-21,09:19
001 Rue Jules Ferry - Gare Saint-Roch,3,9,12,2022,01-21,09:29
002 Com�die,14,10,24,2022,01-21,09:29
003 Esplanade,18,14,32,2022,01-21,09:29
004 H�tel de Ville,7,9,16,2022,01-21,09:29
005 Corum,5,7,12,2022,01-21,09:29
006 Place Albert 1er - St Charles,22,9,31,2022,01-21,09:29
007 Foch,2,6,8,2022,01-21,09:29
008 Halles Castellane,9,3,12,2022,01-21,09:29
009 Observatoire,4,4,8,2022,01-21,09:29
010 Rondelet,1,15,16,2022,01-21,09:29
011 Plan Cabanes,2,10,12,2022,01-21,09:29
012 Boutonnet,2,10,12,2022,01-21,09:29
013 Emile Combes,7,1,8,2022,01-21,09:29
014 Beaux-Arts,3,5,8,2022,01-21,09:29
015 Les Aubes,4,4,8,2022,01-21,09:29
016 Antigone centre,6,10,16,2022,01-21,09:29
017 M�diath�que Emile Zola,7,9,16,2022,01-21,09:29
018 Nombre d'Or,10,6,16,2022,01-21,09:29
019 Louis Blanc,6,10,16,2022,01-21,09:29
020 Gambetta,3,5,8,2022,01-21,09:29
021 Port Marianne,13,3,16,2022,01-21,09:29
022 Clemenceau,7,5,12,2022,01-21,09:29
023 Les Arceaux,2,14,16,2022,01-21,09:29
024 Cit� Mion,3,5,8,2022,01-21,09:29
025 Nouveau Saint-Roch,6,2,8,2022,01-21,09:29
026 Renouvier,1,7,8,2022,01-21,09:29
027 Odysseum,4,4,8,2022,01-21,09:29
028 Saint-Denis,5,3,8,2022,01-21,09:29
029 Richter,9,7,16,2022,01-21,09:29
030 Charles Flahault,1,7,8,2022,01-21,09:29
031 Voltaire,3,5,8,2022,01-21,09:29
032 Pr�s d'Ar�nes,3,5,8,2022,01-21,09:29
033 Garcia Lorca,1,7,8,2022,01-21,09:29
034 Vert Bois,0,16,16,2022,01-21,09:29
035 Malbosc,3,5,8,2022,01-21,09:29
036 Occitanie,3,29,32,2022,01-21,09:29
037 FacdesSciences,4,20,24,2022,01-21,09:29
038 Fac de Lettres,8,8,16,2022,01-21,09:29
039 Aiguelongue,1,7,8,2022,01-21,09:29
040 Jeu de Mail des Abb�s,6,2,8,2022,01-21,09:29
041 Eurom�decine,2,6,8,2022,01-21,09:29
042 Marie Caizergues,7,1,8,2022,01-21,09:29
043 Sabines,5,3,8,2022,01-21,09:29
044 Celleneuve,1,7,8,2022,01-21,09:29
045 Jardin de la Lironde,6,2,8,2022,01-21,09:29
046 P�re Soulas,4,4,8,2022,01-21,09:29
047 Place Viala,5,3,8,2022,01-21,09:29
048 H�tel du D�partement,5,3,8,2022,01-21,09:29
049 Tonnelles,2,6,8,2022,01-21,09:29
050 Parvis Jules Ferry - Gare Saint-Roch,8,0,8,2022,01-21,09:29
051 Pont de Lattes - Gare Saint-Roch,0,12,12,2022,01-21,09:29
053 Deux Ponts - Gare Saint-Roch,2,6,8,2022,01-21,09:29
054 Providence - Ovalie,3,5,8,2022,01-21,09:29
055 P�rols Etang de l'Or,26,42,68,2022,01-21,09:29
056 Albert 1er - Cath�drale,6,6,12,2022,01-21,09:29
057 Saint-Guilhem - Courreau,1,7,8,2022,01-21,09:29
059 Sud De France,3,5,8,2022,01-21,09:29
001 Rue Jules Ferry - Gare Saint-Roch,4,8,12,2022,01-21,09:39
002 Com�die,14,10,24,2022,01-21,09:39
003 Esplanade,18,14,32,2022,01-21,09:39
004 H�tel de Ville,7,9,16,2022,01-21,09:39
005 Corum,5,7,12,2022,01-21,09:39
006 Place Albert 1er - St Charles,22,9,31,2022,01-21,09:39
007 Foch,2,6,8,2022,01-21,09:39
008 Halles Castellane,9,3,12,2022,01-21,09:39
009 Observatoire,4,4,8,2022,01-21,09:39
010 Rondelet,1,15,16,2022,01-21,09:39
011 Plan Cabanes,2,10,12,2022,01-21,09:39
012 Boutonnet,2,10,12,2022,01-21,09:39
013 Emile Combes,7,1,8,2022,01-21,09:39
014 Beaux-Arts,3,5,8,2022,01-21,09:39
015 Les Aubes,4,4,8,2022,01-21,09:39
016 Antigone centre,6,10,16,2022,01-21,09:39
017 M�diath�que Emile Zola,7,9,16,2022,01-21,09:39
018 Nombre d'Or,10,6,16,2022,01-21,09:39
019 Louis Blanc,6,10,16,2022,01-21,09:39
020 Gambetta,3,5,8,2022,01-21,09:39
021 Port Marianne,14,2,16,2022,01-21,09:39
022 Clemenceau,7,5,12,2022,01-21,09:39
023 Les Arceaux,3,13,16,2022,01-21,09:39
024 Cit� Mion,3,5,8,2022,01-21,09:39
025 Nouveau Saint-Roch,6,2,8,2022,01-21,09:39
026 Renouvier,1,7,8,2022,01-21,09:39
027 Odysseum,4,4,8,2022,01-21,09:39
028 Saint-Denis,5,3,8,2022,01-21,09:39
029 Richter,9,7,16,2022,01-21,09:39
030 Charles Flahault,1,7,8,2022,01-21,09:39
031 Voltaire,2,6,8,2022,01-21,09:39
032 Pr�s d'Ar�nes,3,5,8,2022,01-21,09:39
033 Garcia Lorca,1,7,8,2022,01-21,09:39
034 Vert Bois,0,16,16,2022,01-21,09:39
035 Malbosc,3,5,8,2022,01-21,09:39
036 Occitanie,3,29,32,2022,01-21,09:39
037 FacdesSciences,5,19,24,2022,01-21,09:39
038 Fac de Lettres,8,8,16,2022,01-21,09:39
039 Aiguelongue,1,7,8,2022,01-21,09:39
040 Jeu de Mail des Abb�s,6,2,8,2022,01-21,09:39
041 Eurom�decine,2,6,8,2022,01-21,09:39
042 Marie Caizergues,7,1,8,2022,01-21,09:39
043 Sabines,5,3,8,2022,01-21,09:39
044 Celleneuve,1,7,8,2022,01-21,09:39
045 Jardin de la Lironde,6,2,8,2022,01-21,09:39
046 P�re Soulas,4,4,8,2022,01-21,09:39
047 Place Viala,4,4,8,2022,01-21,09:39
048 H�tel du D�partement,6,2,8,2022,01-21,09:39
049 Tonnelles,2,6,8,2022,01-21,09:39
050 Parvis Jules Ferry - Gare Saint-Roch,8,0,8,2022,01-21,09:39
051 Pont de Lattes - Gare Saint-Roch,0,12,12,2022,01-21,09:39
053 Deux Ponts - Gare Saint-Roch,2,6,8,2022,01-21,09:39
054 Providence - Ovalie,3,5,8,2022,01-21,09:39
055 P�rols Etang de l'Or,26,42,68,2022,01-21,09:39
056 Albert 1er - Cath�drale,6,6,12,2022,01-21,09:39
057 Saint-Guilhem - Courreau,1,7,8,2022,01-21,09:39
059 Sud De France,3,5,8,2022,01-21,09:39
001 Rue Jules Ferry - Gare Saint-Roch,3,9,12,2022,01-21,09:49
002 Com�die,13,11,24,2022,01-21,09:49
003 Esplanade,17,15,32,2022,01-21,09:49
004 H�tel de Ville,7,9,16,2022,01-21,09:49
005 Corum,5,7,12,2022,01-21,09:49
006 Place Albert 1er - St Charles,22,9,31,2022,01-21,09:49
007 Foch,2,6,8,2022,01-21,09:49
008 Halles Castellane,9,3,12,2022,01-21,09:49
009 Observatoire,4,4,8,2022,01-21,09:49
010 Rondelet,1,15,16,2022,01-21,09:49
011 Plan Cabanes,3,9,12,2022,01-21,09:49
012 Boutonnet,2,10,12,2022,01-21,09:49
013 Emile Combes,7,1,8,2022,01-21,09:49
014 Beaux-Arts,3,5,8,2022,01-21,09:49
015 Les Aubes,4,4,8,2022,01-21,09:49
016 Antigone centre,6,10,16,2022,01-21,09:49
017 M�diath�que Emile Zola,7,9,16,2022,01-21,09:49
018 Nombre d'Or,10,6,16,2022,01-21,09:49
019 Louis Blanc,6,10,16,2022,01-21,09:49
020 Gambetta,3,5,8,2022,01-21,09:49
021 Port Marianne,14,2,16,2022,01-21,09:49
022 Clemenceau,8,4,12,2022,01-21,09:49
023 Les Arceaux,3,13,16,2022,01-21,09:49
024 Cit� Mion,3,5,8,2022,01-21,09:49
025 Nouveau Saint-Roch,6,2,8,2022,01-21,09:49
026 Renouvier,1,7,8,2022,01-21,09:49
027 Odysseum,4,4,8,2022,01-21,09:49
028 Saint-Denis,5,3,8,2022,01-21,09:49
029 Richter,9,7,16,2022,01-21,09:49
030 Charles Flahault,1,7,8,2022,01-21,09:49
031 Voltaire,2,6,8,2022,01-21,09:49
032 Pr�s d'Ar�nes,3,5,8,2022,01-21,09:49
033 Garcia Lorca,1,7,8,2022,01-21,09:49
034 Vert Bois,0,16,16,2022,01-21,09:49
035 Malbosc,3,5,8,2022,01-21,09:49
036 Occitanie,3,29,32,2022,01-21,09:49
037 FacdesSciences,5,19,24,2022,01-21,09:49
038 Fac de Lettres,8,8,16,2022,01-21,09:49
039 Aiguelongue,1,7,8,2022,01-21,09:49
040 Jeu de Mail des Abb�s,6,2,8,2022,01-21,09:49
041 Eurom�decine,2,6,8,2022,01-21,09:49
042 Marie Caizergues,7,1,8,2022,01-21,09:49
043 Sabines,5,3,8,2022,01-21,09:49
044 Celleneuve,1,7,8,2022,01-21,09:49
045 Jardin de la Lironde,6,2,8,2022,01-21,09:49
046 P�re Soulas,4,4,8,2022,01-21,09:49
047 Place Viala,4,4,8,2022,01-21,09:49
048 H�tel du D�partement,6,2,8,2022,01-21,09:49
049 Tonnelles,2,6,8,2022,01-21,09:49
050 Parvis Jules Ferry - Gare Saint-Roch,7,1,8,2022,01-21,09:49
051 Pont de Lattes - Gare Saint-Roch,0,12,12,2022,01-21,09:49
053 Deux Ponts - Gare Saint-Roch,2,6,8,2022,01-21,09:49
054 Providence - Ovalie,3,5,8,2022,01-21,09:49
055 P�rols Etang de l'Or,26,42,68,2022,01-21,09:49
056 Albert 1er - Cath�drale,6,6,12,2022,01-21,09:49
057 Saint-Guilhem - Courreau,1,7,8,2022,01-21,09:49
059 Sud De France,3,5,8,2022,01-21,09:49
001 Rue Jules Ferry - Gare Saint-Roch,4,8,12,2022,01-21,09:59
002 Com�die,14,10,24,2022,01-21,09:59
003 Esplanade,17,15,32,2022,01-21,09:59
004 H�tel de Ville,7,9,16,2022,01-21,09:59
005 Corum,5,7,12,2022,01-21,09:59
006 Place Albert 1er - St Charles,21,10,31,2022,01-21,09:59
007 Foch,2,6,8,2022,01-21,09:59
008 Halles Castellane,9,3,12,2022,01-21,09:59
009 Observatoire,4,4,8,2022,01-21,09:59
010 Rondelet,1,15,16,2022,01-21,09:59
011 Plan Cabanes,3,9,12,2022,01-21,09:59
012 Boutonnet,2,10,12,2022,01-21,09:59
013 Emile Combes,7,1,8,2022,01-21,09:59
014 Beaux-Arts,3,5,8,2022,01-21,09:59
015 Les Aubes,4,4,8,2022,01-21,09:59
016 Antigone centre,6,10,16,2022,01-21,09:59
017 M�diath�que Emile Zola,7,9,16,2022,01-21,09:59
018 Nombre d'Or,10,6,16,2022,01-21,09:59
019 Louis Blanc,6,10,16,2022,01-21,09:59
020 Gambetta,3,5,8,2022,01-21,09:59
021 Port Marianne,14,2,16,2022,01-21,09:59
022 Clemenceau,7,5,12,2022,01-21,09:59
023 Les Arceaux,2,14,16,2022,01-21,09:59
024 Cit� Mion,3,5,8,2022,01-21,09:59
025 Nouveau Saint-Roch,6,2,8,2022,01-21,09:59
026 Renouvier,1,7,8,2022,01-21,09:59
027 Odysseum,4,4,8,2022,01-21,09:59
028 Saint-Denis,5,3,8,2022,01-21,09:59
029 Richter,9,7,16,2022,01-21,09:59
030 Charles Flahault,1,7,8,2022,01-21,09:59
031 Voltaire,2,6,8,2022,01-21,09:59
032 Pr�s d'Ar�nes,3,5,8,2022,01-21,09:59
033 Garcia Lorca,1,7,8,2022,01-21,09:59
034 Vert Bois,0,16,16,2022,01-21,09:59
035 Malbosc,3,5,8,2022,01-21,09:59
036 Occitanie,3,29,32,2022,01-21,09:59
037 FacdesSciences,5,19,24,2022,01-21,09:59
038 Fac de Lettres,8,8,16,2022,01-21,09:59
039 Aiguelongue,1,7,8,2022,01-21,09:59
040 Jeu de Mail des Abb�s,5,3,8,2022,01-21,09:59
041 Eurom�decine,2,6,8,2022,01-21,09:59
042 Marie Caizergues,7,1,8,2022,01-21,09:59
043 Sabines,5,3,8,2022,01-21,09:59
044 Celleneuve,1,7,8,2022,01-21,09:59
045 Jardin de la Lironde,6,2,8,2022,01-21,09:59
046 P�re Soulas,4,4,8,2022,01-21,09:59
047 Place Viala,4,4,8,2022,01-21,09:59
048 H�tel du D�partement,6,2,8,2022,01-21,09:59
049 Tonnelles,2,6,8,2022,01-21,09:59
050 Parvis Jules Ferry - Gare Saint-Roch,7,1,8,2022,01-21,09:59
051 Pont de Lattes - Gare Saint-Roch,0,12,12,2022,01-21,09:59
053 Deux Ponts - Gare Saint-Roch,2,6,8,2022,01-21,09:59
054 Providence - Ovalie,3,5,8,2022,01-21,09:59
055 P�rols Etang de l'Or,26,42,68,2022,01-21,09:59
056 Albert 1er - Cath�drale,6,6,12,2022,01-21,09:59
057 Saint-Guilhem - Courreau,1,7,8,2022,01-21,09:59
059 Sud De France,3,5,8,2022,01-21,09:59
001 Rue Jules Ferry - Gare Saint-Roch,3,9,12,2022,01-21,10:09
002 Com�die,14,10,24,2022,01-21,10:09
003 Esplanade,16,16,32,2022,01-21,10:09
004 H�tel de Ville,7,9,16,2022,01-21,10:09
005 Corum,5,7,12,2022,01-21,10:09
006 Place Albert 1er - St Charles,22,9,31,2022,01-21,10:09
007 Foch,2,6,8,2022,01-21,10:09
008 Halles Castellane,9,3,12,2022,01-21,10:09
009 Observatoire,4,4,8,2022,01-21,10:09
010 Rondelet,1,15,16,2022,01-21,10:09
011 Plan Cabanes,2,10,12,2022,01-21,10:09
012 Boutonnet,2,10,12,2022,01-21,10:09
013 Emile Combes,7,1,8,2022,01-21,10:09
014 Beaux-Arts,3,5,8,2022,01-21,10:09
015 Les Aubes,4,4,8,2022,01-21,10:09
016 Antigone centre,6,10,16,2022,01-21,10:09
017 M�diath�que Emile Zola,7,9,16,2022,01-21,10:09
018 Nombre d'Or,9,7,16,2022,01-21,10:09
019 Louis Blanc,6,10,16,2022,01-21,10:09
020 Gambetta,4,4,8,2022,01-21,10:09
021 Port Marianne,14,2,16,2022,01-21,10:09
022 Clemenceau,7,5,12,2022,01-21,10:09
023 Les Arceaux,2,14,16,2022,01-21,10:09
024 Cit� Mion,3,5,8,2022,01-21,10:09
025 Nouveau Saint-Roch,6,2,8,2022,01-21,10:09
026 Renouvier,1,7,8,2022,01-21,10:09
027 Odysseum,4,4,8,2022,01-21,10:09
028 Saint-Denis,5,3,8,2022,01-21,10:09
029 Richter,10,6,16,2022,01-21,10:09
030 Charles Flahault,1,7,8,2022,01-21,10:09
031 Voltaire,2,6,8,2022,01-21,10:09
032 Pr�s d'Ar�nes,3,5,8,2022,01-21,10:09
033 Garcia Lorca,1,7,8,2022,01-21,10:09
034 Vert Bois,0,16,16,2022,01-21,10:09
035 Malbosc,3,5,8,2022,01-21,10:09
036 Occitanie,3,29,32,2022,01-21,10:09
037 FacdesSciences,5,19,24,2022,01-21,10:09
038 Fac de Lettres,8,8,16,2022,01-21,10:09
039 Aiguelongue,1,7,8,2022,01-21,10:09
040 Jeu de Mail des Abb�s,5,3,8,2022,01-21,10:09
041 Eurom�decine,2,6,8,2022,01-21,10:09
042 Marie Caizergues,6,2,8,2022,01-21,10:09
043 Sabines,5,3,8,2022,01-21,10:09
044 Celleneuve,1,7,8,2022,01-21,10:09
045 Jardin de la Lironde,6,2,8,2022,01-21,10:09
046 P�re Soulas,5,3,8,2022,01-21,10:09
047 Place Viala,4,4,8,2022,01-21,10:09
048 H�tel du D�partement,6,2,8,2022,01-21,10:09
049 Tonnelles,2,6,8,2022,01-21,10:09
050 Parvis Jules Ferry - Gare Saint-Roch,7,1,8,2022,01-21,10:09
051 Pont de Lattes - Gare Saint-Roch,0,12,12,2022,01-21,10:09
053 Deux Ponts - Gare Saint-Roch,2,6,8,2022,01-21,10:09
054 Providence - Ovalie,3,5,8,2022,01-21,10:09
055 P�rols Etang de l'Or,26,42,68,2022,01-21,10:09
056 Albert 1er - Cath�drale,6,6,12,2022,01-21,10:09
057 Saint-Guilhem - Courreau,1,7,8,2022,01-21,10:09
059 Sud De France,3,5,8,2022,01-21,10:09
001 Rue Jules Ferry - Gare Saint-Roch,3,9,12,2022,01-21,10:20
002 Com�die,14,10,24,2022,01-21,10:20
003 Esplanade,16,16,32,2022,01-21,10:20
004 H�tel de Ville,7,9,16,2022,01-21,10:20
005 Corum,5,7,12,2022,01-21,10:20
006 Place Albert 1er - St Charles,23,8,31,2022,01-21,10:20
007 Foch,2,6,8,2022,01-21,10:20
008 Halles Castellane,9,3,12,2022,01-21,10:20
009 Observatoire,4,4,8,2022,01-21,10:20
010 Rondelet,1,15,16,2022,01-21,10:20
011 Plan Cabanes,2,10,12,2022,01-21,10:20
012 Boutonnet,3,9,12,2022,01-21,10:20
013 Emile Combes,7,1,8,2022,01-21,10:20
014 Beaux-Arts,3,5,8,2022,01-21,10:20
015 Les Aubes,4,4,8,2022,01-21,10:20
016 Antigone centre,6,10,16,2022,01-21,10:20
017 M�diath�que Emile Zola,7,9,16,2022,01-21,10:20
018 Nombre d'Or,9,7,16,2022,01-21,10:20
019 Louis Blanc,6,10,16,2022,01-21,10:20
020 Gambetta,4,4,8,2022,01-21,10:20
021 Port Marianne,14,2,16,2022,01-21,10:20
022 Clemenceau,7,5,12,2022,01-21,10:20
023 Les Arceaux,3,13,16,2022,01-21,10:20
024 Cit� Mion,3,5,8,2022,01-21,10:20
025 Nouveau Saint-Roch,6,2,8,2022,01-21,10:20
026 Renouvier,1,7,8,2022,01-21,10:20
027 Odysseum,4,4,8,2022,01-21,10:20
028 Saint-Denis,5,3,8,2022,01-21,10:20
029 Richter,10,6,16,2022,01-21,10:20
030 Charles Flahault,1,7,8,2022,01-21,10:20
031 Voltaire,2,6,8,2022,01-21,10:20
032 Pr�s d'Ar�nes,3,5,8,2022,01-21,10:20
033 Garcia Lorca,1,7,8,2022,01-21,10:20
034 Vert Bois,0,16,16,2022,01-21,10:20
035 Malbosc,3,5,8,2022,01-21,10:20
036 Occitanie,3,29,32,2022,01-21,10:20
037 FacdesSciences,5,19,24,2022,01-21,10:20
038 Fac de Lettres,8,8,16,2022,01-21,10:20
039 Aiguelongue,2,6,8,2022,01-21,10:20
040 Jeu de Mail des Abb�s,5,3,8,2022,01-21,10:20
041 Eurom�decine,2,6,8,2022,01-21,10:20
042 Marie Caizergues,6,2,8,2022,01-21,10:20
043 Sabines,5,3,8,2022,01-21,10:20
044 Celleneuve,0,8,8,2022,01-21,10:20
045 Jardin de la Lironde,6,2,8,2022,01-21,10:20
046 P�re Soulas,5,3,8,2022,01-21,10:20
047 Place Viala,4,4,8,2022,01-21,10:20
048 H�tel du D�partement,6,2,8,2022,01-21,10:20
049 Tonnelles,2,6,8,2022,01-21,10:20
050 Parvis Jules Ferry - Gare Saint-Roch,7,1,8,2022,01-21,10:20
051 Pont de Lattes - Gare Saint-Roch,0,12,12,2022,01-21,10:20
053 Deux Ponts - Gare Saint-Roch,2,6,8,2022,01-21,10:20
054 Providence - Ovalie,3,5,8,2022,01-21,10:20
055 P�rols Etang de l'Or,26,42,68,2022,01-21,10:20
056 Albert 1er - Cath�drale,6,6,12,2022,01-21,10:20
057 Saint-Guilhem - Courreau,1,7,8,2022,01-21,10:20
059 Sud De France,3,5,8,2022,01-21,10:20
001 Rue Jules Ferry - Gare Saint-Roch,3,9,12,2022,01-21,10:30
002 Com�die,14,10,24,2022,01-21,10:30
003 Esplanade,16,16,32,2022,01-21,10:30
004 H�tel de Ville,7,9,16,2022,01-21,10:30
005 Corum,5,7,12,2022,01-21,10:30
006 Place Albert 1er - St Charles,23,8,31,2022,01-21,10:30
007 Foch,2,6,8,2022,01-21,10:30
008 Halles Castellane,9,3,12,2022,01-21,10:30
009 Observatoire,4,4,8,2022,01-21,10:30
010 Rondelet,1,15,16,2022,01-21,10:30
011 Plan Cabanes,2,10,12,2022,01-21,10:30
012 Boutonnet,3,9,12,2022,01-21,10:30
013 Emile Combes,7,1,8,2022,01-21,10:30
014 Beaux-Arts,3,5,8,2022,01-21,10:30
015 Les Aubes,4,4,8,2022,01-21,10:30
016 Antigone centre,6,10,16,2022,01-21,10:30
017 M�diath�que Emile Zola,7,9,16,2022,01-21,10:30
018 Nombre d'Or,9,7,16,2022,01-21,10:30
019 Louis Blanc,6,10,16,2022,01-21,10:30
020 Gambetta,4,4,8,2022,01-21,10:30
021 Port Marianne,14,2,16,2022,01-21,10:30
022 Clemenceau,7,5,12,2022,01-21,10:30
023 Les Arceaux,3,13,16,2022,01-21,10:30
024 Cit� Mion,3,5,8,2022,01-21,10:30
025 Nouveau Saint-Roch,6,2,8,2022,01-21,10:30
026 Renouvier,1,7,8,2022,01-21,10:30
027 Odysseum,4,4,8,2022,01-21,10:30
028 Saint-Denis,5,3,8,2022,01-21,10:30
029 Richter,10,6,16,2022,01-21,10:30
030 Charles Flahault,1,7,8,2022,01-21,10:30
031 Voltaire,2,6,8,2022,01-21,10:30
032 Pr�s d'Ar�nes,3,5,8,2022,01-21,10:30
033 Garcia Lorca,1,7,8,2022,01-21,10:30
034 Vert Bois,0,16,16,2022,01-21,10:30
035 Malbosc,3,5,8,2022,01-21,10:30
036 Occitanie,3,29,32,2022,01-21,10:30
037 FacdesSciences,5,19,24,2022,01-21,10:30
038 Fac de Lettres,8,8,16,2022,01-21,10:30
039 Aiguelongue,2,6,8,2022,01-21,10:30
040 Jeu de Mail des Abb�s,5,3,8,2022,01-21,10:30
041 Eurom�decine,2,6,8,2022,01-21,10:30
042 Marie Caizergues,6,2,8,2022,01-21,10:30
043 Sabines,5,3,8,2022,01-21,10:30
044 Celleneuve,0,8,8,2022,01-21,10:30
045 Jardin de la Lironde,6,2,8,2022,01-21,10:30
046 P�re Soulas,5,3,8,2022,01-21,10:30
047 Place Viala,3,5,8,2022,01-21,10:30
048 H�tel du D�partement,6,2,8,2022,01-21,10:30
049 Tonnelles,2,6,8,2022,01-21,10:30
050 Parvis Jules Ferry - Gare Saint-Roch,6,2,8,2022,01-21,10:30
051 Pont de Lattes - Gare Saint-Roch,0,12,12,2022,01-21,10:30
053 Deux Ponts - Gare Saint-Roch,2,6,8,2022,01-21,10:30
054 Providence - Ovalie,3,5,8,2022,01-21,10:30
055 P�rols Etang de l'Or,26,42,68,2022,01-21,10:30
056 Albert 1er - Cath�drale,6,6,12,2022,01-21,10:30
057 Saint-Guilhem - Courreau,1,7,8,2022,01-21,10:30
059 Sud De France,3,5,8,2022,01-21,10:30
001 Rue Jules Ferry - Gare Saint-Roch,3,9,12,2022,01-21,10:40
002 Com�die,14,10,24,2022,01-21,10:40
003 Esplanade,16,16,32,2022,01-21,10:40
004 H�tel de Ville,7,9,16,2022,01-21,10:40
005 Corum,5,7,12,2022,01-21,10:40
006 Place Albert 1er - St Charles,23,8,31,2022,01-21,10:40
007 Foch,2,6,8,2022,01-21,10:40
008 Halles Castellane,9,3,12,2022,01-21,10:40
009 Observatoire,4,4,8,2022,01-21,10:40
010 Rondelet,1,15,16,2022,01-21,10:40
011 Plan Cabanes,2,10,12,2022,01-21,10:40
012 Boutonnet,3,9,12,2022,01-21,10:40
013 Emile Combes,7,1,8,2022,01-21,10:40
014 Beaux-Arts,3,5,8,2022,01-21,10:40
015 Les Aubes,4,4,8,2022,01-21,10:40
016 Antigone centre,6,10,16,2022,01-21,10:40
017 M�diath�que Emile Zola,7,9,16,2022,01-21,10:40
018 Nombre d'Or,9,7,16,2022,01-21,10:40
019 Louis Blanc,4,12,16,2022,01-21,10:40
020 Gambetta,4,4,8,2022,01-21,10:40
021 Port Marianne,14,2,16,2022,01-21,10:40
022 Clemenceau,7,5,12,2022,01-21,10:40
023 Les Arceaux,4,12,16,2022,01-21,10:40
024 Cit� Mion,3,5,8,2022,01-21,10:40
025 Nouveau Saint-Roch,6,2,8,2022,01-21,10:40
026 Renouvier,1,7,8,2022,01-21,10:40
027 Odysseum,4,4,8,2022,01-21,10:40
028 Saint-Denis,5,3,8,2022,01-21,10:40
029 Richter,10,6,16,2022,01-21,10:40
030 Charles Flahault,1,7,8,2022,01-21,10:40
031 Voltaire,2,6,8,2022,01-21,10:40
032 Pr�s d'Ar�nes,3,5,8,2022,01-21,10:40
033 Garcia Lorca,1,7,8,2022,01-21,10:40
034 Vert Bois,0,16,16,2022,01-21,10:40
035 Malbosc,3,5,8,2022,01-21,10:40
036 Occitanie,3,29,32,2022,01-21,10:40
037 FacdesSciences,5,19,24,2022,01-21,10:40
038 Fac de Lettres,7,9,16,2022,01-21,10:40
039 Aiguelongue,2,6,8,2022,01-21,10:40
040 Jeu de Mail des Abb�s,5,3,8,2022,01-21,10:40
041 Eurom�decine,2,6,8,2022,01-21,10:40
042 Marie Caizergues,6,2,8,2022,01-21,10:40
043 Sabines,6,2,8,2022,01-21,10:40
044 Celleneuve,1,7,8,2022,01-21,10:40
045 Jardin de la Lironde,6,2,8,2022,01-21,10:40
046 P�re Soulas,5,3,8,2022,01-21,10:40
047 Place Viala,3,5,8,2022,01-21,10:40
048 H�tel du D�partement,6,2,8,2022,01-21,10:40
049 Tonnelles,2,6,8,2022,01-21,10:40
050 Parvis Jules Ferry - Gare Saint-Roch,6,2,8,2022,01-21,10:40
051 Pont de Lattes - Gare Saint-Roch,0,12,12,2022,01-21,10:40
053 Deux Ponts - Gare Saint-Roch,2,6,8,2022,01-21,10:40
054 Providence - Ovalie,3,5,8,2022,01-21,10:40
055 P�rols Etang de l'Or,26,42,68,2022,01-21,10:40
056 Albert 1er - Cath�drale,6,6,12,2022,01-21,10:40
057 Saint-Guilhem - Courreau,1,7,8,2022,01-21,10:40
059 Sud De France,3,5,8,2022,01-21,10:40
001 Rue Jules Ferry - Gare Saint-Roch,3,9,12,2022,01-21,10:50
002 Com�die,14,10,24,2022,01-21,10:50
003 Esplanade,16,16,32,2022,01-21,10:50
004 H�tel de Ville,7,9,16,2022,01-21,10:50
005 Corum,6,6,12,2022,01-21,10:50
006 Place Albert 1er - St Charles,23,8,31,2022,01-21,10:50
007 Foch,2,6,8,2022,01-21,10:50
008 Halles Castellane,9,3,12,2022,01-21,10:50
009 Observatoire,4,4,8,2022,01-21,10:50
010 Rondelet,1,15,16,2022,01-21,10:50
011 Plan Cabanes,2,10,12,2022,01-21,10:50
012 Boutonnet,3,9,12,2022,01-21,10:50
013 Emile Combes,7,1,8,2022,01-21,10:50
014 Beaux-Arts,3,5,8,2022,01-21,10:50
015 Les Aubes,4,4,8,2022,01-21,10:50
016 Antigone centre,6,10,16,2022,01-21,10:50
017 M�diath�que Emile Zola,7,9,16,2022,01-21,10:50
018 Nombre d'Or,9,7,16,2022,01-21,10:50
019 Louis Blanc,4,12,16,2022,01-21,10:50
020 Gambetta,3,5,8,2022,01-21,10:50
021 Port Marianne,13,3,16,2022,01-21,10:50
022 Clemenceau,8,4,12,2022,01-21,10:50
023 Les Arceaux,4,12,16,2022,01-21,10:50
024 Cit� Mion,3,5,8,2022,01-21,10:50
025 Nouveau Saint-Roch,6,2,8,2022,01-21,10:50
026 Renouvier,1,7,8,2022,01-21,10:50
027 Odysseum,4,4,8,2022,01-21,10:50
028 Saint-Denis,5,3,8,2022,01-21,10:50
029 Richter,10,6,16,2022,01-21,10:50
030 Charles Flahault,1,7,8,2022,01-21,10:50
031 Voltaire,2,6,8,2022,01-21,10:50
032 Pr�s d'Ar�nes,3,5,8,2022,01-21,10:50
033 Garcia Lorca,1,7,8,2022,01-21,10:50
034 Vert Bois,0,16,16,2022,01-21,10:50
035 Malbosc,3,5,8,2022,01-21,10:50
036 Occitanie,3,29,32,2022,01-21,10:50
037 FacdesSciences,5,19,24,2022,01-21,10:50
038 Fac de Lettres,7,9,16,2022,01-21,10:50
039 Aiguelongue,2,6,8,2022,01-21,10:50
040 Jeu de Mail des Abb�s,5,3,8,2022,01-21,10:50
041 Eurom�decine,2,6,8,2022,01-21,10:50
042 Marie Caizergues,6,2,8,2022,01-21,10:50
043 Sabines,6,2,8,2022,01-21,10:50
044 Celleneuve,1,7,8,2022,01-21,10:50
045 Jardin de la Lironde,6,2,8,2022,01-21,10:50
046 P�re Soulas,5,3,8,2022,01-21,10:50
047 Place Viala,3,5,8,2022,01-21,10:50
048 H�tel du D�partement,6,2,8,2022,01-21,10:50
049 Tonnelles,2,6,8,2022,01-21,10:50
050 Parvis Jules Ferry - Gare Saint-Roch,6,2,8,2022,01-21,10:50
051 Pont de Lattes - Gare Saint-Roch,0,12,12,2022,01-21,10:50
053 Deux Ponts - Gare Saint-Roch,2,6,8,2022,01-21,10:50
054 Providence - Ovalie,3,5,8,2022,01-21,10:50
055 P�rols Etang de l'Or,26,42,68,2022,01-21,10:50
056 Albert 1er - Cath�drale,6,6,12,2022,01-21,10:50
057 Saint-Guilhem - Courreau,1,7,8,2022,01-21,10:50
059 Sud De France,2,6,8,2022,01-21,10:50
001 Rue Jules Ferry - Gare Saint-Roch,3,9,12,2022,01-21,11:00
002 Com�die,14,10,24,2022,01-21,11:00
003 Esplanade,16,16,32,2022,01-21,11:00
004 H�tel de Ville,7,9,16,2022,01-21,11:00
005 Corum,6,6,12,2022,01-21,11:00
006 Place Albert 1er - St Charles,23,8,31,2022,01-21,11:00
007 Foch,2,6,8,2022,01-21,11:00
008 Halles Castellane,9,3,12,2022,01-21,11:00
009 Observatoire,4,4,8,2022,01-21,11:00
010 Rondelet,1,15,16,2022,01-21,11:00
011 Plan Cabanes,2,10,12,2022,01-21,11:00
012 Boutonnet,3,9,12,2022,01-21,11:00
013 Emile Combes,7,1,8,2022,01-21,11:00
014 Beaux-Arts,3,5,8,2022,01-21,11:00
015 Les Aubes,4,4,8,2022,01-21,11:00
016 Antigone centre,5,11,16,2022,01-21,11:00
017 M�diath�que Emile Zola,7,9,16,2022,01-21,11:00
018 Nombre d'Or,9,7,16,2022,01-21,11:00
019 Louis Blanc,4,12,16,2022,01-21,11:00
020 Gambetta,3,5,8,2022,01-21,11:00
021 Port Marianne,14,2,16,2022,01-21,11:00
022 Clemenceau,8,4,12,2022,01-21,11:00
023 Les Arceaux,4,12,16,2022,01-21,11:00
024 Cit� Mion,3,5,8,2022,01-21,11:00
025 Nouveau Saint-Roch,6,2,8,2022,01-21,11:00
026 Renouvier,1,7,8,2022,01-21,11:00
027 Odysseum,4,4,8,2022,01-21,11:00
028 Saint-Denis,5,3,8,2022,01-21,11:00
029 Richter,10,6,16,2022,01-21,11:00
030 Charles Flahault,1,7,8,2022,01-21,11:00
031 Voltaire,3,5,8,2022,01-21,11:00
032 Pr�s d'Ar�nes,3,5,8,2022,01-21,11:00
033 Garcia Lorca,1,7,8,2022,01-21,11:00
034 Vert Bois,0,16,16,2022,01-21,11:00
035 Malbosc,3,5,8,2022,01-21,11:00
036 Occitanie,3,29,32,2022,01-21,11:00
037 FacdesSciences,5,19,24,2022,01-21,11:00
038 Fac de Lettres,7,9,16,2022,01-21,11:00
039 Aiguelongue,2,6,8,2022,01-21,11:00
040 Jeu de Mail des Abb�s,5,3,8,2022,01-21,11:00
041 Eurom�decine,2,6,8,2022,01-21,11:00
042 Marie Caizergues,6,2,8,2022,01-21,11:00
043 Sabines,6,2,8,2022,01-21,11:00
044 Celleneuve,1,7,8,2022,01-21,11:00
045 Jardin de la Lironde,6,2,8,2022,01-21,11:00
046 P�re Soulas,5,3,8,2022,01-21,11:00
047 Place Viala,3,5,8,2022,01-21,11:00
048 H�tel du D�partement,6,2,8,2022,01-21,11:00
049 Tonnelles,2,6,8,2022,01-21,11:00
050 Parvis Jules Ferry - Gare Saint-Roch,6,2,8,2022,01-21,11:00
051 Pont de Lattes - Gare Saint-Roch,0,12,12,2022,01-21,11:00
053 Deux Ponts - Gare Saint-Roch,2,6,8,2022,01-21,11:00
054 Providence - Ovalie,3,5,8,2022,01-21,11:00
055 P�rols Etang de l'Or,26,42,68,2022,01-21,11:00
056 Albert 1er - Cath�drale,6,6,12,2022,01-21,11:00
057 Saint-Guilhem - Courreau,1,7,8,2022,01-21,11:00
059 Sud De France,2,6,8,2022,01-21,11:00
001 Rue Jules Ferry - Gare Saint-Roch,3,9,12,2022,01-21,11:10
002 Com�die,14,10,24,2022,01-21,11:10
003 Esplanade,16,16,32,2022,01-21,11:10
004 H�tel de Ville,7,9,16,2022,01-21,11:10
005 Corum,6,6,12,2022,01-21,11:10
006 Place Albert 1er - St Charles,23,8,31,2022,01-21,11:10
007 Foch,2,6,8,2022,01-21,11:10
008 Halles Castellane,9,3,12,2022,01-21,11:10
009 Observatoire,4,4,8,2022,01-21,11:10
010 Rondelet,1,15,16,2022,01-21,11:10
011 Plan Cabanes,2,10,12,2022,01-21,11:10
012 Boutonnet,3,9,12,2022,01-21,11:10
013 Emile Combes,7,1,8,2022,01-21,11:10
014 Beaux-Arts,3,5,8,2022,01-21,11:10
015 Les Aubes,4,4,8,2022,01-21,11:10
016 Antigone centre,5,11,16,2022,01-21,11:10
017 M�diath�que Emile Zola,7,9,16,2022,01-21,11:10
018 Nombre d'Or,9,7,16,2022,01-21,11:10
019 Louis Blanc,4,12,16,2022,01-21,11:10
020 Gambetta,3,5,8,2022,01-21,11:10
021 Port Marianne,14,2,16,2022,01-21,11:10
022 Clemenceau,8,4,12,2022,01-21,11:10
023 Les Arceaux,4,12,16,2022,01-21,11:10
024 Cit� Mion,3,5,8,2022,01-21,11:10
025 Nouveau Saint-Roch,6,2,8,2022,01-21,11:10
026 Renouvier,1,7,8,2022,01-21,11:10
027 Odysseum,4,4,8,2022,01-21,11:10
028 Saint-Denis,5,3,8,2022,01-21,11:10
029 Richter,10,6,16,2022,01-21,11:10
030 Charles Flahault,1,7,8,2022,01-21,11:10
031 Voltaire,3,5,8,2022,01-21,11:10
032 Pr�s d'Ar�nes,3,5,8,2022,01-21,11:10
033 Garcia Lorca,1,7,8,2022,01-21,11:10
034 Vert Bois,0,16,16,2022,01-21,11:10
035 Malbosc,3,5,8,2022,01-21,11:10
036 Occitanie,3,29,32,2022,01-21,11:10
037 FacdesSciences,5,19,24,2022,01-21,11:10
038 Fac de Lettres,7,9,16,2022,01-21,11:10
039 Aiguelongue,2,6,8,2022,01-21,11:10
040 Jeu de Mail des Abb�s,5,3,8,2022,01-21,11:10
041 Eurom�decine,2,6,8,2022,01-21,11:10
042 Marie Caizergues,6,2,8,2022,01-21,11:10
043 Sabines,6,2,8,2022,01-21,11:10
044 Celleneuve,1,7,8,2022,01-21,11:10
045 Jardin de la Lironde,6,2,8,2022,01-21,11:10
046 P�re Soulas,4,4,8,2022,01-21,11:10
047 Place Viala,3,5,8,2022,01-21,11:10
048 H�tel du D�partement,6,2,8,2022,01-21,11:10
049 Tonnelles,2,6,8,2022,01-21,11:10
050 Parvis Jules Ferry - Gare Saint-Roch,6,2,8,2022,01-21,11:10
051 Pont de Lattes - Gare Saint-Roch,0,12,12,2022,01-21,11:10
053 Deux Ponts - Gare Saint-Roch,2,6,8,2022,01-21,11:10
054 Providence - Ovalie,3,5,8,2022,01-21,11:10
055 P�rols Etang de l'Or,24,44,68,2022,01-21,11:10
056 Albert 1er - Cath�drale,6,6,12,2022,01-21,11:10
057 Saint-Guilhem - Courreau,1,7,8,2022,01-21,11:10
059 Sud De France,2,6,8,2022,01-21,11:10
001 Rue Jules Ferry - Gare Saint-Roch,3,9,12,2022,01-21,11:21
002 Com�die,14,10,24,2022,01-21,11:21
003 Esplanade,16,16,32,2022,01-21,11:21
004 H�tel de Ville,7,9,16,2022,01-21,11:21
005 Corum,6,6,12,2022,01-21,11:21
006 Place Albert 1er - St Charles,23,8,31,2022,01-21,11:21
007 Foch,2,6,8,2022,01-21,11:21
008 Halles Castellane,9,3,12,2022,01-21,11:21
009 Observatoire,4,4,8,2022,01-21,11:21
010 Rondelet,1,15,16,2022,01-21,11:21
011 Plan Cabanes,2,10,12,2022,01-21,11:21
012 Boutonnet,3,9,12,2022,01-21,11:21
013 Emile Combes,7,1,8,2022,01-21,11:21
014 Beaux-Arts,3,5,8,2022,01-21,11:21
015 Les Aubes,4,4,8,2022,01-21,11:21
016 Antigone centre,5,11,16,2022,01-21,11:21
017 M�diath�que Emile Zola,7,9,16,2022,01-21,11:21
018 Nombre d'Or,10,6,16,2022,01-21,11:21
019 Louis Blanc,4,12,16,2022,01-21,11:21
020 Gambetta,3,5,8,2022,01-21,11:21
021 Port Marianne,14,2,16,2022,01-21,11:21
022 Clemenceau,8,4,12,2022,01-21,11:21
023 Les Arceaux,4,12,16,2022,01-21,11:21
024 Cit� Mion,3,5,8,2022,01-21,11:21
025 Nouveau Saint-Roch,6,2,8,2022,01-21,11:21
026 Renouvier,0,8,8,2022,01-21,11:21
027 Odysseum,4,4,8,2022,01-21,11:21
028 Saint-Denis,5,3,8,2022,01-21,11:21
029 Richter,11,5,16,2022,01-21,11:21
030 Charles Flahault,1,7,8,2022,01-21,11:21
031 Voltaire,3,5,8,2022,01-21,11:21
032 Pr�s d'Ar�nes,3,5,8,2022,01-21,11:21
033 Garcia Lorca,1,7,8,2022,01-21,11:21
034 Vert Bois,0,16,16,2022,01-21,11:21
035 Malbosc,2,6,8,2022,01-21,11:21
036 Occitanie,3,29,32,2022,01-21,11:21
037 FacdesSciences,6,18,24,2022,01-21,11:21
038 Fac de Lettres,7,9,16,2022,01-21,11:21
039 Aiguelongue,2,6,8,2022,01-21,11:21
040 Jeu de Mail des Abb�s,5,3,8,2022,01-21,11:21
041 Eurom�decine,2,6,8,2022,01-21,11:21
042 Marie Caizergues,6,2,8,2022,01-21,11:21
043 Sabines,6,2,8,2022,01-21,11:21
044 Celleneuve,1,7,8,2022,01-21,11:21
045 Jardin de la Lironde,6,2,8,2022,01-21,11:21
046 P�re Soulas,4,4,8,2022,01-21,11:21
047 Place Viala,3,5,8,2022,01-21,11:21
048 H�tel du D�partement,6,2,8,2022,01-21,11:21
049 Tonnelles,2,6,8,2022,01-21,11:21
050 Parvis Jules Ferry - Gare Saint-Roch,6,2,8,2022,01-21,11:21
051 Pont de Lattes - Gare Saint-Roch,0,12,12,2022,01-21,11:21
053 Deux Ponts - Gare Saint-Roch,2,6,8,2022,01-21,11:21
054 Providence - Ovalie,3,5,8,2022,01-21,11:21
055 P�rols Etang de l'Or,24,44,68,2022,01-21,11:21
056 Albert 1er - Cath�drale,6,6,12,2022,01-21,11:21
057 Saint-Guilhem - Courreau,1,7,8,2022,01-21,11:21
059 Sud De France,2,6,8,2022,01-21,11:21
001 Rue Jules Ferry - Gare Saint-Roch,3,9,12,2022,01-21,11:31
002 Com�die,14,10,24,2022,01-21,11:31
003 Esplanade,16,16,32,2022,01-21,11:31
004 H�tel de Ville,6,10,16,2022,01-21,11:31
005 Corum,6,6,12,2022,01-21,11:31
006 Place Albert 1er - St Charles,23,8,31,2022,01-21,11:31
007 Foch,2,6,8,2022,01-21,11:31
008 Halles Castellane,9,3,12,2022,01-21,11:31
009 Observatoire,4,4,8,2022,01-21,11:31
010 Rondelet,1,15,16,2022,01-21,11:31
011 Plan Cabanes,2,10,12,2022,01-21,11:31
012 Boutonnet,3,9,12,2022,01-21,11:31
013 Emile Combes,7,1,8,2022,01-21,11:31
014 Beaux-Arts,3,5,8,2022,01-21,11:31
015 Les Aubes,4,4,8,2022,01-21,11:31
016 Antigone centre,5,11,16,2022,01-21,11:31
017 M�diath�que Emile Zola,7,9,16,2022,01-21,11:31
018 Nombre d'Or,10,6,16,2022,01-21,11:31
019 Louis Blanc,4,12,16,2022,01-21,11:31
020 Gambetta,3,5,8,2022,01-21,11:31
021 Port Marianne,14,2,16,2022,01-21,11:31
022 Clemenceau,8,4,12,2022,01-21,11:31
023 Les Arceaux,4,12,16,2022,01-21,11:31
024 Cit� Mion,3,5,8,2022,01-21,11:31
025 Nouveau Saint-Roch,6,2,8,2022,01-21,11:31
026 Renouvier,0,8,8,2022,01-21,11:31
027 Odysseum,4,4,8,2022,01-21,11:31
028 Saint-Denis,5,3,8,2022,01-21,11:31
029 Richter,11,5,16,2022,01-21,11:31
030 Charles Flahault,1,7,8,2022,01-21,11:31
031 Voltaire,3,5,8,2022,01-21,11:31
032 Pr�s d'Ar�nes,3,5,8,2022,01-21,11:31
033 Garcia Lorca,1,7,8,2022,01-21,11:31
034 Vert Bois,0,16,16,2022,01-21,11:31
035 Malbosc,2,6,8,2022,01-21,11:31
036 Occitanie,4,28,32,2022,01-21,11:31
037 FacdesSciences,5,19,24,2022,01-21,11:31
038 Fac de Lettres,7,9,16,2022,01-21,11:31
039 Aiguelongue,2,6,8,2022,01-21,11:31
040 Jeu de Mail des Abb�s,5,3,8,2022,01-21,11:31
041 Eurom�decine,2,6,8,2022,01-21,11:31
042 Marie Caizergues,6,2,8,2022,01-21,11:31
043 Sabines,6,2,8,2022,01-21,11:31
044 Celleneuve,1,7,8,2022,01-21,11:31
045 Jardin de la Lironde,6,2,8,2022,01-21,11:31
046 P�re Soulas,5,3,8,2022,01-21,11:31
047 Place Viala,3,5,8,2022,01-21,11:31
048 H�tel du D�partement,6,2,8,2022,01-21,11:31
049 Tonnelles,2,6,8,2022,01-21,11:31
050 Parvis Jules Ferry - Gare Saint-Roch,6,2,8,2022,01-21,11:31
051 Pont de Lattes - Gare Saint-Roch,0,12,12,2022,01-21,11:31
053 Deux Ponts - Gare Saint-Roch,2,6,8,2022,01-21,11:31
054 Providence - Ovalie,3,5,8,2022,01-21,11:31
055 P�rols Etang de l'Or,24,44,68,2022,01-21,11:31
056 Albert 1er - Cath�drale,6,6,12,2022,01-21,11:31
057 Saint-Guilhem - Courreau,1,7,8,2022,01-21,11:31
059 Sud De France,2,6,8,2022,01-21,11:31
001 Rue Jules Ferry - Gare Saint-Roch,3,9,12,2022,01-21,11:41
002 Com�die,14,10,24,2022,01-21,11:41
003 Esplanade,14,18,32,2022,01-21,11:41
004 H�tel de Ville,6,10,16,2022,01-21,11:41
005 Corum,6,6,12,2022,01-21,11:41
006 Place Albert 1er - St Charles,23,8,31,2022,01-21,11:41
007 Foch,2,6,8,2022,01-21,11:41
008 Halles Castellane,9,3,12,2022,01-21,11:41
009 Observatoire,4,4,8,2022,01-21,11:41
010 Rondelet,1,15,16,2022,01-21,11:41
011 Plan Cabanes,1,11,12,2022,01-21,11:41
012 Boutonnet,3,9,12,2022,01-21,11:41
013 Emile Combes,7,1,8,2022,01-21,11:41
014 Beaux-Arts,3,5,8,2022,01-21,11:41
015 Les Aubes,4,4,8,2022,01-21,11:41
016 Antigone centre,5,11,16,2022,01-21,11:41
017 M�diath�que Emile Zola,6,10,16,2022,01-21,11:41
018 Nombre d'Or,10,6,16,2022,01-21,11:41
019 Louis Blanc,4,12,16,2022,01-21,11:41
020 Gambetta,2,6,8,2022,01-21,11:41
021 Port Marianne,14,2,16,2022,01-21,11:41
022 Clemenceau,8,4,12,2022,01-21,11:41
023 Les Arceaux,4,12,16,2022,01-21,11:41
024 Cit� Mion,3,5,8,2022,01-21,11:41
025 Nouveau Saint-Roch,5,3,8,2022,01-21,11:41
026 Renouvier,0,8,8,2022,01-21,11:41
027 Odysseum,4,4,8,2022,01-21,11:41
028 Saint-Denis,6,2,8,2022,01-21,11:41
029 Richter,10,6,16,2022,01-21,11:41
030 Charles Flahault,1,7,8,2022,01-21,11:41
031 Voltaire,3,5,8,2022,01-21,11:41
032 Pr�s d'Ar�nes,3,5,8,2022,01-21,11:41
033 Garcia Lorca,1,7,8,2022,01-21,11:41
034 Vert Bois,0,16,16,2022,01-21,11:41
035 Malbosc,2,6,8,2022,01-21,11:41
036 Occitanie,4,28,32,2022,01-21,11:41
037 FacdesSciences,5,19,24,2022,01-21,11:41
038 Fac de Lettres,7,9,16,2022,01-21,11:41
039 Aiguelongue,2,6,8,2022,01-21,11:41
040 Jeu de Mail des Abb�s,5,3,8,2022,01-21,11:41
041 Eurom�decine,2,6,8,2022,01-21,11:41
042 Marie Caizergues,6,2,8,2022,01-21,11:41
043 Sabines,6,2,8,2022,01-21,11:41
044 Celleneuve,1,7,8,2022,01-21,11:41
045 Jardin de la Lironde,6,2,8,2022,01-21,11:41
046 P�re Soulas,5,3,8,2022,01-21,11:41
047 Place Viala,3,5,8,2022,01-21,11:41
048 H�tel du D�partement,6,2,8,2022,01-21,11:41
049 Tonnelles,2,6,8,2022,01-21,11:41
050 Parvis Jules Ferry - Gare Saint-Roch,6,2,8,2022,01-21,11:41
051 Pont de Lattes - Gare Saint-Roch,0,12,12,2022,01-21,11:41
053 Deux Ponts - Gare Saint-Roch,2,6,8,2022,01-21,11:41
054 Providence - Ovalie,3,5,8,2022,01-21,11:41
055 P�rols Etang de l'Or,24,44,68,2022,01-21,11:41
056 Albert 1er - Cath�drale,6,6,12,2022,01-21,11:41
057 Saint-Guilhem - Courreau,1,7,8,2022,01-21,11:41
059 Sud De France,2,6,8,2022,01-21,11:41
001 Rue Jules Ferry - Gare Saint-Roch,3,9,12,2022,01-21,11:51
002 Com�die,14,10,24,2022,01-21,11:51
003 Esplanade,15,17,32,2022,01-21,11:51
004 H�tel de Ville,6,10,16,2022,01-21,11:51
005 Corum,6,6,12,2022,01-21,11:51
006 Place Albert 1er - St Charles,23,8,31,2022,01-21,11:51
007 Foch,2,6,8,2022,01-21,11:51
008 Halles Castellane,9,3,12,2022,01-21,11:51
009 Observatoire,4,4,8,2022,01-21,11:51
010 Rondelet,1,15,16,2022,01-21,11:51
011 Plan Cabanes,1,11,12,2022,01-21,11:51
012 Boutonnet,3,9,12,2022,01-21,11:51
013 Emile Combes,7,1,8,2022,01-21,11:51
014 Beaux-Arts,3,5,8,2022,01-21,11:51
015 Les Aubes,4,4,8,2022,01-21,11:51
016 Antigone centre,5,11,16,2022,01-21,11:51
017 M�diath�que Emile Zola,6,10,16,2022,01-21,11:51
018 Nombre d'Or,9,7,16,2022,01-21,11:51
019 Louis Blanc,4,12,16,2022,01-21,11:51
020 Gambetta,2,6,8,2022,01-21,11:51
021 Port Marianne,14,2,16,2022,01-21,11:51
022 Clemenceau,8,4,12,2022,01-21,11:51
023 Les Arceaux,4,12,16,2022,01-21,11:51
024 Cit� Mion,3,5,8,2022,01-21,11:51
025 Nouveau Saint-Roch,5,3,8,2022,01-21,11:51
026 Renouvier,1,7,8,2022,01-21,11:51
027 Odysseum,4,4,8,2022,01-21,11:51
028 Saint-Denis,6,2,8,2022,01-21,11:51
029 Richter,10,6,16,2022,01-21,11:51
030 Charles Flahault,0,8,8,2022,01-21,11:51
031 Voltaire,3,5,8,2022,01-21,11:51
032 Pr�s d'Ar�nes,3,5,8,2022,01-21,11:51
033 Garcia Lorca,1,7,8,2022,01-21,11:51
034 Vert Bois,0,16,16,2022,01-21,11:51
035 Malbosc,2,6,8,2022,01-21,11:51
036 Occitanie,4,28,32,2022,01-21,11:51
037 FacdesSciences,5,19,24,2022,01-21,11:51
038 Fac de Lettres,7,9,16,2022,01-21,11:51
039 Aiguelongue,2,6,8,2022,01-21,11:51
040 Jeu de Mail des Abb�s,5,3,8,2022,01-21,11:51
041 Eurom�decine,2,6,8,2022,01-21,11:51
042 Marie Caizergues,6,2,8,2022,01-21,11:51
043 Sabines,6,2,8,2022,01-21,11:51
044 Celleneuve,1,7,8,2022,01-21,11:51
045 Jardin de la Lironde,6,2,8,2022,01-21,11:51
046 P�re Soulas,6,2,8,2022,01-21,11:51
047 Place Viala,3,5,8,2022,01-21,11:51
048 H�tel du D�partement,6,2,8,2022,01-21,11:51
049 Tonnelles,2,6,8,2022,01-21,11:51
050 Parvis Jules Ferry - Gare Saint-Roch,5,3,8,2022,01-21,11:51
051 Pont de Lattes - Gare Saint-Roch,1,11,12,2022,01-21,11:51
053 Deux Ponts - Gare Saint-Roch,2,6,8,2022,01-21,11:51
054 Providence - Ovalie,3,5,8,2022,01-21,11:51
055 P�rols Etang de l'Or,24,44,68,2022,01-21,11:51
056 Albert 1er - Cath�drale,6,6,12,2022,01-21,11:51
057 Saint-Guilhem - Courreau,1,7,8,2022,01-21,11:51
059 Sud De France,2,6,8,2022,01-21,11:51
001 Rue Jules Ferry - Gare Saint-Roch,3,9,12,2022,01-21,12:01
002 Com�die,14,10,24,2022,01-21,12:01
003 Esplanade,15,17,32,2022,01-21,12:01
004 H�tel de Ville,6,10,16,2022,01-21,12:01
005 Corum,6,6,12,2022,01-21,12:01
006 Place Albert 1er - St Charles,23,8,31,2022,01-21,12:01
007 Foch,3,5,8,2022,01-21,12:01
008 Halles Castellane,9,3,12,2022,01-21,12:01
009 Observatoire,2,6,8,2022,01-21,12:01
010 Rondelet,1,15,16,2022,01-21,12:01
011 Plan Cabanes,1,11,12,2022,01-21,12:01
012 Boutonnet,3,9,12,2022,01-21,12:01
013 Emile Combes,7,1,8,2022,01-21,12:01
014 Beaux-Arts,3,5,8,2022,01-21,12:01
015 Les Aubes,3,5,8,2022,01-21,12:01
016 Antigone centre,5,11,16,2022,01-21,12:01
017 M�diath�que Emile Zola,6,10,16,2022,01-21,12:01
018 Nombre d'Or,9,7,16,2022,01-21,12:01
019 Louis Blanc,4,12,16,2022,01-21,12:01
020 Gambetta,2,6,8,2022,01-21,12:01
021 Port Marianne,14,2,16,2022,01-21,12:01
022 Clemenceau,8,4,12,2022,01-21,12:01
023 Les Arceaux,4,12,16,2022,01-21,12:01
024 Cit� Mion,3,5,8,2022,01-21,12:01
025 Nouveau Saint-Roch,6,2,8,2022,01-21,12:01
026 Renouvier,1,7,8,2022,01-21,12:01
027 Odysseum,4,4,8,2022,01-21,12:01
028 Saint-Denis,6,2,8,2022,01-21,12:01
029 Richter,11,5,16,2022,01-21,12:01
030 Charles Flahault,0,8,8,2022,01-21,12:01
031 Voltaire,3,5,8,2022,01-21,12:01
032 Pr�s d'Ar�nes,3,5,8,2022,01-21,12:01
033 Garcia Lorca,2,6,8,2022,01-21,12:01
034 Vert Bois,0,16,16,2022,01-21,12:01
035 Malbosc,2,6,8,2022,01-21,12:01
036 Occitanie,4,28,32,2022,01-21,12:01
037 FacdesSciences,5,19,24,2022,01-21,12:01
038 Fac de Lettres,7,9,16,2022,01-21,12:01
039 Aiguelongue,2,6,8,2022,01-21,12:01
040 Jeu de Mail des Abb�s,5,3,8,2022,01-21,12:01
041 Eurom�decine,2,6,8,2022,01-21,12:01
042 Marie Caizergues,6,2,8,2022,01-21,12:01
043 Sabines,6,2,8,2022,01-21,12:01
044 Celleneuve,1,7,8,2022,01-21,12:01
045 Jardin de la Lironde,6,2,8,2022,01-21,12:01
046 P�re Soulas,6,2,8,2022,01-21,12:01
047 Place Viala,3,5,8,2022,01-21,12:01
048 H�tel du D�partement,6,2,8,2022,01-21,12:01
049 Tonnelles,2,6,8,2022,01-21,12:01
050 Parvis Jules Ferry - Gare Saint-Roch,5,3,8,2022,01-21,12:01
051 Pont de Lattes - Gare Saint-Roch,1,11,12,2022,01-21,12:01
053 Deux Ponts - Gare Saint-Roch,2,6,8,2022,01-21,12:01
054 Providence - Ovalie,3,5,8,2022,01-21,12:01
055 P�rols Etang de l'Or,24,44,68,2022,01-21,12:01
056 Albert 1er - Cath�drale,6,6,12,2022,01-21,12:01
057 Saint-Guilhem - Courreau,1,7,8,2022,01-21,12:01
059 Sud De France,2,6,8,2022,01-21,12:01
001 Rue Jules Ferry - Gare Saint-Roch,3,9,12,2022,01-21,12:11
002 Com�die,14,10,24,2022,01-21,12:11
003 Esplanade,15,17,32,2022,01-21,12:11
004 H�tel de Ville,6,10,16,2022,01-21,12:11
005 Corum,6,6,12,2022,01-21,12:11
006 Place Albert 1er - St Charles,23,8,31,2022,01-21,12:11
007 Foch,3,5,8,2022,01-21,12:11
008 Halles Castellane,9,3,12,2022,01-21,12:11
009 Observatoire,2,6,8,2022,01-21,12:11
010 Rondelet,1,15,16,2022,01-21,12:11
011 Plan Cabanes,2,10,12,2022,01-21,12:11
012 Boutonnet,3,9,12,2022,01-21,12:11
013 Emile Combes,7,1,8,2022,01-21,12:11
014 Beaux-Arts,3,5,8,2022,01-21,12:11
015 Les Aubes,3,5,8,2022,01-21,12:11
016 Antigone centre,5,11,16,2022,01-21,12:11
017 M�diath�que Emile Zola,6,10,16,2022,01-21,12:11
018 Nombre d'Or,9,7,16,2022,01-21,12:11
019 Louis Blanc,4,12,16,2022,01-21,12:11
020 Gambetta,2,6,8,2022,01-21,12:11
021 Port Marianne,14,2,16,2022,01-21,12:11
022 Clemenceau,8,4,12,2022,01-21,12:11
023 Les Arceaux,4,12,16,2022,01-21,12:11
024 Cit� Mion,3,5,8,2022,01-21,12:11
025 Nouveau Saint-Roch,6,2,8,2022,01-21,12:11
026 Renouvier,1,7,8,2022,01-21,12:11
027 Odysseum,4,4,8,2022,01-21,12:11
028 Saint-Denis,6,2,8,2022,01-21,12:11
029 Richter,11,5,16,2022,01-21,12:11
030 Charles Flahault,0,8,8,2022,01-21,12:11
031 Voltaire,3,5,8,2022,01-21,12:11
032 Pr�s d'Ar�nes,2,6,8,2022,01-21,12:11
033 Garcia Lorca,2,6,8,2022,01-21,12:11
034 Vert Bois,0,16,16,2022,01-21,12:11
035 Malbosc,2,6,8,2022,01-21,12:11
036 Occitanie,4,28,32,2022,01-21,12:11
037 FacdesSciences,5,19,24,2022,01-21,12:11
038 Fac de Lettres,7,9,16,2022,01-21,12:11
039 Aiguelongue,2,6,8,2022,01-21,12:11
040 Jeu de Mail des Abb�s,5,3,8,2022,01-21,12:11
041 Eurom�decine,2,6,8,2022,01-21,12:11
042 Marie Caizergues,6,2,8,2022,01-21,12:11
043 Sabines,6,2,8,2022,01-21,12:11
044 Celleneuve,1,7,8,2022,01-21,12:11
045 Jardin de la Lironde,6,2,8,2022,01-21,12:11
046 P�re Soulas,6,2,8,2022,01-21,12:11
047 Place Viala,3,5,8,2022,01-21,12:11
048 H�tel du D�partement,6,2,8,2022,01-21,12:11
049 Tonnelles,2,6,8,2022,01-21,12:11
050 Parvis Jules Ferry - Gare Saint-Roch,5,3,8,2022,01-21,12:11
051 Pont de Lattes - Gare Saint-Roch,1,11,12,2022,01-21,12:11
053 Deux Ponts - Gare Saint-Roch,2,6,8,2022,01-21,12:11
054 Providence - Ovalie,3,5,8,2022,01-21,12:11
055 P�rols Etang de l'Or,24,44,68,2022,01-21,12:11
056 Albert 1er - Cath�drale,6,6,12,2022,01-21,12:11
057 Saint-Guilhem - Courreau,1,7,8,2022,01-21,12:11
059 Sud De France,2,6,8,2022,01-21,12:11
001 Rue Jules Ferry - Gare Saint-Roch,3,9,12,2022,01-21,12:22
002 Com�die,13,11,24,2022,01-21,12:22
003 Esplanade,14,18,32,2022,01-21,12:22
004 H�tel de Ville,7,9,16,2022,01-21,12:22
005 Corum,6,6,12,2022,01-21,12:22
006 Place Albert 1er - St Charles,23,8,31,2022,01-21,12:22
007 Foch,3,5,8,2022,01-21,12:22
008 Halles Castellane,9,3,12,2022,01-21,12:22
009 Observatoire,2,6,8,2022,01-21,12:22
010 Rondelet,1,15,16,2022,01-21,12:22
011 Plan Cabanes,2,10,12,2022,01-21,12:22
012 Boutonnet,3,9,12,2022,01-21,12:22
013 Emile Combes,7,1,8,2022,01-21,12:22
014 Beaux-Arts,3,5,8,2022,01-21,12:22
015 Les Aubes,4,4,8,2022,01-21,12:22
016 Antigone centre,3,13,16,2022,01-21,12:22
017 M�diath�que Emile Zola,7,9,16,2022,01-21,12:22
018 Nombre d'Or,9,7,16,2022,01-21,12:22
019 Louis Blanc,4,12,16,2022,01-21,12:22
020 Gambetta,3,5,8,2022,01-21,12:22
021 Port Marianne,14,2,16,2022,01-21,12:22
022 Clemenceau,8,4,12,2022,01-21,12:22
023 Les Arceaux,4,12,16,2022,01-21,12:22
024 Cit� Mion,3,5,8,2022,01-21,12:22
025 Nouveau Saint-Roch,6,2,8,2022,01-21,12:22
026 Renouvier,1,7,8,2022,01-21,12:22
027 Odysseum,4,4,8,2022,01-21,12:22
028 Saint-Denis,6,2,8,2022,01-21,12:22
029 Richter,11,5,16,2022,01-21,12:22
030 Charles Flahault,0,8,8,2022,01-21,12:22
031 Voltaire,3,5,8,2022,01-21,12:22
032 Pr�s d'Ar�nes,2,6,8,2022,01-21,12:22
033 Garcia Lorca,2,6,8,2022,01-21,12:22
034 Vert Bois,0,16,16,2022,01-21,12:22
035 Malbosc,2,6,8,2022,01-21,12:22
036 Occitanie,4,28,32,2022,01-21,12:22
037 FacdesSciences,5,19,24,2022,01-21,12:22
038 Fac de Lettres,7,9,16,2022,01-21,12:22
039 Aiguelongue,2,6,8,2022,01-21,12:22
040 Jeu de Mail des Abb�s,4,4,8,2022,01-21,12:22
041 Eurom�decine,2,6,8,2022,01-21,12:22
042 Marie Caizergues,6,2,8,2022,01-21,12:22
043 Sabines,6,2,8,2022,01-21,12:22
044 Celleneuve,1,7,8,2022,01-21,12:22
045 Jardin de la Lironde,6,2,8,2022,01-21,12:22
046 P�re Soulas,6,2,8,2022,01-21,12:22
047 Place Viala,3,5,8,2022,01-21,12:22
048 H�tel du D�partement,6,2,8,2022,01-21,12:22
049 Tonnelles,2,6,8,2022,01-21,12:22
050 Parvis Jules Ferry - Gare Saint-Roch,5,3,8,2022,01-21,12:22
051 Pont de Lattes - Gare Saint-Roch,1,11,12,2022,01-21,12:22
053 Deux Ponts - Gare Saint-Roch,2,6,8,2022,01-21,12:22
054 Providence - Ovalie,3,5,8,2022,01-21,12:22
055 P�rols Etang de l'Or,24,44,68,2022,01-21,12:22
056 Albert 1er - Cath�drale,6,6,12,2022,01-21,12:22
057 Saint-Guilhem - Courreau,1,7,8,2022,01-21,12:22
059 Sud De France,2,6,8,2022,01-21,12:22
001 Rue Jules Ferry - Gare Saint-Roch,3,9,12,2022,01-21,12:32
002 Com�die,13,11,24,2022,01-21,12:32
003 Esplanade,13,19,32,2022,01-21,12:32
004 H�tel de Ville,7,9,16,2022,01-21,12:32
005 Corum,6,6,12,2022,01-21,12:32
006 Place Albert 1er - St Charles,23,8,31,2022,01-21,12:32
007 Foch,3,5,8,2022,01-21,12:32
008 Halles Castellane,9,3,12,2022,01-21,12:32
009 Observatoire,2,6,8,2022,01-21,12:32
010 Rondelet,1,15,16,2022,01-21,12:32
011 Plan Cabanes,2,10,12,2022,01-21,12:32
012 Boutonnet,3,9,12,2022,01-21,12:32
013 Emile Combes,7,1,8,2022,01-21,12:32
014 Beaux-Arts,3,5,8,2022,01-21,12:32
015 Les Aubes,4,4,8,2022,01-21,12:32
016 Antigone centre,4,12,16,2022,01-21,12:32
017 M�diath�que Emile Zola,7,9,16,2022,01-21,12:32
018 Nombre d'Or,9,7,16,2022,01-21,12:32
019 Louis Blanc,5,11,16,2022,01-21,12:32
020 Gambetta,3,5,8,2022,01-21,12:32
021 Port Marianne,14,2,16,2022,01-21,12:32
022 Clemenceau,8,4,12,2022,01-21,12:32
023 Les Arceaux,4,12,16,2022,01-21,12:32
024 Cit� Mion,3,5,8,2022,01-21,12:32
025 Nouveau Saint-Roch,6,2,8,2022,01-21,12:32
026 Renouvier,1,7,8,2022,01-21,12:32
027 Odysseum,4,4,8,2022,01-21,12:32
028 Saint-Denis,6,2,8,2022,01-21,12:32
029 Richter,10,6,16,2022,01-21,12:32
030 Charles Flahault,0,8,8,2022,01-21,12:32
031 Voltaire,3,5,8,2022,01-21,12:32
032 Pr�s d'Ar�nes,2,6,8,2022,01-21,12:32
033 Garcia Lorca,2,6,8,2022,01-21,12:32
034 Vert Bois,0,16,16,2022,01-21,12:32
035 Malbosc,2,6,8,2022,01-21,12:32
036 Occitanie,4,28,32,2022,01-21,12:32
037 FacdesSciences,6,18,24,2022,01-21,12:32
038 Fac de Lettres,6,10,16,2022,01-21,12:32
039 Aiguelongue,2,6,8,2022,01-21,12:32
040 Jeu de Mail des Abb�s,4,4,8,2022,01-21,12:32
041 Eurom�decine,2,6,8,2022,01-21,12:32
042 Marie Caizergues,5,3,8,2022,01-21,12:32
043 Sabines,6,2,8,2022,01-21,12:32
044 Celleneuve,1,7,8,2022,01-21,12:32
045 Jardin de la Lironde,6,2,8,2022,01-21,12:32
046 P�re Soulas,6,2,8,2022,01-21,12:32
047 Place Viala,2,6,8,2022,01-21,12:32
048 H�tel du D�partement,6,2,8,2022,01-21,12:32
049 Tonnelles,2,6,8,2022,01-21,12:32
050 Parvis Jules Ferry - Gare Saint-Roch,5,3,8,2022,01-21,12:32
051 Pont de Lattes - Gare Saint-Roch,1,11,12,2022,01-21,12:32
053 Deux Ponts - Gare Saint-Roch,2,6,8,2022,01-21,12:32
054 Providence - Ovalie,3,5,8,2022,01-21,12:32
055 P�rols Etang de l'Or,24,44,68,2022,01-21,12:32
056 Albert 1er - Cath�drale,6,6,12,2022,01-21,12:32
057 Saint-Guilhem - Courreau,1,7,8,2022,01-21,12:32
059 Sud De France,2,6,8,2022,01-21,12:32
001 Rue Jules Ferry - Gare Saint-Roch,3,9,12,2022,01-21,12:42
002 Com�die,13,11,24,2022,01-21,12:42
003 Esplanade,13,19,32,2022,01-21,12:42
004 H�tel de Ville,7,9,16,2022,01-21,12:42
005 Corum,6,6,12,2022,01-21,12:42
006 Place Albert 1er - St Charles,24,7,31,2022,01-21,12:42
007 Foch,3,5,8,2022,01-21,12:42
008 Halles Castellane,9,3,12,2022,01-21,12:42
009 Observatoire,2,6,8,2022,01-21,12:42
010 Rondelet,1,15,16,2022,01-21,12:42
011 Plan Cabanes,2,10,12,2022,01-21,12:42
012 Boutonnet,3,9,12,2022,01-21,12:42
013 Emile Combes,7,1,8,2022,01-21,12:42
014 Beaux-Arts,3,5,8,2022,01-21,12:42
015 Les Aubes,4,4,8,2022,01-21,12:42
016 Antigone centre,5,11,16,2022,01-21,12:42
017 M�diath�que Emile Zola,7,9,16,2022,01-21,12:42
018 Nombre d'Or,9,7,16,2022,01-21,12:42
019 Louis Blanc,6,10,16,2022,01-21,12:42
020 Gambetta,3,5,8,2022,01-21,12:42
021 Port Marianne,14,2,16,2022,01-21,12:42
022 Clemenceau,8,4,12,2022,01-21,12:42
023 Les Arceaux,4,12,16,2022,01-21,12:42
024 Cit� Mion,3,5,8,2022,01-21,12:42
025 Nouveau Saint-Roch,6,2,8,2022,01-21,12:42
026 Renouvier,1,7,8,2022,01-21,12:42
027 Odysseum,4,4,8,2022,01-21,12:42
028 Saint-Denis,6,2,8,2022,01-21,12:42
029 Richter,10,6,16,2022,01-21,12:42
030 Charles Flahault,0,8,8,2022,01-21,12:42
031 Voltaire,3,5,8,2022,01-21,12:42
032 Pr�s d'Ar�nes,2,6,8,2022,01-21,12:42
033 Garcia Lorca,2,6,8,2022,01-21,12:42
034 Vert Bois,0,16,16,2022,01-21,12:42
035 Malbosc,2,6,8,2022,01-21,12:42
036 Occitanie,4,28,32,2022,01-21,12:42
037 FacdesSciences,6,18,24,2022,01-21,12:42
038 Fac de Lettres,6,10,16,2022,01-21,12:42
039 Aiguelongue,2,6,8,2022,01-21,12:42
040 Jeu de Mail des Abb�s,4,4,8,2022,01-21,12:42
041 Eurom�decine,2,6,8,2022,01-21,12:42
042 Marie Caizergues,5,3,8,2022,01-21,12:42
043 Sabines,6,2,8,2022,01-21,12:42
044 Celleneuve,0,8,8,2022,01-21,12:42
045 Jardin de la Lironde,6,2,8,2022,01-21,12:42
046 P�re Soulas,5,3,8,2022,01-21,12:42
047 Place Viala,2,6,8,2022,01-21,12:42
048 H�tel du D�partement,6,2,8,2022,01-21,12:42
049 Tonnelles,2,6,8,2022,01-21,12:42
050 Parvis Jules Ferry - Gare Saint-Roch,5,3,8,2022,01-21,12:42
051 Pont de Lattes - Gare Saint-Roch,1,11,12,2022,01-21,12:42
053 Deux Ponts - Gare Saint-Roch,2,6,8,2022,01-21,12:42
054 Providence - Ovalie,3,5,8,2022,01-21,12:42
055 P�rols Etang de l'Or,24,44,68,2022,01-21,12:42
056 Albert 1er - Cath�drale,6,6,12,2022,01-21,12:42
057 Saint-Guilhem - Courreau,2,6,8,2022,01-21,12:42
059 Sud De France,2,6,8,2022,01-21,12:42
001 Rue Jules Ferry - Gare Saint-Roch,3,9,12,2022,01-21,12:52
002 Com�die,13,11,24,2022,01-21,12:52
003 Esplanade,12,20,32,2022,01-21,12:52
004 H�tel de Ville,7,9,16,2022,01-21,12:52
005 Corum,6,6,12,2022,01-21,12:52
006 Place Albert 1er - St Charles,25,6,31,2022,01-21,12:52
007 Foch,3,5,8,2022,01-21,12:52
008 Halles Castellane,9,3,12,2022,01-21,12:52
009 Observatoire,2,6,8,2022,01-21,12:52
010 Rondelet,1,15,16,2022,01-21,12:52
011 Plan Cabanes,2,10,12,2022,01-21,12:52
012 Boutonnet,2,10,12,2022,01-21,12:52
013 Emile Combes,7,1,8,2022,01-21,12:52
014 Beaux-Arts,3,5,8,2022,01-21,12:52
015 Les Aubes,4,4,8,2022,01-21,12:52
016 Antigone centre,4,12,16,2022,01-21,12:52
017 M�diath�que Emile Zola,7,9,16,2022,01-21,12:52
018 Nombre d'Or,9,7,16,2022,01-21,12:52
019 Louis Blanc,6,10,16,2022,01-21,12:52
020 Gambetta,3,5,8,2022,01-21,12:52
021 Port Marianne,14,2,16,2022,01-21,12:52
022 Clemenceau,8,4,12,2022,01-21,12:52
023 Les Arceaux,4,12,16,2022,01-21,12:52
024 Cit� Mion,3,5,8,2022,01-21,12:52
025 Nouveau Saint-Roch,6,2,8,2022,01-21,12:52
026 Renouvier,1,7,8,2022,01-21,12:52
027 Odysseum,4,4,8,2022,01-21,12:52
028 Saint-Denis,6,2,8,2022,01-21,12:52
029 Richter,10,6,16,2022,01-21,12:52
030 Charles Flahault,0,8,8,2022,01-21,12:52
031 Voltaire,3,5,8,2022,01-21,12:52
032 Pr�s d'Ar�nes,2,6,8,2022,01-21,12:52
033 Garcia Lorca,2,6,8,2022,01-21,12:52
034 Vert Bois,0,16,16,2022,01-21,12:52
035 Malbosc,2,6,8,2022,01-21,12:52
036 Occitanie,4,28,32,2022,01-21,12:52
037 FacdesSciences,6,18,24,2022,01-21,12:52
038 Fac de Lettres,5,11,16,2022,01-21,12:52
039 Aiguelongue,2,6,8,2022,01-21,12:52
040 Jeu de Mail des Abb�s,4,4,8,2022,01-21,12:52
041 Eurom�decine,2,6,8,2022,01-21,12:52
042 Marie Caizergues,4,4,8,2022,01-21,12:52
043 Sabines,6,2,8,2022,01-21,12:52
044 Celleneuve,0,8,8,2022,01-21,12:52
045 Jardin de la Lironde,6,2,8,2022,01-21,12:52
046 P�re Soulas,5,3,8,2022,01-21,12:52
047 Place Viala,2,6,8,2022,01-21,12:52
048 H�tel du D�partement,6,2,8,2022,01-21,12:52
049 Tonnelles,2,6,8,2022,01-21,12:52
050 Parvis Jules Ferry - Gare Saint-Roch,5,3,8,2022,01-21,12:52
051 Pont de Lattes - Gare Saint-Roch,1,11,12,2022,01-21,12:52
053 Deux Ponts - Gare Saint-Roch,2,6,8,2022,01-21,12:52
054 Providence - Ovalie,3,5,8,2022,01-21,12:52
055 P�rols Etang de l'Or,25,43,68,2022,01-21,12:52
056 Albert 1er - Cath�drale,6,6,12,2022,01-21,12:52
057 Saint-Guilhem - Courreau,2,6,8,2022,01-21,12:52
059 Sud De France,2,6,8,2022,01-21,12:52
001 Rue Jules Ferry - Gare Saint-Roch,3,9,12,2022,01-21,13:02
002 Com�die,13,11,24,2022,01-21,13:02
003 Esplanade,12,20,32,2022,01-21,13:02
004 H�tel de Ville,7,9,16,2022,01-21,13:02
005 Corum,6,6,12,2022,01-21,13:02
006 Place Albert 1er - St Charles,27,4,31,2022,01-21,13:02
007 Foch,3,5,8,2022,01-21,13:02
008 Halles Castellane,9,3,12,2022,01-21,13:02
009 Observatoire,2,6,8,2022,01-21,13:02
010 Rondelet,1,15,16,2022,01-21,13:02
011 Plan Cabanes,2,10,12,2022,01-21,13:02
012 Boutonnet,2,10,12,2022,01-21,13:02
013 Emile Combes,8,0,8,2022,01-21,13:02
014 Beaux-Arts,3,5,8,2022,01-21,13:02
015 Les Aubes,4,4,8,2022,01-21,13:02
016 Antigone centre,3,13,16,2022,01-21,13:02
017 M�diath�que Emile Zola,7,9,16,2022,01-21,13:02
018 Nombre d'Or,9,7,16,2022,01-21,13:02
019 Louis Blanc,6,10,16,2022,01-21,13:02
020 Gambetta,3,5,8,2022,01-21,13:02
021 Port Marianne,14,2,16,2022,01-21,13:02
022 Clemenceau,7,5,12,2022,01-21,13:02
023 Les Arceaux,4,12,16,2022,01-21,13:02
024 Cit� Mion,3,5,8,2022,01-21,13:02
025 Nouveau Saint-Roch,6,2,8,2022,01-21,13:02
026 Renouvier,1,7,8,2022,01-21,13:02
027 Odysseum,4,4,8,2022,01-21,13:02
028 Saint-Denis,6,2,8,2022,01-21,13:02
029 Richter,10,6,16,2022,01-21,13:02
030 Charles Flahault,0,8,8,2022,01-21,13:02
031 Voltaire,3,5,8,2022,01-21,13:02
032 Pr�s d'Ar�nes,2,6,8,2022,01-21,13:02
033 Garcia Lorca,2,6,8,2022,01-21,13:02
034 Vert Bois,0,16,16,2022,01-21,13:02
035 Malbosc,2,6,8,2022,01-21,13:02
036 Occitanie,4,28,32,2022,01-21,13:02
037 FacdesSciences,6,18,24,2022,01-21,13:02
038 Fac de Lettres,5,11,16,2022,01-21,13:02
039 Aiguelongue,2,6,8,2022,01-21,13:02
040 Jeu de Mail des Abb�s,4,4,8,2022,01-21,13:02
041 Eurom�decine,2,6,8,2022,01-21,13:02
042 Marie Caizergues,4,4,8,2022,01-21,13:02
043 Sabines,6,2,8,2022,01-21,13:02
044 Celleneuve,0,8,8,2022,01-21,13:02
045 Jardin de la Lironde,6,2,8,2022,01-21,13:02
046 P�re Soulas,5,3,8,2022,01-21,13:02
047 Place Viala,3,5,8,2022,01-21,13:02
048 H�tel du D�partement,6,2,8,2022,01-21,13:02
049 Tonnelles,2,6,8,2022,01-21,13:02
050 Parvis Jules Ferry - Gare Saint-Roch,5,3,8,2022,01-21,13:02
051 Pont de Lattes - Gare Saint-Roch,1,11,12,2022,01-21,13:02
053 Deux Ponts - Gare Saint-Roch,2,6,8,2022,01-21,13:02
054 Providence - Ovalie,3,5,8,2022,01-21,13:02
055 P�rols Etang de l'Or,23,45,68,2022,01-21,13:02
056 Albert 1er - Cath�drale,5,7,12,2022,01-21,13:02
057 Saint-Guilhem - Courreau,2,6,8,2022,01-21,13:02
059 Sud De France,2,6,8,2022,01-21,13:02
001 Rue Jules Ferry - Gare Saint-Roch,4,8,12,2022,01-21,13:12
002 Com�die,13,11,24,2022,01-21,13:12
003 Esplanade,11,21,32,2022,01-21,13:12
004 H�tel de Ville,7,9,16,2022,01-21,13:12
005 Corum,6,6,12,2022,01-21,13:12
006 Place Albert 1er - St Charles,27,4,31,2022,01-21,13:12
007 Foch,3,5,8,2022,01-21,13:12
008 Halles Castellane,9,3,12,2022,01-21,13:12
009 Observatoire,2,6,8,2022,01-21,13:12
010 Rondelet,1,15,16,2022,01-21,13:12
011 Plan Cabanes,3,9,12,2022,01-21,13:12
012 Boutonnet,2,10,12,2022,01-21,13:12
013 Emile Combes,8,0,8,2022,01-21,13:12
014 Beaux-Arts,3,5,8,2022,01-21,13:12
015 Les Aubes,4,4,8,2022,01-21,13:12
016 Antigone centre,3,13,16,2022,01-21,13:12
017 M�diath�que Emile Zola,7,9,16,2022,01-21,13:12
018 Nombre d'Or,9,7,16,2022,01-21,13:12
019 Louis Blanc,8,8,16,2022,01-21,13:12
020 Gambetta,3,5,8,2022,01-21,13:12
021 Port Marianne,14,2,16,2022,01-21,13:12
022 Clemenceau,7,5,12,2022,01-21,13:12
023 Les Arceaux,4,12,16,2022,01-21,13:12
024 Cit� Mion,3,5,8,2022,01-21,13:12
025 Nouveau Saint-Roch,6,2,8,2022,01-21,13:12
026 Renouvier,1,7,8,2022,01-21,13:12
027 Odysseum,4,4,8,2022,01-21,13:12
028 Saint-Denis,6,2,8,2022,01-21,13:12
029 Richter,10,6,16,2022,01-21,13:12
030 Charles Flahault,0,8,8,2022,01-21,13:12
031 Voltaire,3,5,8,2022,01-21,13:12
032 Pr�s d'Ar�nes,3,5,8,2022,01-21,13:12
033 Garcia Lorca,1,7,8,2022,01-21,13:12
034 Vert Bois,0,16,16,2022,01-21,13:12
035 Malbosc,2,6,8,2022,01-21,13:12
036 Occitanie,4,28,32,2022,01-21,13:12
037 FacdesSciences,7,17,24,2022,01-21,13:12
038 Fac de Lettres,4,12,16,2022,01-21,13:12
039 Aiguelongue,2,6,8,2022,01-21,13:12
040 Jeu de Mail des Abb�s,5,3,8,2022,01-21,13:12
041 Eurom�decine,2,6,8,2022,01-21,13:12
042 Marie Caizergues,4,4,8,2022,01-21,13:12
043 Sabines,6,2,8,2022,01-21,13:12
044 Celleneuve,0,8,8,2022,01-21,13:12
045 Jardin de la Lironde,6,2,8,2022,01-21,13:12
046 P�re Soulas,5,3,8,2022,01-21,13:12
047 Place Viala,3,5,8,2022,01-21,13:12
048 H�tel du D�partement,6,2,8,2022,01-21,13:12
049 Tonnelles,2,6,8,2022,01-21,13:12
050 Parvis Jules Ferry - Gare Saint-Roch,5,3,8,2022,01-21,13:12
051 Pont de Lattes - Gare Saint-Roch,1,11,12,2022,01-21,13:12
053 Deux Ponts - Gare Saint-Roch,2,6,8,2022,01-21,13:12
054 Providence - Ovalie,3,5,8,2022,01-21,13:12
055 P�rols Etang de l'Or,23,45,68,2022,01-21,13:12
056 Albert 1er - Cath�drale,4,8,12,2022,01-21,13:12
057 Saint-Guilhem - Courreau,2,6,8,2022,01-21,13:12
059 Sud De France,2,6,8,2022,01-21,13:12
001 Rue Jules Ferry - Gare Saint-Roch,4,8,12,2022,01-21,13:23
002 Com�die,13,11,24,2022,01-21,13:23
003 Esplanade,10,22,32,2022,01-21,13:23
004 H�tel de Ville,7,9,16,2022,01-21,13:23
005 Corum,5,7,12,2022,01-21,13:23
006 Place Albert 1er - St Charles,27,4,31,2022,01-21,13:23
007 Foch,3,5,8,2022,01-21,13:23
008 Halles Castellane,9,3,12,2022,01-21,13:23
009 Observatoire,2,6,8,2022,01-21,13:23
010 Rondelet,1,15,16,2022,01-21,13:23
011 Plan Cabanes,3,9,12,2022,01-21,13:23
012 Boutonnet,2,10,12,2022,01-21,13:23
013 Emile Combes,8,0,8,2022,01-21,13:23
014 Beaux-Arts,3,5,8,2022,01-21,13:23
015 Les Aubes,4,4,8,2022,01-21,13:23
016 Antigone centre,3,13,16,2022,01-21,13:23
017 M�diath�que Emile Zola,7,9,16,2022,01-21,13:23
018 Nombre d'Or,9,7,16,2022,01-21,13:23
019 Louis Blanc,8,8,16,2022,01-21,13:23
020 Gambetta,3,5,8,2022,01-21,13:23
021 Port Marianne,14,2,16,2022,01-21,13:23
022 Clemenceau,6,6,12,2022,01-21,13:23
023 Les Arceaux,4,12,16,2022,01-21,13:23
024 Cit� Mion,3,5,8,2022,01-21,13:23
025 Nouveau Saint-Roch,6,2,8,2022,01-21,13:23
026 Renouvier,1,7,8,2022,01-21,13:23
027 Odysseum,4,4,8,2022,01-21,13:23
028 Saint-Denis,6,2,8,2022,01-21,13:23
029 Richter,10,6,16,2022,01-21,13:23
030 Charles Flahault,0,8,8,2022,01-21,13:23
031 Voltaire,3,5,8,2022,01-21,13:23
032 Pr�s d'Ar�nes,3,5,8,2022,01-21,13:23
033 Garcia Lorca,1,7,8,2022,01-21,13:23
034 Vert Bois,0,16,16,2022,01-21,13:23
035 Malbosc,2,6,8,2022,01-21,13:23
036 Occitanie,4,28,32,2022,01-21,13:23
037 FacdesSciences,7,17,24,2022,01-21,13:23
038 Fac de Lettres,4,12,16,2022,01-21,13:23
039 Aiguelongue,2,6,8,2022,01-21,13:23
040 Jeu de Mail des Abb�s,5,3,8,2022,01-21,13:23
041 Eurom�decine,2,6,8,2022,01-21,13:23
042 Marie Caizergues,4,4,8,2022,01-21,13:23
043 Sabines,6,2,8,2022,01-21,13:23
044 Celleneuve,0,8,8,2022,01-21,13:23
045 Jardin de la Lironde,6,2,8,2022,01-21,13:23
046 P�re Soulas,5,3,8,2022,01-21,13:23
047 Place Viala,3,5,8,2022,01-21,13:23
048 H�tel du D�partement,6,2,8,2022,01-21,13:23
049 Tonnelles,2,6,8,2022,01-21,13:23
050 Parvis Jules Ferry - Gare Saint-Roch,5,3,8,2022,01-21,13:23
051 Pont de Lattes - Gare Saint-Roch,1,11,12,2022,01-21,13:23
053 Deux Ponts - Gare Saint-Roch,1,7,8,2022,01-21,13:23
054 Providence - Ovalie,3,5,8,2022,01-21,13:23
055 P�rols Etang de l'Or,23,45,68,2022,01-21,13:23
056 Albert 1er - Cath�drale,4,8,12,2022,01-21,13:23
057 Saint-Guilhem - Courreau,2,6,8,2022,01-21,13:23
059 Sud De France,2,6,8,2022,01-21,13:23
001 Rue Jules Ferry - Gare Saint-Roch,4,8,12,2022,01-21,13:33
002 Com�die,13,11,24,2022,01-21,13:33
003 Esplanade,10,22,32,2022,01-21,13:33
004 H�tel de Ville,8,8,16,2022,01-21,13:33
005 Corum,6,6,12,2022,01-21,13:33
006 Place Albert 1er - St Charles,25,6,31,2022,01-21,13:33
007 Foch,3,5,8,2022,01-21,13:33
008 Halles Castellane,8,4,12,2022,01-21,13:33
009 Observatoire,2,6,8,2022,01-21,13:33
010 Rondelet,1,15,16,2022,01-21,13:33
011 Plan Cabanes,3,9,12,2022,01-21,13:33
012 Boutonnet,3,9,12,2022,01-21,13:33
013 Emile Combes,8,0,8,2022,01-21,13:33
014 Beaux-Arts,3,5,8,2022,01-21,13:33
015 Les Aubes,4,4,8,2022,01-21,13:33
016 Antigone centre,2,14,16,2022,01-21,13:33
017 M�diath�que Emile Zola,7,9,16,2022,01-21,13:33
018 Nombre d'Or,10,6,16,2022,01-21,13:33
019 Louis Blanc,8,8,16,2022,01-21,13:33
020 Gambetta,3,5,8,2022,01-21,13:33
021 Port Marianne,14,2,16,2022,01-21,13:33
022 Clemenceau,6,6,12,2022,01-21,13:33
023 Les Arceaux,5,11,16,2022,01-21,13:33
024 Cit� Mion,3,5,8,2022,01-21,13:33
025 Nouveau Saint-Roch,5,3,8,2022,01-21,13:33
026 Renouvier,1,7,8,2022,01-21,13:33
027 Odysseum,4,4,8,2022,01-21,13:33
028 Saint-Denis,5,3,8,2022,01-21,13:33
029 Richter,11,5,16,2022,01-21,13:33
030 Charles Flahault,0,8,8,2022,01-21,13:33
031 Voltaire,3,5,8,2022,01-21,13:33
032 Pr�s d'Ar�nes,3,5,8,2022,01-21,13:33
033 Garcia Lorca,1,7,8,2022,01-21,13:33
034 Vert Bois,0,16,16,2022,01-21,13:33
035 Malbosc,2,6,8,2022,01-21,13:33
036 Occitanie,4,28,32,2022,01-21,13:33
037 FacdesSciences,7,17,24,2022,01-21,13:33
038 Fac de Lettres,3,13,16,2022,01-21,13:33
039 Aiguelongue,2,6,8,2022,01-21,13:33
040 Jeu de Mail des Abb�s,5,3,8,2022,01-21,13:33
041 Eurom�decine,2,6,8,2022,01-21,13:33
042 Marie Caizergues,4,4,8,2022,01-21,13:33
043 Sabines,6,2,8,2022,01-21,13:33
044 Celleneuve,0,8,8,2022,01-21,13:33
045 Jardin de la Lironde,6,2,8,2022,01-21,13:33
046 P�re Soulas,5,3,8,2022,01-21,13:33
047 Place Viala,3,5,8,2022,01-21,13:33
048 H�tel du D�partement,6,2,8,2022,01-21,13:33
049 Tonnelles,2,6,8,2022,01-21,13:33
050 Parvis Jules Ferry - Gare Saint-Roch,5,3,8,2022,01-21,13:33
051 Pont de Lattes - Gare Saint-Roch,1,11,12,2022,01-21,13:33
053 Deux Ponts - Gare Saint-Roch,1,7,8,2022,01-21,13:33
054 Providence - Ovalie,3,5,8,2022,01-21,13:33
055 P�rols Etang de l'Or,23,45,68,2022,01-21,13:33
056 Albert 1er - Cath�drale,4,8,12,2022,01-21,13:33
057 Saint-Guilhem - Courreau,2,6,8,2022,01-21,13:33
059 Sud De France,2,6,8,2022,01-21,13:33
001 Rue Jules Ferry - Gare Saint-Roch,4,8,12,2022,01-21,13:43
002 Com�die,13,11,24,2022,01-21,13:43
003 Esplanade,10,22,32,2022,01-21,13:43
004 H�tel de Ville,8,8,16,2022,01-21,13:43
005 Corum,6,6,12,2022,01-21,13:43
006 Place Albert 1er - St Charles,25,6,31,2022,01-21,13:43
007 Foch,3,5,8,2022,01-21,13:43
008 Halles Castellane,8,4,12,2022,01-21,13:43
009 Observatoire,2,6,8,2022,01-21,13:43
010 Rondelet,1,15,16,2022,01-21,13:43
011 Plan Cabanes,3,9,12,2022,01-21,13:43
012 Boutonnet,3,9,12,2022,01-21,13:43
013 Emile Combes,8,0,8,2022,01-21,13:43
014 Beaux-Arts,3,5,8,2022,01-21,13:43
015 Les Aubes,4,4,8,2022,01-21,13:43
016 Antigone centre,2,14,16,2022,01-21,13:43
017 M�diath�que Emile Zola,8,8,16,2022,01-21,13:43
018 Nombre d'Or,10,6,16,2022,01-21,13:43
019 Louis Blanc,8,8,16,2022,01-21,13:43
020 Gambetta,3,5,8,2022,01-21,13:43
021 Port Marianne,14,2,16,2022,01-21,13:43
022 Clemenceau,6,6,12,2022,01-21,13:43
023 Les Arceaux,5,11,16,2022,01-21,13:43
024 Cit� Mion,3,5,8,2022,01-21,13:43
025 Nouveau Saint-Roch,5,3,8,2022,01-21,13:43
026 Renouvier,2,6,8,2022,01-21,13:43
027 Odysseum,4,4,8,2022,01-21,13:43
028 Saint-Denis,4,4,8,2022,01-21,13:43
029 Richter,11,5,16,2022,01-21,13:43
030 Charles Flahault,0,8,8,2022,01-21,13:43
031 Voltaire,3,5,8,2022,01-21,13:43
032 Pr�s d'Ar�nes,3,5,8,2022,01-21,13:43
033 Garcia Lorca,1,7,8,2022,01-21,13:43
034 Vert Bois,0,16,16,2022,01-21,13:43
035 Malbosc,2,6,8,2022,01-21,13:43
036 Occitanie,5,27,32,2022,01-21,13:43
037 FacdesSciences,7,17,24,2022,01-21,13:43
038 Fac de Lettres,3,13,16,2022,01-21,13:43
039 Aiguelongue,2,6,8,2022,01-21,13:43
040 Jeu de Mail des Abb�s,5,3,8,2022,01-21,13:43
041 Eurom�decine,2,6,8,2022,01-21,13:43
042 Marie Caizergues,4,4,8,2022,01-21,13:43
043 Sabines,6,2,8,2022,01-21,13:43
044 Celleneuve,0,8,8,2022,01-21,13:43
045 Jardin de la Lironde,6,2,8,2022,01-21,13:43
046 P�re Soulas,5,3,8,2022,01-21,13:43
047 Place Viala,3,5,8,2022,01-21,13:43
048 H�tel du D�partement,6,2,8,2022,01-21,13:43
049 Tonnelles,2,6,8,2022,01-21,13:43
050 Parvis Jules Ferry - Gare Saint-Roch,5,3,8,2022,01-21,13:43
051 Pont de Lattes - Gare Saint-Roch,2,10,12,2022,01-21,13:43
053 Deux Ponts - Gare Saint-Roch,1,7,8,2022,01-21,13:43
054 Providence - Ovalie,3,5,8,2022,01-21,13:43
055 P�rols Etang de l'Or,21,47,68,2022,01-21,13:43
056 Albert 1er - Cath�drale,4,8,12,2022,01-21,13:43
057 Saint-Guilhem - Courreau,2,6,8,2022,01-21,13:43
059 Sud De France,2,6,8,2022,01-21,13:43
001 Rue Jules Ferry - Gare Saint-Roch,4,8,12,2022,01-21,13:53
002 Com�die,13,11,24,2022,01-21,13:53
003 Esplanade,9,23,32,2022,01-21,13:53
004 H�tel de Ville,8,8,16,2022,01-21,13:53
005 Corum,6,6,12,2022,01-21,13:53
006 Place Albert 1er - St Charles,27,4,31,2022,01-21,13:53
007 Foch,3,5,8,2022,01-21,13:53
008 Halles Castellane,8,4,12,2022,01-21,13:53
009 Observatoire,2,6,8,2022,01-21,13:53
010 Rondelet,1,15,16,2022,01-21,13:53
011 Plan Cabanes,3,9,12,2022,01-21,13:53
012 Boutonnet,3,9,12,2022,01-21,13:53
013 Emile Combes,8,0,8,2022,01-21,13:53
014 Beaux-Arts,3,5,8,2022,01-21,13:53
015 Les Aubes,4,4,8,2022,01-21,13:53
016 Antigone centre,2,14,16,2022,01-21,13:53
017 M�diath�que Emile Zola,7,9,16,2022,01-21,13:53
018 Nombre d'Or,10,6,16,2022,01-21,13:53
019 Louis Blanc,8,8,16,2022,01-21,13:53
020 Gambetta,3,5,8,2022,01-21,13:53
021 Port Marianne,14,2,16,2022,01-21,13:53
022 Clemenceau,6,6,12,2022,01-21,13:53
023 Les Arceaux,4,12,16,2022,01-21,13:53
024 Cit� Mion,3,5,8,2022,01-21,13:53
025 Nouveau Saint-Roch,6,2,8,2022,01-21,13:53
026 Renouvier,2,6,8,2022,01-21,13:53
027 Odysseum,4,4,8,2022,01-21,13:53
028 Saint-Denis,4,4,8,2022,01-21,13:53
029 Richter,11,5,16,2022,01-21,13:53
030 Charles Flahault,0,8,8,2022,01-21,13:53
031 Voltaire,3,5,8,2022,01-21,13:53
032 Pr�s d'Ar�nes,3,5,8,2022,01-21,13:53
033 Garcia Lorca,1,7,8,2022,01-21,13:53
034 Vert Bois,0,16,16,2022,01-21,13:53
035 Malbosc,2,6,8,2022,01-21,13:53
036 Occitanie,5,27,32,2022,01-21,13:53
037 FacdesSciences,6,18,24,2022,01-21,13:53
038 Fac de Lettres,3,13,16,2022,01-21,13:53
039 Aiguelongue,2,6,8,2022,01-21,13:53
040 Jeu de Mail des Abb�s,5,3,8,2022,01-21,13:53
041 Eurom�decine,2,6,8,2022,01-21,13:53
042 Marie Caizergues,4,4,8,2022,01-21,13:53
043 Sabines,6,2,8,2022,01-21,13:53
044 Celleneuve,0,8,8,2022,01-21,13:53
045 Jardin de la Lironde,6,2,8,2022,01-21,13:53
046 P�re Soulas,4,4,8,2022,01-21,13:53
047 Place Viala,3,5,8,2022,01-21,13:53
048 H�tel du D�partement,6,2,8,2022,01-21,13:53
049 Tonnelles,2,6,8,2022,01-21,13:53
050 Parvis Jules Ferry - Gare Saint-Roch,5,3,8,2022,01-21,13:53
051 Pont de Lattes - Gare Saint-Roch,1,11,12,2022,01-21,13:53
053 Deux Ponts - Gare Saint-Roch,1,7,8,2022,01-21,13:53
054 Providence - Ovalie,3,5,8,2022,01-21,13:53
055 P�rols Etang de l'Or,21,47,68,2022,01-21,13:53
056 Albert 1er - Cath�drale,4,8,12,2022,01-21,13:53
057 Saint-Guilhem - Courreau,2,6,8,2022,01-21,13:53
059 Sud De France,2,6,8,2022,01-21,13:53
001 Rue Jules Ferry - Gare Saint-Roch,4,8,12,2022,01-21,14:03
002 Com�die,13,11,24,2022,01-21,14:03
003 Esplanade,9,23,32,2022,01-21,14:03
004 H�tel de Ville,8,8,16,2022,01-21,14:03
005 Corum,6,6,12,2022,01-21,14:03
006 Place Albert 1er - St Charles,28,3,31,2022,01-21,14:03
007 Foch,3,5,8,2022,01-21,14:03
008 Halles Castellane,8,4,12,2022,01-21,14:03
009 Observatoire,2,6,8,2022,01-21,14:03
010 Rondelet,1,15,16,2022,01-21,14:03
011 Plan Cabanes,3,9,12,2022,01-21,14:03
012 Boutonnet,2,10,12,2022,01-21,14:03
013 Emile Combes,8,0,8,2022,01-21,14:03
014 Beaux-Arts,3,5,8,2022,01-21,14:03
015 Les Aubes,3,5,8,2022,01-21,14:03
016 Antigone centre,2,14,16,2022,01-21,14:03
017 M�diath�que Emile Zola,7,9,16,2022,01-21,14:03
018 Nombre d'Or,10,6,16,2022,01-21,14:03
019 Louis Blanc,8,8,16,2022,01-21,14:03
020 Gambetta,3,5,8,2022,01-21,14:03
021 Port Marianne,14,2,16,2022,01-21,14:03
022 Clemenceau,7,5,12,2022,01-21,14:03
023 Les Arceaux,4,12,16,2022,01-21,14:03
024 Cit� Mion,3,5,8,2022,01-21,14:03
025 Nouveau Saint-Roch,6,2,8,2022,01-21,14:03
026 Renouvier,2,6,8,2022,01-21,14:03
027 Odysseum,4,4,8,2022,01-21,14:03
028 Saint-Denis,6,2,8,2022,01-21,14:03
029 Richter,12,4,16,2022,01-21,14:03
030 Charles Flahault,0,8,8,2022,01-21,14:03
031 Voltaire,2,6,8,2022,01-21,14:03
032 Pr�s d'Ar�nes,3,5,8,2022,01-21,14:03
033 Garcia Lorca,1,7,8,2022,01-21,14:03
034 Vert Bois,0,16,16,2022,01-21,14:03
035 Malbosc,2,6,8,2022,01-21,14:03
036 Occitanie,4,28,32,2022,01-21,14:03
037 FacdesSciences,6,18,24,2022,01-21,14:03
038 Fac de Lettres,2,14,16,2022,01-21,14:03
039 Aiguelongue,2,6,8,2022,01-21,14:03
040 Jeu de Mail des Abb�s,5,3,8,2022,01-21,14:03
041 Eurom�decine,2,6,8,2022,01-21,14:03
042 Marie Caizergues,4,4,8,2022,01-21,14:03
043 Sabines,6,2,8,2022,01-21,14:03
044 Celleneuve,0,8,8,2022,01-21,14:03
045 Jardin de la Lironde,6,2,8,2022,01-21,14:03
046 P�re Soulas,5,3,8,2022,01-21,14:03
047 Place Viala,3,5,8,2022,01-21,14:03
048 H�tel du D�partement,6,2,8,2022,01-21,14:03
049 Tonnelles,2,6,8,2022,01-21,14:03
050 Parvis Jules Ferry - Gare Saint-Roch,6,2,8,2022,01-21,14:03
051 Pont de Lattes - Gare Saint-Roch,1,11,12,2022,01-21,14:03
053 Deux Ponts - Gare Saint-Roch,1,7,8,2022,01-21,14:03
054 Providence - Ovalie,3,5,8,2022,01-21,14:03
055 P�rols Etang de l'Or,21,47,68,2022,01-21,14:03
056 Albert 1er - Cath�drale,4,8,12,2022,01-21,14:03
057 Saint-Guilhem - Courreau,2,6,8,2022,01-21,14:03
059 Sud De France,2,6,8,2022,01-21,14:03
001 Rue Jules Ferry - Gare Saint-Roch,4,8,12,2022,01-21,14:13
002 Com�die,13,11,24,2022,01-21,14:13
003 Esplanade,8,24,32,2022,01-21,14:13
004 H�tel de Ville,8,8,16,2022,01-21,14:13
005 Corum,7,5,12,2022,01-21,14:13
006 Place Albert 1er - St Charles,28,3,31,2022,01-21,14:13
007 Foch,3,5,8,2022,01-21,14:13
008 Halles Castellane,8,4,12,2022,01-21,14:13
009 Observatoire,1,7,8,2022,01-21,14:13
010 Rondelet,1,15,16,2022,01-21,14:13
011 Plan Cabanes,3,9,12,2022,01-21,14:13
012 Boutonnet,2,10,12,2022,01-21,14:13
013 Emile Combes,8,0,8,2022,01-21,14:13
014 Beaux-Arts,3,5,8,2022,01-21,14:13
015 Les Aubes,3,5,8,2022,01-21,14:13
016 Antigone centre,3,13,16,2022,01-21,14:13
017 M�diath�que Emile Zola,7,9,16,2022,01-21,14:13
018 Nombre d'Or,10,6,16,2022,01-21,14:13
019 Louis Blanc,8,8,16,2022,01-21,14:13
020 Gambetta,3,5,8,2022,01-21,14:13
021 Port Marianne,14,2,16,2022,01-21,14:13
022 Clemenceau,7,5,12,2022,01-21,14:13
023 Les Arceaux,4,12,16,2022,01-21,14:13
024 Cit� Mion,3,5,8,2022,01-21,14:13
025 Nouveau Saint-Roch,5,3,8,2022,01-21,14:13
026 Renouvier,2,6,8,2022,01-21,14:13
027 Odysseum,4,4,8,2022,01-21,14:13
028 Saint-Denis,6,2,8,2022,01-21,14:13
029 Richter,11,5,16,2022,01-21,14:13
030 Charles Flahault,0,8,8,2022,01-21,14:13
031 Voltaire,2,6,8,2022,01-21,14:13
032 Pr�s d'Ar�nes,3,5,8,2022,01-21,14:13
033 Garcia Lorca,1,7,8,2022,01-21,14:13
034 Vert Bois,0,16,16,2022,01-21,14:13
035 Malbosc,2,6,8,2022,01-21,14:13
036 Occitanie,4,28,32,2022,01-21,14:13
037 FacdesSciences,6,18,24,2022,01-21,14:13
038 Fac de Lettres,2,14,16,2022,01-21,14:13
039 Aiguelongue,2,6,8,2022,01-21,14:13
040 Jeu de Mail des Abb�s,5,3,8,2022,01-21,14:13
041 Eurom�decine,2,6,8,2022,01-21,14:13
042 Marie Caizergues,4,4,8,2022,01-21,14:13
043 Sabines,6,2,8,2022,01-21,14:13
044 Celleneuve,0,8,8,2022,01-21,14:13
045 Jardin de la Lironde,6,2,8,2022,01-21,14:13
046 P�re Soulas,5,3,8,2022,01-21,14:13
047 Place Viala,3,5,8,2022,01-21,14:13
048 H�tel du D�partement,6,2,8,2022,01-21,14:13
049 Tonnelles,2,6,8,2022,01-21,14:13
050 Parvis Jules Ferry - Gare Saint-Roch,6,2,8,2022,01-21,14:13
051 Pont de Lattes - Gare Saint-Roch,1,11,12,2022,01-21,14:13
053 Deux Ponts - Gare Saint-Roch,1,7,8,2022,01-21,14:13
054 Providence - Ovalie,3,5,8,2022,01-21,14:13
055 P�rols Etang de l'Or,21,47,68,2022,01-21,14:13
056 Albert 1er - Cath�drale,4,8,12,2022,01-21,14:13
057 Saint-Guilhem - Courreau,2,6,8,2022,01-21,14:13
059 Sud De France,2,6,8,2022,01-21,14:13
001 Rue Jules Ferry - Gare Saint-Roch,4,8,12,2022,01-21,14:24
002 Com�die,13,11,24,2022,01-21,14:24
003 Esplanade,8,24,32,2022,01-21,14:24
004 H�tel de Ville,8,8,16,2022,01-21,14:24
005 Corum,7,5,12,2022,01-21,14:24
006 Place Albert 1er - St Charles,28,3,31,2022,01-21,14:24
007 Foch,4,4,8,2022,01-21,14:24
008 Halles Castellane,8,4,12,2022,01-21,14:24
009 Observatoire,1,7,8,2022,01-21,14:24
010 Rondelet,1,15,16,2022,01-21,14:24
011 Plan Cabanes,2,10,12,2022,01-21,14:24
012 Boutonnet,2,10,12,2022,01-21,14:24
013 Emile Combes,8,0,8,2022,01-21,14:24
014 Beaux-Arts,3,5,8,2022,01-21,14:24
015 Les Aubes,4,4,8,2022,01-21,14:24
016 Antigone centre,3,13,16,2022,01-21,14:24
017 M�diath�que Emile Zola,7,9,16,2022,01-21,14:24
018 Nombre d'Or,11,5,16,2022,01-21,14:24
019 Louis Blanc,9,7,16,2022,01-21,14:24
020 Gambetta,4,4,8,2022,01-21,14:24
021 Port Marianne,14,2,16,2022,01-21,14:24
022 Clemenceau,7,5,12,2022,01-21,14:24
023 Les Arceaux,3,13,16,2022,01-21,14:24
024 Cit� Mion,3,5,8,2022,01-21,14:24
025 Nouveau Saint-Roch,5,3,8,2022,01-21,14:24
026 Renouvier,2,6,8,2022,01-21,14:24
027 Odysseum,5,3,8,2022,01-21,14:24
028 Saint-Denis,6,2,8,2022,01-21,14:24
029 Richter,11,5,16,2022,01-21,14:24
030 Charles Flahault,0,8,8,2022,01-21,14:24
031 Voltaire,2,6,8,2022,01-21,14:24
032 Pr�s d'Ar�nes,3,5,8,2022,01-21,14:24
033 Garcia Lorca,2,6,8,2022,01-21,14:24
034 Vert Bois,0,16,16,2022,01-21,14:24
035 Malbosc,2,6,8,2022,01-21,14:24
036 Occitanie,4,28,32,2022,01-21,14:24
037 FacdesSciences,6,18,24,2022,01-21,14:24
038 Fac de Lettres,2,14,16,2022,01-21,14:24
039 Aiguelongue,2,6,8,2022,01-21,14:24
040 Jeu de Mail des Abb�s,5,3,8,2022,01-21,14:24
041 Eurom�decine,2,6,8,2022,01-21,14:24
042 Marie Caizergues,4,4,8,2022,01-21,14:24
043 Sabines,6,2,8,2022,01-21,14:24
044 Celleneuve,0,8,8,2022,01-21,14:24
045 Jardin de la Lironde,6,2,8,2022,01-21,14:24
046 P�re Soulas,5,3,8,2022,01-21,14:24
047 Place Viala,3,5,8,2022,01-21,14:24
048 H�tel du D�partement,6,2,8,2022,01-21,14:24
049 Tonnelles,2,6,8,2022,01-21,14:24
050 Parvis Jules Ferry - Gare Saint-Roch,7,1,8,2022,01-21,14:24
051 Pont de Lattes - Gare Saint-Roch,1,11,12,2022,01-21,14:24
053 Deux Ponts - Gare Saint-Roch,1,7,8,2022,01-21,14:24
054 Providence - Ovalie,3,5,8,2022,01-21,14:24
055 P�rols Etang de l'Or,21,47,68,2022,01-21,14:24
056 Albert 1er - Cath�drale,4,8,12,2022,01-21,14:24
057 Saint-Guilhem - Courreau,2,6,8,2022,01-21,14:24
059 Sud De France,2,6,8,2022,01-21,14:24
001 Rue Jules Ferry - Gare Saint-Roch,4,8,12,2022,01-21,14:34
002 Com�die,13,11,24,2022,01-21,14:34
003 Esplanade,8,24,32,2022,01-21,14:34
004 H�tel de Ville,8,8,16,2022,01-21,14:34
005 Corum,7,5,12,2022,01-21,14:34
006 Place Albert 1er - St Charles,28,3,31,2022,01-21,14:34
007 Foch,4,4,8,2022,01-21,14:34
008 Halles Castellane,8,4,12,2022,01-21,14:34
009 Observatoire,1,7,8,2022,01-21,14:34
010 Rondelet,1,15,16,2022,01-21,14:34
011 Plan Cabanes,2,10,12,2022,01-21,14:34
012 Boutonnet,2,10,12,2022,01-21,14:34
013 Emile Combes,8,0,8,2022,01-21,14:34
014 Beaux-Arts,3,5,8,2022,01-21,14:34
015 Les Aubes,3,5,8,2022,01-21,14:34
016 Antigone centre,3,13,16,2022,01-21,14:34
017 M�diath�que Emile Zola,7,9,16,2022,01-21,14:34
018 Nombre d'Or,11,5,16,2022,01-21,14:34
019 Louis Blanc,9,7,16,2022,01-21,14:34
020 Gambetta,3,5,8,2022,01-21,14:34
021 Port Marianne,14,2,16,2022,01-21,14:34
022 Clemenceau,7,5,12,2022,01-21,14:34
023 Les Arceaux,3,13,16,2022,01-21,14:34
024 Cit� Mion,3,5,8,2022,01-21,14:34
025 Nouveau Saint-Roch,5,3,8,2022,01-21,14:34
026 Renouvier,2,6,8,2022,01-21,14:34
027 Odysseum,5,3,8,2022,01-21,14:34
028 Saint-Denis,6,2,8,2022,01-21,14:34
029 Richter,11,5,16,2022,01-21,14:34
030 Charles Flahault,0,8,8,2022,01-21,14:34
031 Voltaire,2,6,8,2022,01-21,14:34
032 Pr�s d'Ar�nes,3,5,8,2022,01-21,14:34
033 Garcia Lorca,2,6,8,2022,01-21,14:34
034 Vert Bois,0,16,16,2022,01-21,14:34
035 Malbosc,2,6,8,2022,01-21,14:34
036 Occitanie,4,28,32,2022,01-21,14:34
037 FacdesSciences,5,19,24,2022,01-21,14:34
038 Fac de Lettres,2,14,16,2022,01-21,14:34
039 Aiguelongue,2,6,8,2022,01-21,14:34
040 Jeu de Mail des Abb�s,5,3,8,2022,01-21,14:34
041 Eurom�decine,2,6,8,2022,01-21,14:34
042 Marie Caizergues,4,4,8,2022,01-21,14:34
043 Sabines,6,2,8,2022,01-21,14:34
044 Celleneuve,0,8,8,2022,01-21,14:34
045 Jardin de la Lironde,6,2,8,2022,01-21,14:34
046 P�re Soulas,5,3,8,2022,01-21,14:34
047 Place Viala,4,4,8,2022,01-21,14:34
048 H�tel du D�partement,6,2,8,2022,01-21,14:34
049 Tonnelles,2,6,8,2022,01-21,14:34
050 Parvis Jules Ferry - Gare Saint-Roch,7,1,8,2022,01-21,14:34
051 Pont de Lattes - Gare Saint-Roch,1,11,12,2022,01-21,14:34
053 Deux Ponts - Gare Saint-Roch,1,7,8,2022,01-21,14:34
054 Providence - Ovalie,3,5,8,2022,01-21,14:34
055 P�rols Etang de l'Or,21,47,68,2022,01-21,14:34
056 Albert 1er - Cath�drale,4,8,12,2022,01-21,14:34
057 Saint-Guilhem - Courreau,2,6,8,2022,01-21,14:34
059 Sud De France,2,6,8,2022,01-21,14:34
001 Rue Jules Ferry - Gare Saint-Roch,4,8,12,2022,01-21,14:44
002 Com�die,13,11,24,2022,01-21,14:44
003 Esplanade,8,24,32,2022,01-21,14:44
004 H�tel de Ville,8,8,16,2022,01-21,14:44
005 Corum,7,5,12,2022,01-21,14:44
006 Place Albert 1er - St Charles,29,2,31,2022,01-21,14:44
007 Foch,3,5,8,2022,01-21,14:44
008 Halles Castellane,8,4,12,2022,01-21,14:44
009 Observatoire,1,7,8,2022,01-21,14:44
010 Rondelet,1,15,16,2022,01-21,14:44
011 Plan Cabanes,2,10,12,2022,01-21,14:44
012 Boutonnet,3,9,12,2022,01-21,14:44
013 Emile Combes,8,0,8,2022,01-21,14:44
014 Beaux-Arts,3,5,8,2022,01-21,14:44
015 Les Aubes,2,6,8,2022,01-21,14:44
016 Antigone centre,3,13,16,2022,01-21,14:44
017 M�diath�que Emile Zola,6,10,16,2022,01-21,14:44
018 Nombre d'Or,11,5,16,2022,01-21,14:44
019 Louis Blanc,10,6,16,2022,01-21,14:44
020 Gambetta,3,5,8,2022,01-21,14:44
021 Port Marianne,15,1,16,2022,01-21,14:44
022 Clemenceau,7,5,12,2022,01-21,14:44
023 Les Arceaux,3,13,16,2022,01-21,14:44
024 Cit� Mion,3,5,8,2022,01-21,14:44
025 Nouveau Saint-Roch,5,3,8,2022,01-21,14:44
026 Renouvier,2,6,8,2022,01-21,14:44
027 Odysseum,5,3,8,2022,01-21,14:44
028 Saint-Denis,6,2,8,2022,01-21,14:44
029 Richter,11,5,16,2022,01-21,14:44
030 Charles Flahault,0,8,8,2022,01-21,14:44
031 Voltaire,2,6,8,2022,01-21,14:44
032 Pr�s d'Ar�nes,3,5,8,2022,01-21,14:44
033 Garcia Lorca,2,6,8,2022,01-21,14:44
034 Vert Bois,0,16,16,2022,01-21,14:44
035 Malbosc,2,6,8,2022,01-21,14:44
036 Occitanie,4,28,32,2022,01-21,14:44
037 FacdesSciences,5,19,24,2022,01-21,14:44
038 Fac de Lettres,2,14,16,2022,01-21,14:44
039 Aiguelongue,2,6,8,2022,01-21,14:44
040 Jeu de Mail des Abb�s,5,3,8,2022,01-21,14:44
041 Eurom�decine,2,6,8,2022,01-21,14:44
042 Marie Caizergues,4,4,8,2022,01-21,14:44
043 Sabines,6,2,8,2022,01-21,14:44
044 Celleneuve,0,8,8,2022,01-21,14:44
045 Jardin de la Lironde,6,2,8,2022,01-21,14:44
046 P�re Soulas,5,3,8,2022,01-21,14:44
047 Place Viala,4,4,8,2022,01-21,14:44
048 H�tel du D�partement,6,2,8,2022,01-21,14:44
049 Tonnelles,3,5,8,2022,01-21,14:44
050 Parvis Jules Ferry - Gare Saint-Roch,7,1,8,2022,01-21,14:44
051 Pont de Lattes - Gare Saint-Roch,1,11,12,2022,01-21,14:44
053 Deux Ponts - Gare Saint-Roch,1,7,8,2022,01-21,14:44
054 Providence - Ovalie,3,5,8,2022,01-21,14:44
055 P�rols Etang de l'Or,21,47,68,2022,01-21,14:44
056 Albert 1er - Cath�drale,4,8,12,2022,01-21,14:44
057 Saint-Guilhem - Courreau,2,6,8,2022,01-21,14:44
059 Sud De France,0,8,8,2022,01-21,14:44
001 Rue Jules Ferry - Gare Saint-Roch,4,8,12,2022,01-21,14:54
002 Com�die,13,11,24,2022,01-21,14:54
003 Esplanade,8,24,32,2022,01-21,14:54
004 H�tel de Ville,8,8,16,2022,01-21,14:54
005 Corum,7,5,12,2022,01-21,14:54
006 Place Albert 1er - St Charles,28,3,31,2022,01-21,14:54
007 Foch,3,5,8,2022,01-21,14:54
008 Halles Castellane,5,7,12,2022,01-21,14:54
009 Observatoire,1,7,8,2022,01-21,14:54
010 Rondelet,1,15,16,2022,01-21,14:54
011 Plan Cabanes,2,10,12,2022,01-21,14:54
012 Boutonnet,3,9,12,2022,01-21,14:54
013 Emile Combes,8,0,8,2022,01-21,14:54
014 Beaux-Arts,3,5,8,2022,01-21,14:54
015 Les Aubes,2,6,8,2022,01-21,14:54
016 Antigone centre,3,13,16,2022,01-21,14:54
017 M�diath�que Emile Zola,7,9,16,2022,01-21,14:54
018 Nombre d'Or,11,5,16,2022,01-21,14:54
019 Louis Blanc,10,6,16,2022,01-21,14:54
020 Gambetta,3,5,8,2022,01-21,14:54
021 Port Marianne,15,1,16,2022,01-21,14:54
022 Clemenceau,7,5,12,2022,01-21,14:54
023 Les Arceaux,3,13,16,2022,01-21,14:54
024 Cit� Mion,3,5,8,2022,01-21,14:54
025 Nouveau Saint-Roch,6,2,8,2022,01-21,14:54
026 Renouvier,2,6,8,2022,01-21,14:54
027 Odysseum,5,3,8,2022,01-21,14:54
028 Saint-Denis,6,2,8,2022,01-21,14:54
029 Richter,11,5,16,2022,01-21,14:54
030 Charles Flahault,0,8,8,2022,01-21,14:54
031 Voltaire,2,6,8,2022,01-21,14:54
032 Pr�s d'Ar�nes,3,5,8,2022,01-21,14:54
033 Garcia Lorca,2,6,8,2022,01-21,14:54
034 Vert Bois,0,16,16,2022,01-21,14:54
035 Malbosc,2,6,8,2022,01-21,14:54
036 Occitanie,4,28,32,2022,01-21,14:54
037 FacdesSciences,6,18,24,2022,01-21,14:54
038 Fac de Lettres,2,14,16,2022,01-21,14:54
039 Aiguelongue,2,6,8,2022,01-21,14:54
040 Jeu de Mail des Abb�s,5,3,8,2022,01-21,14:54
041 Eurom�decine,2,6,8,2022,01-21,14:54
042 Marie Caizergues,4,4,8,2022,01-21,14:54
043 Sabines,6,2,8,2022,01-21,14:54
044 Celleneuve,0,8,8,2022,01-21,14:54
045 Jardin de la Lironde,6,2,8,2022,01-21,14:54
046 P�re Soulas,5,3,8,2022,01-21,14:54
047 Place Viala,4,4,8,2022,01-21,14:54
048 H�tel du D�partement,6,2,8,2022,01-21,14:54
049 Tonnelles,3,5,8,2022,01-21,14:54
050 Parvis Jules Ferry - Gare Saint-Roch,7,1,8,2022,01-21,14:54
051 Pont de Lattes - Gare Saint-Roch,1,11,12,2022,01-21,14:54
053 Deux Ponts - Gare Saint-Roch,1,7,8,2022,01-21,14:54
054 Providence - Ovalie,3,5,8,2022,01-21,14:54
055 P�rols Etang de l'Or,21,47,68,2022,01-21,14:54
056 Albert 1er - Cath�drale,4,8,12,2022,01-21,14:54
057 Saint-Guilhem - Courreau,2,6,8,2022,01-21,14:54
059 Sud De France,0,8,8,2022,01-21,14:54
001 Rue Jules Ferry - Gare Saint-Roch,4,8,12,2022,01-21,15:04
002 Com�die,13,11,24,2022,01-21,15:04
003 Esplanade,8,24,32,2022,01-21,15:04
004 H�tel de Ville,8,8,16,2022,01-21,15:04
005 Corum,7,5,12,2022,01-21,15:04
006 Place Albert 1er - St Charles,28,3,31,2022,01-21,15:04
007 Foch,3,5,8,2022,01-21,15:04
008 Halles Castellane,5,7,12,2022,01-21,15:04
009 Observatoire,1,7,8,2022,01-21,15:04
010 Rondelet,1,15,16,2022,01-21,15:04
011 Plan Cabanes,2,10,12,2022,01-21,15:04
012 Boutonnet,3,9,12,2022,01-21,15:04
013 Emile Combes,8,0,8,2022,01-21,15:04
014 Beaux-Arts,3,5,8,2022,01-21,15:04
015 Les Aubes,4,4,8,2022,01-21,15:04
016 Antigone centre,3,13,16,2022,01-21,15:04
017 M�diath�que Emile Zola,6,10,16,2022,01-21,15:04
018 Nombre d'Or,11,5,16,2022,01-21,15:04
019 Louis Blanc,10,6,16,2022,01-21,15:04
020 Gambetta,3,5,8,2022,01-21,15:04
021 Port Marianne,16,0,16,2022,01-21,15:04
022 Clemenceau,7,5,12,2022,01-21,15:04
023 Les Arceaux,3,13,16,2022,01-21,15:04
024 Cit� Mion,3,5,8,2022,01-21,15:04
025 Nouveau Saint-Roch,6,2,8,2022,01-21,15:04
026 Renouvier,2,6,8,2022,01-21,15:04
027 Odysseum,5,3,8,2022,01-21,15:04
028 Saint-Denis,6,2,8,2022,01-21,15:04
029 Richter,11,5,16,2022,01-21,15:04
030 Charles Flahault,0,8,8,2022,01-21,15:04
031 Voltaire,3,5,8,2022,01-21,15:04
032 Pr�s d'Ar�nes,3,5,8,2022,01-21,15:04
033 Garcia Lorca,2,6,8,2022,01-21,15:04
034 Vert Bois,0,16,16,2022,01-21,15:04
035 Malbosc,0,8,8,2022,01-21,15:04
036 Occitanie,4,28,32,2022,01-21,15:04
037 FacdesSciences,6,18,24,2022,01-21,15:04
038 Fac de Lettres,1,15,16,2022,01-21,15:04
039 Aiguelongue,2,6,8,2022,01-21,15:04
040 Jeu de Mail des Abb�s,5,3,8,2022,01-21,15:04
041 Eurom�decine,2,6,8,2022,01-21,15:04
042 Marie Caizergues,4,4,8,2022,01-21,15:04
043 Sabines,6,2,8,2022,01-21,15:04
044 Celleneuve,0,8,8,2022,01-21,15:04
045 Jardin de la Lironde,6,2,8,2022,01-21,15:04
046 P�re Soulas,5,3,8,2022,01-21,15:04
047 Place Viala,3,5,8,2022,01-21,15:04
048 H�tel du D�partement,6,2,8,2022,01-21,15:04
049 Tonnelles,3,5,8,2022,01-21,15:04
050 Parvis Jules Ferry - Gare Saint-Roch,8,0,8,2022,01-21,15:04
051 Pont de Lattes - Gare Saint-Roch,1,11,12,2022,01-21,15:04
053 Deux Ponts - Gare Saint-Roch,1,7,8,2022,01-21,15:04
054 Providence - Ovalie,3,5,8,2022,01-21,15:04
055 P�rols Etang de l'Or,21,47,68,2022,01-21,15:04
056 Albert 1er - Cath�drale,4,8,12,2022,01-21,15:04
057 Saint-Guilhem - Courreau,2,6,8,2022,01-21,15:04
059 Sud De France,0,8,8,2022,01-21,15:04
001 Rue Jules Ferry - Gare Saint-Roch,4,8,12,2022,01-21,15:14
002 Com�die,12,12,24,2022,01-21,15:14
003 Esplanade,9,23,32,2022,01-21,15:14
004 H�tel de Ville,8,8,16,2022,01-21,15:14
005 Corum,7,5,12,2022,01-21,15:14
006 Place Albert 1er - St Charles,28,3,31,2022,01-21,15:14
007 Foch,3,5,8,2022,01-21,15:14
008 Halles Castellane,5,7,12,2022,01-21,15:14
009 Observatoire,2,6,8,2022,01-21,15:14
010 Rondelet,1,15,16,2022,01-21,15:14
011 Plan Cabanes,2,10,12,2022,01-21,15:14
012 Boutonnet,3,9,12,2022,01-21,15:14
013 Emile Combes,8,0,8,2022,01-21,15:14
014 Beaux-Arts,3,5,8,2022,01-21,15:14
015 Les Aubes,4,4,8,2022,01-21,15:14
016 Antigone centre,3,13,16,2022,01-21,15:14
017 M�diath�que Emile Zola,6,10,16,2022,01-21,15:14
018 Nombre d'Or,11,5,16,2022,01-21,15:14
019 Louis Blanc,10,6,16,2022,01-21,15:14
020 Gambetta,3,5,8,2022,01-21,15:14
021 Port Marianne,16,0,16,2022,01-21,15:14
022 Clemenceau,7,5,12,2022,01-21,15:14
023 Les Arceaux,3,13,16,2022,01-21,15:14
024 Cit� Mion,3,5,8,2022,01-21,15:14
025 Nouveau Saint-Roch,6,2,8,2022,01-21,15:14
026 Renouvier,2,6,8,2022,01-21,15:14
027 Odysseum,5,3,8,2022,01-21,15:14
028 Saint-Denis,6,2,8,2022,01-21,15:14
029 Richter,11,5,16,2022,01-21,15:14
030 Charles Flahault,0,8,8,2022,01-21,15:14
031 Voltaire,3,5,8,2022,01-21,15:14
032 Pr�s d'Ar�nes,3,5,8,2022,01-21,15:14
033 Garcia Lorca,2,6,8,2022,01-21,15:14
034 Vert Bois,0,16,16,2022,01-21,15:14
035 Malbosc,0,8,8,2022,01-21,15:14
036 Occitanie,3,29,32,2022,01-21,15:14
037 FacdesSciences,6,18,24,2022,01-21,15:14
038 Fac de Lettres,1,15,16,2022,01-21,15:14
039 Aiguelongue,2,6,8,2022,01-21,15:14
040 Jeu de Mail des Abb�s,5,3,8,2022,01-21,15:14
041 Eurom�decine,2,6,8,2022,01-21,15:14
042 Marie Caizergues,4,4,8,2022,01-21,15:14
043 Sabines,6,2,8,2022,01-21,15:14
044 Celleneuve,0,8,8,2022,01-21,15:14
045 Jardin de la Lironde,6,2,8,2022,01-21,15:14
046 P�re Soulas,5,3,8,2022,01-21,15:14
047 Place Viala,3,5,8,2022,01-21,15:14
048 H�tel du D�partement,6,2,8,2022,01-21,15:14
049 Tonnelles,3,5,8,2022,01-21,15:14
050 Parvis Jules Ferry - Gare Saint-Roch,8,0,8,2022,01-21,15:14
051 Pont de Lattes - Gare Saint-Roch,1,11,12,2022,01-21,15:14
053 Deux Ponts - Gare Saint-Roch,1,7,8,2022,01-21,15:14
054 Providence - Ovalie,3,5,8,2022,01-21,15:14
055 P�rols Etang de l'Or,21,47,68,2022,01-21,15:14
056 Albert 1er - Cath�drale,4,8,12,2022,01-21,15:14
057 Saint-Guilhem - Courreau,2,6,8,2022,01-21,15:14
059 Sud De France,0,8,8,2022,01-21,15:14
001 Rue Jules Ferry - Gare Saint-Roch,4,8,12,2022,01-21,15:25
002 Com�die,12,12,24,2022,01-21,15:25
003 Esplanade,9,23,32,2022,01-21,15:25
004 H�tel de Ville,8,8,16,2022,01-21,15:25
005 Corum,6,6,12,2022,01-21,15:25
006 Place Albert 1er - St Charles,29,2,31,2022,01-21,15:25
007 Foch,3,5,8,2022,01-21,15:25
008 Halles Castellane,5,7,12,2022,01-21,15:25
009 Observatoire,2,6,8,2022,01-21,15:25
010 Rondelet,1,15,16,2022,01-21,15:25
011 Plan Cabanes,2,10,12,2022,01-21,15:25
012 Boutonnet,5,7,12,2022,01-21,15:25
013 Emile Combes,8,0,8,2022,01-21,15:25
014 Beaux-Arts,3,5,8,2022,01-21,15:25
015 Les Aubes,4,4,8,2022,01-21,15:25
016 Antigone centre,3,13,16,2022,01-21,15:25
017 M�diath�que Emile Zola,6,10,16,2022,01-21,15:25
018 Nombre d'Or,11,5,16,2022,01-21,15:25
019 Louis Blanc,10,6,16,2022,01-21,15:25
020 Gambetta,3,5,8,2022,01-21,15:25
021 Port Marianne,16,0,16,2022,01-21,15:25
022 Clemenceau,7,5,12,2022,01-21,15:25
023 Les Arceaux,4,12,16,2022,01-21,15:25
024 Cit� Mion,3,5,8,2022,01-21,15:25
025 Nouveau Saint-Roch,6,2,8,2022,01-21,15:25
026 Renouvier,2,6,8,2022,01-21,15:25
027 Odysseum,5,3,8,2022,01-21,15:25
028 Saint-Denis,7,1,8,2022,01-21,15:25
029 Richter,11,5,16,2022,01-21,15:25
030 Charles Flahault,0,8,8,2022,01-21,15:25
031 Voltaire,3,5,8,2022,01-21,15:25
032 Pr�s d'Ar�nes,3,5,8,2022,01-21,15:25
033 Garcia Lorca,2,6,8,2022,01-21,15:25
034 Vert Bois,0,16,16,2022,01-21,15:25
035 Malbosc,0,8,8,2022,01-21,15:25
036 Occitanie,4,28,32,2022,01-21,15:25
037 FacdesSciences,7,17,24,2022,01-21,15:25
038 Fac de Lettres,0,16,16,2022,01-21,15:25
039 Aiguelongue,2,6,8,2022,01-21,15:25
040 Jeu de Mail des Abb�s,5,3,8,2022,01-21,15:25
041 Eurom�decine,2,6,8,2022,01-21,15:25
042 Marie Caizergues,4,4,8,2022,01-21,15:25
043 Sabines,6,2,8,2022,01-21,15:25
044 Celleneuve,0,8,8,2022,01-21,15:25
045 Jardin de la Lironde,6,2,8,2022,01-21,15:25
046 P�re Soulas,5,3,8,2022,01-21,15:25
047 Place Viala,3,5,8,2022,01-21,15:25
048 H�tel du D�partement,6,2,8,2022,01-21,15:25
049 Tonnelles,3,5,8,2022,01-21,15:25
050 Parvis Jules Ferry - Gare Saint-Roch,8,0,8,2022,01-21,15:25
051 Pont de Lattes - Gare Saint-Roch,1,11,12,2022,01-21,15:25
053 Deux Ponts - Gare Saint-Roch,1,7,8,2022,01-21,15:25
054 Providence - Ovalie,3,5,8,2022,01-21,15:25
055 P�rols Etang de l'Or,21,47,68,2022,01-21,15:25
056 Albert 1er - Cath�drale,4,8,12,2022,01-21,15:25
057 Saint-Guilhem - Courreau,2,6,8,2022,01-21,15:25
059 Sud De France,0,8,8,2022,01-21,15:25
001 Rue Jules Ferry - Gare Saint-Roch,4,8,12,2022,01-21,15:35
002 Com�die,12,12,24,2022,01-21,15:35
003 Esplanade,9,23,32,2022,01-21,15:35
004 H�tel de Ville,8,8,16,2022,01-21,15:35
005 Corum,6,6,12,2022,01-21,15:35
006 Place Albert 1er - St Charles,29,2,31,2022,01-21,15:35
007 Foch,3,5,8,2022,01-21,15:35
008 Halles Castellane,5,7,12,2022,01-21,15:35
009 Observatoire,2,6,8,2022,01-21,15:35
010 Rondelet,1,15,16,2022,01-21,15:35
011 Plan Cabanes,2,10,12,2022,01-21,15:35
012 Boutonnet,6,6,12,2022,01-21,15:35
013 Emile Combes,8,0,8,2022,01-21,15:35
014 Beaux-Arts,3,5,8,2022,01-21,15:35
015 Les Aubes,4,4,8,2022,01-21,15:35
016 Antigone centre,3,13,16,2022,01-21,15:35
017 M�diath�que Emile Zola,6,10,16,2022,01-21,15:35
018 Nombre d'Or,11,5,16,2022,01-21,15:35
019 Louis Blanc,10,6,16,2022,01-21,15:35
020 Gambetta,3,5,8,2022,01-21,15:35
021 Port Marianne,16,0,16,2022,01-21,15:35
022 Clemenceau,7,5,12,2022,01-21,15:35
023 Les Arceaux,4,12,16,2022,01-21,15:35
024 Cit� Mion,3,5,8,2022,01-21,15:35
025 Nouveau Saint-Roch,6,2,8,2022,01-21,15:35
026 Renouvier,2,6,8,2022,01-21,15:35
027 Odysseum,5,3,8,2022,01-21,15:35
028 Saint-Denis,7,1,8,2022,01-21,15:35
029 Richter,11,5,16,2022,01-21,15:35
030 Charles Flahault,0,8,8,2022,01-21,15:35
031 Voltaire,2,6,8,2022,01-21,15:35
032 Pr�s d'Ar�nes,2,6,8,2022,01-21,15:35
033 Garcia Lorca,2,6,8,2022,01-21,15:35
034 Vert Bois,0,16,16,2022,01-21,15:35
035 Malbosc,0,8,8,2022,01-21,15:35
036 Occitanie,5,27,32,2022,01-21,15:35
037 FacdesSciences,5,19,24,2022,01-21,15:35
038 Fac de Lettres,0,16,16,2022,01-21,15:35
039 Aiguelongue,2,6,8,2022,01-21,15:35
040 Jeu de Mail des Abb�s,5,3,8,2022,01-21,15:35
041 Eurom�decine,2,6,8,2022,01-21,15:35
042 Marie Caizergues,5,3,8,2022,01-21,15:35
043 Sabines,6,2,8,2022,01-21,15:35
044 Celleneuve,0,8,8,2022,01-21,15:35
045 Jardin de la Lironde,6,2,8,2022,01-21,15:35
046 P�re Soulas,5,3,8,2022,01-21,15:35
047 Place Viala,3,5,8,2022,01-21,15:35
048 H�tel du D�partement,6,2,8,2022,01-21,15:35
049 Tonnelles,3,5,8,2022,01-21,15:35
050 Parvis Jules Ferry - Gare Saint-Roch,8,0,8,2022,01-21,15:35
051 Pont de Lattes - Gare Saint-Roch,1,11,12,2022,01-21,15:35
053 Deux Ponts - Gare Saint-Roch,1,7,8,2022,01-21,15:35
054 Providence - Ovalie,3,5,8,2022,01-21,15:35
055 P�rols Etang de l'Or,22,46,68,2022,01-21,15:35
056 Albert 1er - Cath�drale,4,8,12,2022,01-21,15:35
057 Saint-Guilhem - Courreau,2,6,8,2022,01-21,15:35
059 Sud De France,0,8,8,2022,01-21,15:35
001 Rue Jules Ferry - Gare Saint-Roch,4,8,12,2022,01-21,15:45
002 Com�die,12,12,24,2022,01-21,15:45
003 Esplanade,9,23,32,2022,01-21,15:45
004 H�tel de Ville,8,8,16,2022,01-21,15:45
005 Corum,6,6,12,2022,01-21,15:45
006 Place Albert 1er - St Charles,29,2,31,2022,01-21,15:45
007 Foch,3,5,8,2022,01-21,15:45
008 Halles Castellane,5,7,12,2022,01-21,15:45
009 Observatoire,3,5,8,2022,01-21,15:45
010 Rondelet,1,15,16,2022,01-21,15:45
011 Plan Cabanes,2,10,12,2022,01-21,15:45
012 Boutonnet,4,8,12,2022,01-21,15:45
013 Emile Combes,8,0,8,2022,01-21,15:45
014 Beaux-Arts,3,5,8,2022,01-21,15:45
015 Les Aubes,4,4,8,2022,01-21,15:45
016 Antigone centre,3,13,16,2022,01-21,15:45
017 M�diath�que Emile Zola,6,10,16,2022,01-21,15:45
018 Nombre d'Or,11,5,16,2022,01-21,15:45
019 Louis Blanc,11,5,16,2022,01-21,15:45
020 Gambetta,3,5,8,2022,01-21,15:45
021 Port Marianne,16,0,16,2022,01-21,15:45
022 Clemenceau,7,5,12,2022,01-21,15:45
023 Les Arceaux,4,12,16,2022,01-21,15:45
024 Cit� Mion,3,5,8,2022,01-21,15:45
025 Nouveau Saint-Roch,6,2,8,2022,01-21,15:45
026 Renouvier,2,6,8,2022,01-21,15:45
027 Odysseum,3,5,8,2022,01-21,15:45
028 Saint-Denis,7,1,8,2022,01-21,15:45
029 Richter,11,5,16,2022,01-21,15:45
030 Charles Flahault,0,8,8,2022,01-21,15:45
031 Voltaire,2,6,8,2022,01-21,15:45
032 Pr�s d'Ar�nes,2,6,8,2022,01-21,15:45
033 Garcia Lorca,2,6,8,2022,01-21,15:45
034 Vert Bois,0,16,16,2022,01-21,15:45
035 Malbosc,0,8,8,2022,01-21,15:45
036 Occitanie,5,27,32,2022,01-21,15:45
037 FacdesSciences,5,19,24,2022,01-21,15:45
038 Fac de Lettres,0,16,16,2022,01-21,15:45
039 Aiguelongue,2,6,8,2022,01-21,15:45
040 Jeu de Mail des Abb�s,5,3,8,2022,01-21,15:45
041 Eurom�decine,2,6,8,2022,01-21,15:45
042 Marie Caizergues,5,3,8,2022,01-21,15:45
043 Sabines,6,2,8,2022,01-21,15:45
044 Celleneuve,0,8,8,2022,01-21,15:45
045 Jardin de la Lironde,6,2,8,2022,01-21,15:45
046 P�re Soulas,4,4,8,2022,01-21,15:45
047 Place Viala,3,5,8,2022,01-21,15:45
048 H�tel du D�partement,6,2,8,2022,01-21,15:45
049 Tonnelles,3,5,8,2022,01-21,15:45
050 Parvis Jules Ferry - Gare Saint-Roch,8,0,8,2022,01-21,15:45
051 Pont de Lattes - Gare Saint-Roch,1,11,12,2022,01-21,15:45
053 Deux Ponts - Gare Saint-Roch,1,7,8,2022,01-21,15:45
054 Providence - Ovalie,3,5,8,2022,01-21,15:45
055 P�rols Etang de l'Or,23,45,68,2022,01-21,15:45
056 Albert 1er - Cath�drale,4,8,12,2022,01-21,15:45
057 Saint-Guilhem - Courreau,2,6,8,2022,01-21,15:45
059 Sud De France,0,8,8,2022,01-21,15:45
001 Rue Jules Ferry - Gare Saint-Roch,4,8,12,2022,01-21,15:55
002 Com�die,12,12,24,2022,01-21,15:55
003 Esplanade,8,24,32,2022,01-21,15:55
004 H�tel de Ville,8,8,16,2022,01-21,15:55
005 Corum,6,6,12,2022,01-21,15:55
006 Place Albert 1er - St Charles,29,2,31,2022,01-21,15:55
007 Foch,3,5,8,2022,01-21,15:55
008 Halles Castellane,5,7,12,2022,01-21,15:55
009 Observatoire,3,5,8,2022,01-21,15:55
010 Rondelet,1,15,16,2022,01-21,15:55
011 Plan Cabanes,2,10,12,2022,01-21,15:55
012 Boutonnet,3,9,12,2022,01-21,15:55
013 Emile Combes,8,0,8,2022,01-21,15:55
014 Beaux-Arts,3,5,8,2022,01-21,15:55
015 Les Aubes,4,4,8,2022,01-21,15:55
016 Antigone centre,3,13,16,2022,01-21,15:55
017 M�diath�que Emile Zola,7,9,16,2022,01-21,15:55
018 Nombre d'Or,10,6,16,2022,01-21,15:55
019 Louis Blanc,12,4,16,2022,01-21,15:55
020 Gambetta,3,5,8,2022,01-21,15:55
021 Port Marianne,16,0,16,2022,01-21,15:55
022 Clemenceau,7,5,12,2022,01-21,15:55
023 Les Arceaux,4,12,16,2022,01-21,15:55
024 Cit� Mion,3,5,8,2022,01-21,15:55
025 Nouveau Saint-Roch,6,2,8,2022,01-21,15:55
026 Renouvier,2,6,8,2022,01-21,15:55
027 Odysseum,3,5,8,2022,01-21,15:55
028 Saint-Denis,7,1,8,2022,01-21,15:55
029 Richter,11,5,16,2022,01-21,15:55
030 Charles Flahault,0,8,8,2022,01-21,15:55
031 Voltaire,2,6,8,2022,01-21,15:55
032 Pr�s d'Ar�nes,2,6,8,2022,01-21,15:55
033 Garcia Lorca,2,6,8,2022,01-21,15:55
034 Vert Bois,0,16,16,2022,01-21,15:55
035 Malbosc,0,8,8,2022,01-21,15:55
036 Occitanie,6,26,32,2022,01-21,15:55
037 FacdesSciences,5,19,24,2022,01-21,15:55
038 Fac de Lettres,1,15,16,2022,01-21,15:55
039 Aiguelongue,2,6,8,2022,01-21,15:55
040 Jeu de Mail des Abb�s,5,3,8,2022,01-21,15:55
041 Eurom�decine,2,6,8,2022,01-21,15:55
042 Marie Caizergues,5,3,8,2022,01-21,15:55
043 Sabines,6,2,8,2022,01-21,15:55
044 Celleneuve,0,8,8,2022,01-21,15:55
045 Jardin de la Lironde,6,2,8,2022,01-21,15:55
046 P�re Soulas,4,4,8,2022,01-21,15:55
047 Place Viala,3,5,8,2022,01-21,15:55
048 H�tel du D�partement,6,2,8,2022,01-21,15:55
049 Tonnelles,3,5,8,2022,01-21,15:55
050 Parvis Jules Ferry - Gare Saint-Roch,8,0,8,2022,01-21,15:55
051 Pont de Lattes - Gare Saint-Roch,1,11,12,2022,01-21,15:55
053 Deux Ponts - Gare Saint-Roch,1,7,8,2022,01-21,15:55
054 Providence - Ovalie,3,5,8,2022,01-21,15:55
055 P�rols Etang de l'Or,23,45,68,2022,01-21,15:55
056 Albert 1er - Cath�drale,4,8,12,2022,01-21,15:55
057 Saint-Guilhem - Courreau,2,6,8,2022,01-21,15:55
059 Sud De France,0,8,8,2022,01-21,15:55
001 Rue Jules Ferry - Gare Saint-Roch,4,8,12,2022,01-21,16:05
002 Com�die,11,13,24,2022,01-21,16:05
003 Esplanade,8,24,32,2022,01-21,16:05
004 H�tel de Ville,8,8,16,2022,01-21,16:05
005 Corum,6,6,12,2022,01-21,16:05
006 Place Albert 1er - St Charles,29,2,31,2022,01-21,16:05
007 Foch,2,6,8,2022,01-21,16:05
008 Halles Castellane,3,9,12,2022,01-21,16:05
009 Observatoire,3,5,8,2022,01-21,16:05
010 Rondelet,0,16,16,2022,01-21,16:05
011 Plan Cabanes,1,11,12,2022,01-21,16:05
012 Boutonnet,1,11,12,2022,01-21,16:05
013 Emile Combes,8,0,8,2022,01-21,16:05
014 Beaux-Arts,3,5,8,2022,01-21,16:05
015 Les Aubes,5,3,8,2022,01-21,16:05
016 Antigone centre,3,13,16,2022,01-21,16:05
017 M�diath�que Emile Zola,7,9,16,2022,01-21,16:05
018 Nombre d'Or,10,6,16,2022,01-21,16:05
019 Louis Blanc,12,4,16,2022,01-21,16:05
020 Gambetta,3,5,8,2022,01-21,16:05
021 Port Marianne,16,0,16,2022,01-21,16:05
022 Clemenceau,7,5,12,2022,01-21,16:05
023 Les Arceaux,4,12,16,2022,01-21,16:05
024 Cit� Mion,3,5,8,2022,01-21,16:05
025 Nouveau Saint-Roch,6,2,8,2022,01-21,16:05
026 Renouvier,2,6,8,2022,01-21,16:05
027 Odysseum,3,5,8,2022,01-21,16:05
028 Saint-Denis,7,1,8,2022,01-21,16:05
029 Richter,11,5,16,2022,01-21,16:05
030 Charles Flahault,0,8,8,2022,01-21,16:05
031 Voltaire,2,6,8,2022,01-21,16:05
032 Pr�s d'Ar�nes,2,6,8,2022,01-21,16:05
033 Garcia Lorca,2,6,8,2022,01-21,16:05
034 Vert Bois,0,16,16,2022,01-21,16:05
035 Malbosc,0,8,8,2022,01-21,16:05
036 Occitanie,6,26,32,2022,01-21,16:05
037 FacdesSciences,6,18,24,2022,01-21,16:05
038 Fac de Lettres,1,15,16,2022,01-21,16:05
039 Aiguelongue,2,6,8,2022,01-21,16:05
040 Jeu de Mail des Abb�s,5,3,8,2022,01-21,16:05
041 Eurom�decine,2,6,8,2022,01-21,16:05
042 Marie Caizergues,4,4,8,2022,01-21,16:05
043 Sabines,6,2,8,2022,01-21,16:05
044 Celleneuve,0,8,8,2022,01-21,16:05
045 Jardin de la Lironde,6,2,8,2022,01-21,16:05
046 P�re Soulas,4,4,8,2022,01-21,16:05
047 Place Viala,3,5,8,2022,01-21,16:05
048 H�tel du D�partement,6,2,8,2022,01-21,16:05
049 Tonnelles,3,5,8,2022,01-21,16:05
050 Parvis Jules Ferry - Gare Saint-Roch,8,0,8,2022,01-21,16:05
051 Pont de Lattes - Gare Saint-Roch,1,11,12,2022,01-21,16:05
053 Deux Ponts - Gare Saint-Roch,1,7,8,2022,01-21,16:05
054 Providence - Ovalie,3,5,8,2022,01-21,16:05
055 P�rols Etang de l'Or,23,45,68,2022,01-21,16:05
056 Albert 1er - Cath�drale,4,8,12,2022,01-21,16:05
057 Saint-Guilhem - Courreau,2,6,8,2022,01-21,16:05
059 Sud De France,0,8,8,2022,01-21,16:05
001 Rue Jules Ferry - Gare Saint-Roch,3,9,12,2022,01-21,16:16
002 Com�die,12,12,24,2022,01-21,16:16
003 Esplanade,8,24,32,2022,01-21,16:16
004 H�tel de Ville,8,8,16,2022,01-21,16:16
005 Corum,6,6,12,2022,01-21,16:16
006 Place Albert 1er - St Charles,29,2,31,2022,01-21,16:16
007 Foch,2,6,8,2022,01-21,16:16
008 Halles Castellane,3,9,12,2022,01-21,16:16
009 Observatoire,3,5,8,2022,01-21,16:16
010 Rondelet,0,16,16,2022,01-21,16:16
011 Plan Cabanes,1,11,12,2022,01-21,16:16
012 Boutonnet,2,10,12,2022,01-21,16:16
013 Emile Combes,8,0,8,2022,01-21,16:16
014 Beaux-Arts,3,5,8,2022,01-21,16:16
015 Les Aubes,5,3,8,2022,01-21,16:16
016 Antigone centre,3,13,16,2022,01-21,16:16
017 M�diath�que Emile Zola,7,9,16,2022,01-21,16:16
018 Nombre d'Or,10,6,16,2022,01-21,16:16
019 Louis Blanc,12,4,16,2022,01-21,16:16
020 Gambetta,3,5,8,2022,01-21,16:16
021 Port Marianne,16,0,16,2022,01-21,16:16
022 Clemenceau,7,5,12,2022,01-21,16:16
023 Les Arceaux,4,12,16,2022,01-21,16:16
024 Cit� Mion,3,5,8,2022,01-21,16:16
025 Nouveau Saint-Roch,7,1,8,2022,01-21,16:16
026 Renouvier,2,6,8,2022,01-21,16:16
027 Odysseum,3,5,8,2022,01-21,16:16
028 Saint-Denis,7,1,8,2022,01-21,16:16
029 Richter,11,5,16,2022,01-21,16:16
030 Charles Flahault,1,7,8,2022,01-21,16:16
031 Voltaire,4,4,8,2022,01-21,16:16
032 Pr�s d'Ar�nes,2,6,8,2022,01-21,16:16
033 Garcia Lorca,2,6,8,2022,01-21,16:16
034 Vert Bois,0,16,16,2022,01-21,16:16
035 Malbosc,0,8,8,2022,01-21,16:16
036 Occitanie,5,27,32,2022,01-21,16:16
037 FacdesSciences,6,18,24,2022,01-21,16:16
038 Fac de Lettres,2,14,16,2022,01-21,16:16
039 Aiguelongue,2,6,8,2022,01-21,16:16
040 Jeu de Mail des Abb�s,5,3,8,2022,01-21,16:16
041 Eurom�decine,2,6,8,2022,01-21,16:16
042 Marie Caizergues,2,6,8,2022,01-21,16:16
043 Sabines,6,2,8,2022,01-21,16:16
044 Celleneuve,0,8,8,2022,01-21,16:16
045 Jardin de la Lironde,6,2,8,2022,01-21,16:16
046 P�re Soulas,7,1,8,2022,01-21,16:16
047 Place Viala,2,6,8,2022,01-21,16:16
048 H�tel du D�partement,6,2,8,2022,01-21,16:16
049 Tonnelles,3,5,8,2022,01-21,16:16
050 Parvis Jules Ferry - Gare Saint-Roch,8,0,8,2022,01-21,16:16
051 Pont de Lattes - Gare Saint-Roch,1,11,12,2022,01-21,16:16
053 Deux Ponts - Gare Saint-Roch,1,7,8,2022,01-21,16:16
054 Providence - Ovalie,3,5,8,2022,01-21,16:16
055 P�rols Etang de l'Or,23,45,68,2022,01-21,16:16
056 Albert 1er - Cath�drale,4,8,12,2022,01-21,16:16
057 Saint-Guilhem - Courreau,2,6,8,2022,01-21,16:16
059 Sud De France,0,8,8,2022,01-21,16:16
001 Rue Jules Ferry - Gare Saint-Roch,4,8,12,2022,01-21,16:26
002 Com�die,12,12,24,2022,01-21,16:26
003 Esplanade,8,24,32,2022,01-21,16:26
004 H�tel de Ville,8,8,16,2022,01-21,16:26
005 Corum,8,4,12,2022,01-21,16:26
006 Place Albert 1er - St Charles,29,2,31,2022,01-21,16:26
007 Foch,2,6,8,2022,01-21,16:26
008 Halles Castellane,3,9,12,2022,01-21,16:26
009 Observatoire,3,5,8,2022,01-21,16:26
010 Rondelet,0,16,16,2022,01-21,16:26
011 Plan Cabanes,1,11,12,2022,01-21,16:26
012 Boutonnet,2,10,12,2022,01-21,16:26
013 Emile Combes,8,0,8,2022,01-21,16:26
014 Beaux-Arts,3,5,8,2022,01-21,16:26
015 Les Aubes,5,3,8,2022,01-21,16:26
016 Antigone centre,3,13,16,2022,01-21,16:26
017 M�diath�que Emile Zola,8,8,16,2022,01-21,16:26
018 Nombre d'Or,10,6,16,2022,01-21,16:26
019 Louis Blanc,12,4,16,2022,01-21,16:26
020 Gambetta,3,5,8,2022,01-21,16:26
021 Port Marianne,16,0,16,2022,01-21,16:26
022 Clemenceau,6,6,12,2022,01-21,16:26
023 Les Arceaux,4,12,16,2022,01-21,16:26
024 Cit� Mion,4,4,8,2022,01-21,16:26
025 Nouveau Saint-Roch,7,1,8,2022,01-21,16:26
026 Renouvier,2,6,8,2022,01-21,16:26
027 Odysseum,3,5,8,2022,01-21,16:26
028 Saint-Denis,7,1,8,2022,01-21,16:26
029 Richter,11,5,16,2022,01-21,16:26
030 Charles Flahault,1,7,8,2022,01-21,16:26
031 Voltaire,4,4,8,2022,01-21,16:26
032 Pr�s d'Ar�nes,2,6,8,2022,01-21,16:26
033 Garcia Lorca,2,6,8,2022,01-21,16:26
034 Vert Bois,0,16,16,2022,01-21,16:26
035 Malbosc,0,8,8,2022,01-21,16:26
036 Occitanie,5,27,32,2022,01-21,16:26
037 FacdesSciences,4,20,24,2022,01-21,16:26
038 Fac de Lettres,2,14,16,2022,01-21,16:26
039 Aiguelongue,2,6,8,2022,01-21,16:26
040 Jeu de Mail des Abb�s,5,3,8,2022,01-21,16:26
041 Eurom�decine,2,6,8,2022,01-21,16:26
042 Marie Caizergues,2,6,8,2022,01-21,16:26
043 Sabines,6,2,8,2022,01-21,16:26
044 Celleneuve,0,8,8,2022,01-21,16:26
045 Jardin de la Lironde,6,2,8,2022,01-21,16:26
046 P�re Soulas,7,1,8,2022,01-21,16:26
047 Place Viala,2,6,8,2022,01-21,16:26
048 H�tel du D�partement,6,2,8,2022,01-21,16:26
049 Tonnelles,3,5,8,2022,01-21,16:26
050 Parvis Jules Ferry - Gare Saint-Roch,8,0,8,2022,01-21,16:26
051 Pont de Lattes - Gare Saint-Roch,1,11,12,2022,01-21,16:26
053 Deux Ponts - Gare Saint-Roch,1,7,8,2022,01-21,16:26
054 Providence - Ovalie,3,5,8,2022,01-21,16:26
055 P�rols Etang de l'Or,22,46,68,2022,01-21,16:26
056 Albert 1er - Cath�drale,5,7,12,2022,01-21,16:26
057 Saint-Guilhem - Courreau,2,6,8,2022,01-21,16:26
059 Sud De France,0,8,8,2022,01-21,16:26
001 Rue Jules Ferry - Gare Saint-Roch,4,8,12,2022,01-21,16:36
002 Com�die,11,13,24,2022,01-21,16:36
003 Esplanade,8,24,32,2022,01-21,16:36
004 H�tel de Ville,8,8,16,2022,01-21,16:36
005 Corum,8,4,12,2022,01-21,16:36
006 Place Albert 1er - St Charles,28,3,31,2022,01-21,16:36
007 Foch,2,6,8,2022,01-21,16:36
008 Halles Castellane,3,9,12,2022,01-21,16:36
009 Observatoire,3,5,8,2022,01-21,16:36
010 Rondelet,0,16,16,2022,01-21,16:36
011 Plan Cabanes,1,11,12,2022,01-21,16:36
012 Boutonnet,2,10,12,2022,01-21,16:36
013 Emile Combes,8,0,8,2022,01-21,16:36
014 Beaux-Arts,3,5,8,2022,01-21,16:36
015 Les Aubes,5,3,8,2022,01-21,16:36
016 Antigone centre,7,9,16,2022,01-21,16:36
017 M�diath�que Emile Zola,7,9,16,2022,01-21,16:36
018 Nombre d'Or,11,5,16,2022,01-21,16:36
019 Louis Blanc,15,1,16,2022,01-21,16:36
020 Gambetta,3,5,8,2022,01-21,16:36
021 Port Marianne,16,0,16,2022,01-21,16:36
022 Clemenceau,6,6,12,2022,01-21,16:36
023 Les Arceaux,4,12,16,2022,01-21,16:36
024 Cit� Mion,4,4,8,2022,01-21,16:36
025 Nouveau Saint-Roch,7,1,8,2022,01-21,16:36
026 Renouvier,2,6,8,2022,01-21,16:36
027 Odysseum,3,5,8,2022,01-21,16:36
028 Saint-Denis,7,1,8,2022,01-21,16:36
029 Richter,11,5,16,2022,01-21,16:36
030 Charles Flahault,1,7,8,2022,01-21,16:36
031 Voltaire,4,4,8,2022,01-21,16:36
032 Pr�s d'Ar�nes,2,6,8,2022,01-21,16:36
033 Garcia Lorca,2,6,8,2022,01-21,16:36
034 Vert Bois,0,16,16,2022,01-21,16:36
035 Malbosc,0,8,8,2022,01-21,16:36
036 Occitanie,5,27,32,2022,01-21,16:36
037 FacdesSciences,4,20,24,2022,01-21,16:36
038 Fac de Lettres,2,14,16,2022,01-21,16:36
039 Aiguelongue,2,6,8,2022,01-21,16:36
040 Jeu de Mail des Abb�s,5,3,8,2022,01-21,16:36
041 Eurom�decine,2,6,8,2022,01-21,16:36
042 Marie Caizergues,2,6,8,2022,01-21,16:36
043 Sabines,6,2,8,2022,01-21,16:36
044 Celleneuve,0,8,8,2022,01-21,16:36
045 Jardin de la Lironde,6,2,8,2022,01-21,16:36
046 P�re Soulas,7,1,8,2022,01-21,16:36
047 Place Viala,1,7,8,2022,01-21,16:36
048 H�tel du D�partement,6,2,8,2022,01-21,16:36
049 Tonnelles,3,5,8,2022,01-21,16:36
050 Parvis Jules Ferry - Gare Saint-Roch,7,1,8,2022,01-21,16:36
051 Pont de Lattes - Gare Saint-Roch,1,11,12,2022,01-21,16:36
053 Deux Ponts - Gare Saint-Roch,0,8,8,2022,01-21,16:36
054 Providence - Ovalie,3,5,8,2022,01-21,16:36
055 P�rols Etang de l'Or,24,44,68,2022,01-21,16:36
056 Albert 1er - Cath�drale,5,7,12,2022,01-21,16:36
057 Saint-Guilhem - Courreau,2,6,8,2022,01-21,16:36
059 Sud De France,0,8,8,2022,01-21,16:36
001 Rue Jules Ferry - Gare Saint-Roch,4,8,12,2022,01-21,16:46
002 Com�die,11,13,24,2022,01-21,16:46
003 Esplanade,8,24,32,2022,01-21,16:46
004 H�tel de Ville,8,8,16,2022,01-21,16:46
005 Corum,8,4,12,2022,01-21,16:46
006 Place Albert 1er - St Charles,28,3,31,2022,01-21,16:46
007 Foch,2,6,8,2022,01-21,16:46
008 Halles Castellane,3,9,12,2022,01-21,16:46
009 Observatoire,3,5,8,2022,01-21,16:46
010 Rondelet,0,16,16,2022,01-21,16:46
011 Plan Cabanes,1,11,12,2022,01-21,16:46
012 Boutonnet,2,10,12,2022,01-21,16:46
013 Emile Combes,8,0,8,2022,01-21,16:46
014 Beaux-Arts,3,5,8,2022,01-21,16:46
015 Les Aubes,5,3,8,2022,01-21,16:46
016 Antigone centre,7,9,16,2022,01-21,16:46
017 M�diath�que Emile Zola,7,9,16,2022,01-21,16:46
018 Nombre d'Or,11,5,16,2022,01-21,16:46
019 Louis Blanc,15,1,16,2022,01-21,16:46
020 Gambetta,3,5,8,2022,01-21,16:46
021 Port Marianne,16,0,16,2022,01-21,16:46
022 Clemenceau,6,6,12,2022,01-21,16:46
023 Les Arceaux,4,12,16,2022,01-21,16:46
024 Cit� Mion,4,4,8,2022,01-21,16:46
025 Nouveau Saint-Roch,7,1,8,2022,01-21,16:46
026 Renouvier,2,6,8,2022,01-21,16:46
027 Odysseum,3,5,8,2022,01-21,16:46
028 Saint-Denis,7,1,8,2022,01-21,16:46
029 Richter,11,5,16,2022,01-21,16:46
030 Charles Flahault,1,7,8,2022,01-21,16:46
031 Voltaire,4,4,8,2022,01-21,16:46
032 Pr�s d'Ar�nes,2,6,8,2022,01-21,16:46
033 Garcia Lorca,3,5,8,2022,01-21,16:46
034 Vert Bois,0,16,16,2022,01-21,16:46
035 Malbosc,0,8,8,2022,01-21,16:46
036 Occitanie,5,27,32,2022,01-21,16:46
037 FacdesSciences,4,20,24,2022,01-21,16:46
038 Fac de Lettres,2,14,16,2022,01-21,16:46
039 Aiguelongue,2,6,8,2022,01-21,16:46
040 Jeu de Mail des Abb�s,5,3,8,2022,01-21,16:46
041 Eurom�decine,2,6,8,2022,01-21,16:46
042 Marie Caizergues,3,5,8,2022,01-21,16:46
043 Sabines,6,2,8,2022,01-21,16:46
044 Celleneuve,0,8,8,2022,01-21,16:46
045 Jardin de la Lironde,6,2,8,2022,01-21,16:46
046 P�re Soulas,7,1,8,2022,01-21,16:46
047 Place Viala,1,7,8,2022,01-21,16:46
048 H�tel du D�partement,6,2,8,2022,01-21,16:46
049 Tonnelles,3,5,8,2022,01-21,16:46
050 Parvis Jules Ferry - Gare Saint-Roch,7,1,8,2022,01-21,16:46
051 Pont de Lattes - Gare Saint-Roch,1,11,12,2022,01-21,16:46
053 Deux Ponts - Gare Saint-Roch,0,8,8,2022,01-21,16:46
054 Providence - Ovalie,3,5,8,2022,01-21,16:46
055 P�rols Etang de l'Or,24,44,68,2022,01-21,16:46
056 Albert 1er - Cath�drale,5,7,12,2022,01-21,16:46
057 Saint-Guilhem - Courreau,2,6,8,2022,01-21,16:46
059 Sud De France,0,8,8,2022,01-21,16:46
001 Rue Jules Ferry - Gare Saint-Roch,4,8,12,2022,01-21,16:56
002 Com�die,11,13,24,2022,01-21,16:56
003 Esplanade,8,24,32,2022,01-21,16:56
004 H�tel de Ville,8,8,16,2022,01-21,16:56
005 Corum,8,4,12,2022,01-21,16:56
006 Place Albert 1er - St Charles,28,3,31,2022,01-21,16:56
007 Foch,2,6,8,2022,01-21,16:56
008 Halles Castellane,3,9,12,2022,01-21,16:56
009 Observatoire,3,5,8,2022,01-21,16:56
010 Rondelet,0,16,16,2022,01-21,16:56
011 Plan Cabanes,1,11,12,2022,01-21,16:56
012 Boutonnet,1,11,12,2022,01-21,16:56
013 Emile Combes,8,0,8,2022,01-21,16:56
014 Beaux-Arts,3,5,8,2022,01-21,16:56
015 Les Aubes,6,2,8,2022,01-21,16:56
016 Antigone centre,7,9,16,2022,01-21,16:56
017 M�diath�que Emile Zola,7,9,16,2022,01-21,16:56
018 Nombre d'Or,11,5,16,2022,01-21,16:56
019 Louis Blanc,14,2,16,2022,01-21,16:56
020 Gambetta,2,6,8,2022,01-21,16:56
021 Port Marianne,16,0,16,2022,01-21,16:56
022 Clemenceau,6,6,12,2022,01-21,16:56
023 Les Arceaux,4,12,16,2022,01-21,16:56
024 Cit� Mion,4,4,8,2022,01-21,16:56
025 Nouveau Saint-Roch,7,1,8,2022,01-21,16:56
026 Renouvier,2,6,8,2022,01-21,16:56
027 Odysseum,3,5,8,2022,01-21,16:56
028 Saint-Denis,7,1,8,2022,01-21,16:56
029 Richter,11,5,16,2022,01-21,16:56
030 Charles Flahault,1,7,8,2022,01-21,16:56
031 Voltaire,4,4,8,2022,01-21,16:56
032 Pr�s d'Ar�nes,2,6,8,2022,01-21,16:56
033 Garcia Lorca,3,5,8,2022,01-21,16:56
034 Vert Bois,0,16,16,2022,01-21,16:56
035 Malbosc,0,8,8,2022,01-21,16:56
036 Occitanie,5,27,32,2022,01-21,16:56
037 FacdesSciences,3,21,24,2022,01-21,16:56
038 Fac de Lettres,1,15,16,2022,01-21,16:56
039 Aiguelongue,1,7,8,2022,01-21,16:56
040 Jeu de Mail des Abb�s,5,3,8,2022,01-21,16:56
041 Eurom�decine,2,6,8,2022,01-21,16:56
042 Marie Caizergues,5,3,8,2022,01-21,16:56
043 Sabines,6,2,8,2022,01-21,16:56
044 Celleneuve,0,8,8,2022,01-21,16:56
045 Jardin de la Lironde,6,2,8,2022,01-21,16:56
046 P�re Soulas,7,1,8,2022,01-21,16:56
047 Place Viala,1,7,8,2022,01-21,16:56
048 H�tel du D�partement,6,2,8,2022,01-21,16:56
049 Tonnelles,3,5,8,2022,01-21,16:56
050 Parvis Jules Ferry - Gare Saint-Roch,7,1,8,2022,01-21,16:56
051 Pont de Lattes - Gare Saint-Roch,1,11,12,2022,01-21,16:56
053 Deux Ponts - Gare Saint-Roch,0,8,8,2022,01-21,16:56
054 Providence - Ovalie,3,5,8,2022,01-21,16:56
055 P�rols Etang de l'Or,24,44,68,2022,01-21,16:56
056 Albert 1er - Cath�drale,5,7,12,2022,01-21,16:56
057 Saint-Guilhem - Courreau,2,6,8,2022,01-21,16:56
059 Sud De France,0,8,8,2022,01-21,16:56
001 Rue Jules Ferry - Gare Saint-Roch,4,8,12,2022,01-21,17:07
002 Com�die,12,12,24,2022,01-21,17:07
003 Esplanade,8,24,32,2022,01-21,17:07
004 H�tel de Ville,8,8,16,2022,01-21,17:07
005 Corum,8,4,12,2022,01-21,17:07
006 Place Albert 1er - St Charles,28,3,31,2022,01-21,17:07
007 Foch,2,6,8,2022,01-21,17:07
008 Halles Castellane,3,9,12,2022,01-21,17:07
009 Observatoire,3,5,8,2022,01-21,17:07
010 Rondelet,0,16,16,2022,01-21,17:07
011 Plan Cabanes,1,11,12,2022,01-21,17:07
012 Boutonnet,1,11,12,2022,01-21,17:07
013 Emile Combes,8,0,8,2022,01-21,17:07
014 Beaux-Arts,3,5,8,2022,01-21,17:07
015 Les Aubes,5,3,8,2022,01-21,17:07
016 Antigone centre,7,9,16,2022,01-21,17:07
017 M�diath�que Emile Zola,5,11,16,2022,01-21,17:07
018 Nombre d'Or,11,5,16,2022,01-21,17:07
019 Louis Blanc,14,2,16,2022,01-21,17:07
020 Gambetta,1,7,8,2022,01-21,17:07
021 Port Marianne,16,0,16,2022,01-21,17:07
022 Clemenceau,6,6,12,2022,01-21,17:07
023 Les Arceaux,4,12,16,2022,01-21,17:07
024 Cit� Mion,4,4,8,2022,01-21,17:07
025 Nouveau Saint-Roch,7,1,8,2022,01-21,17:07
026 Renouvier,2,6,8,2022,01-21,17:07
027 Odysseum,3,5,8,2022,01-21,17:07
028 Saint-Denis,7,1,8,2022,01-21,17:07
029 Richter,11,5,16,2022,01-21,17:07
030 Charles Flahault,1,7,8,2022,01-21,17:07
031 Voltaire,4,4,8,2022,01-21,17:07
032 Pr�s d'Ar�nes,1,7,8,2022,01-21,17:07
033 Garcia Lorca,3,5,8,2022,01-21,17:07
034 Vert Bois,0,16,16,2022,01-21,17:07
035 Malbosc,0,8,8,2022,01-21,17:07
036 Occitanie,5,27,32,2022,01-21,17:07
037 FacdesSciences,2,22,24,2022,01-21,17:07
038 Fac de Lettres,0,16,16,2022,01-21,17:07
039 Aiguelongue,1,7,8,2022,01-21,17:07
040 Jeu de Mail des Abb�s,5,3,8,2022,01-21,17:07
041 Eurom�decine,2,6,8,2022,01-21,17:07
042 Marie Caizergues,5,3,8,2022,01-21,17:07
043 Sabines,6,2,8,2022,01-21,17:07
044 Celleneuve,0,8,8,2022,01-21,17:07
045 Jardin de la Lironde,6,2,8,2022,01-21,17:07
046 P�re Soulas,7,1,8,2022,01-21,17:07
047 Place Viala,1,7,8,2022,01-21,17:07
048 H�tel du D�partement,6,2,8,2022,01-21,17:07
049 Tonnelles,3,5,8,2022,01-21,17:07
050 Parvis Jules Ferry - Gare Saint-Roch,6,2,8,2022,01-21,17:07
051 Pont de Lattes - Gare Saint-Roch,0,12,12,2022,01-21,17:07
053 Deux Ponts - Gare Saint-Roch,0,8,8,2022,01-21,17:07
054 Providence - Ovalie,3,5,8,2022,01-21,17:07
055 P�rols Etang de l'Or,24,44,68,2022,01-21,17:07
056 Albert 1er - Cath�drale,5,7,12,2022,01-21,17:07
057 Saint-Guilhem - Courreau,2,6,8,2022,01-21,17:07
059 Sud De France,0,8,8,2022,01-21,17:07
001 Rue Jules Ferry - Gare Saint-Roch,4,8,12,2022,01-21,17:17
002 Com�die,12,12,24,2022,01-21,17:17
003 Esplanade,8,24,32,2022,01-21,17:17
004 H�tel de Ville,9,7,16,2022,01-21,17:17
005 Corum,8,4,12,2022,01-21,17:17
006 Place Albert 1er - St Charles,28,3,31,2022,01-21,17:17
007 Foch,2,6,8,2022,01-21,17:17
008 Halles Castellane,2,10,12,2022,01-21,17:17
009 Observatoire,3,5,8,2022,01-21,17:17
010 Rondelet,0,16,16,2022,01-21,17:17
011 Plan Cabanes,1,11,12,2022,01-21,17:17
012 Boutonnet,1,11,12,2022,01-21,17:17
013 Emile Combes,8,0,8,2022,01-21,17:17
014 Beaux-Arts,3,5,8,2022,01-21,17:17
015 Les Aubes,5,3,8,2022,01-21,17:17
016 Antigone centre,7,9,16,2022,01-21,17:17
017 M�diath�que Emile Zola,5,11,16,2022,01-21,17:17
018 Nombre d'Or,11,5,16,2022,01-21,17:17
019 Louis Blanc,15,1,16,2022,01-21,17:17
020 Gambetta,1,7,8,2022,01-21,17:17
021 Port Marianne,16,0,16,2022,01-21,17:17
022 Clemenceau,6,6,12,2022,01-21,17:17
023 Les Arceaux,4,12,16,2022,01-21,17:17
024 Cit� Mion,4,4,8,2022,01-21,17:17
025 Nouveau Saint-Roch,7,1,8,2022,01-21,17:17
026 Renouvier,3,5,8,2022,01-21,17:17
027 Odysseum,3,5,8,2022,01-21,17:17
028 Saint-Denis,7,1,8,2022,01-21,17:17
029 Richter,11,5,16,2022,01-21,17:17
030 Charles Flahault,1,7,8,2022,01-21,17:17
031 Voltaire,4,4,8,2022,01-21,17:17
032 Pr�s d'Ar�nes,1,7,8,2022,01-21,17:17
033 Garcia Lorca,3,5,8,2022,01-21,17:17
034 Vert Bois,0,16,16,2022,01-21,17:17
035 Malbosc,0,8,8,2022,01-21,17:17
036 Occitanie,6,26,32,2022,01-21,17:17
037 FacdesSciences,2,22,24,2022,01-21,17:17
038 Fac de Lettres,0,16,16,2022,01-21,17:17
039 Aiguelongue,1,7,8,2022,01-21,17:17
040 Jeu de Mail des Abb�s,6,2,8,2022,01-21,17:17
041 Eurom�decine,1,7,8,2022,01-21,17:17
042 Marie Caizergues,6,2,8,2022,01-21,17:17
043 Sabines,6,2,8,2022,01-21,17:17
044 Celleneuve,0,8,8,2022,01-21,17:17
045 Jardin de la Lironde,6,2,8,2022,01-21,17:17
046 P�re Soulas,6,2,8,2022,01-21,17:17
047 Place Viala,1,7,8,2022,01-21,17:17
048 H�tel du D�partement,6,2,8,2022,01-21,17:17
049 Tonnelles,3,5,8,2022,01-21,17:17
050 Parvis Jules Ferry - Gare Saint-Roch,6,2,8,2022,01-21,17:17
051 Pont de Lattes - Gare Saint-Roch,0,12,12,2022,01-21,17:17
053 Deux Ponts - Gare Saint-Roch,0,8,8,2022,01-21,17:17
054 Providence - Ovalie,3,5,8,2022,01-21,17:17
055 P�rols Etang de l'Or,24,44,68,2022,01-21,17:17
056 Albert 1er - Cath�drale,5,7,12,2022,01-21,17:17
057 Saint-Guilhem - Courreau,2,6,8,2022,01-21,17:17
059 Sud De France,0,8,8,2022,01-21,17:17
001 Rue Jules Ferry - Gare Saint-Roch,4,8,12,2022,01-21,17:27
002 Com�die,12,12,24,2022,01-21,17:27
003 Esplanade,7,25,32,2022,01-21,17:27
004 H�tel de Ville,9,7,16,2022,01-21,17:27
005 Corum,7,5,12,2022,01-21,17:27
006 Place Albert 1er - St Charles,29,2,31,2022,01-21,17:27
007 Foch,2,6,8,2022,01-21,17:27
008 Halles Castellane,2,10,12,2022,01-21,17:27
009 Observatoire,3,5,8,2022,01-21,17:27
010 Rondelet,0,16,16,2022,01-21,17:27
011 Plan Cabanes,1,11,12,2022,01-21,17:27
012 Boutonnet,1,11,12,2022,01-21,17:27
013 Emile Combes,8,0,8,2022,01-21,17:27
014 Beaux-Arts,3,5,8,2022,01-21,17:27
015 Les Aubes,5,3,8,2022,01-21,17:27
016 Antigone centre,9,7,16,2022,01-21,17:27
017 M�diath�que Emile Zola,5,11,16,2022,01-21,17:27
018 Nombre d'Or,11,5,16,2022,01-21,17:27
019 Louis Blanc,16,0,16,2022,01-21,17:27
020 Gambetta,1,7,8,2022,01-21,17:27
021 Port Marianne,16,0,16,2022,01-21,17:27
022 Clemenceau,5,7,12,2022,01-21,17:27
023 Les Arceaux,3,13,16,2022,01-21,17:27
024 Cit� Mion,4,4,8,2022,01-21,17:27
025 Nouveau Saint-Roch,7,1,8,2022,01-21,17:27
026 Renouvier,3,5,8,2022,01-21,17:27
027 Odysseum,3,5,8,2022,01-21,17:27
028 Saint-Denis,7,1,8,2022,01-21,17:27
029 Richter,11,5,16,2022,01-21,17:27
030 Charles Flahault,1,7,8,2022,01-21,17:27
031 Voltaire,4,4,8,2022,01-21,17:27
032 Pr�s d'Ar�nes,1,7,8,2022,01-21,17:27
033 Garcia Lorca,3,5,8,2022,01-21,17:27
034 Vert Bois,0,16,16,2022,01-21,17:27
035 Malbosc,0,8,8,2022,01-21,17:27
036 Occitanie,6,26,32,2022,01-21,17:27
037 FacdesSciences,2,22,24,2022,01-21,17:27
038 Fac de Lettres,0,16,16,2022,01-21,17:27
039 Aiguelongue,2,6,8,2022,01-21,17:27
040 Jeu de Mail des Abb�s,6,2,8,2022,01-21,17:27
041 Eurom�decine,1,7,8,2022,01-21,17:27
042 Marie Caizergues,8,0,8,2022,01-21,17:27
043 Sabines,6,2,8,2022,01-21,17:27
044 Celleneuve,0,8,8,2022,01-21,17:27
045 Jardin de la Lironde,6,2,8,2022,01-21,17:27
046 P�re Soulas,6,2,8,2022,01-21,17:27
047 Place Viala,0,8,8,2022,01-21,17:27
048 H�tel du D�partement,6,2,8,2022,01-21,17:27
049 Tonnelles,3,5,8,2022,01-21,17:27
050 Parvis Jules Ferry - Gare Saint-Roch,6,2,8,2022,01-21,17:27
051 Pont de Lattes - Gare Saint-Roch,0,12,12,2022,01-21,17:27
053 Deux Ponts - Gare Saint-Roch,0,8,8,2022,01-21,17:27
054 Providence - Ovalie,3,5,8,2022,01-21,17:27
055 P�rols Etang de l'Or,24,44,68,2022,01-21,17:27
056 Albert 1er - Cath�drale,5,7,12,2022,01-21,17:27
057 Saint-Guilhem - Courreau,2,6,8,2022,01-21,17:27
059 Sud De France,0,8,8,2022,01-21,17:27
001 Rue Jules Ferry - Gare Saint-Roch,4,8,12,2022,01-21,17:37
002 Com�die,13,11,24,2022,01-21,17:37
003 Esplanade,7,25,32,2022,01-21,17:37
004 H�tel de Ville,9,7,16,2022,01-21,17:37
005 Corum,8,4,12,2022,01-21,17:37
006 Place Albert 1er - St Charles,29,2,31,2022,01-21,17:37
007 Foch,2,6,8,2022,01-21,17:37
008 Halles Castellane,2,10,12,2022,01-21,17:37
009 Observatoire,3,5,8,2022,01-21,17:37
010 Rondelet,0,16,16,2022,01-21,17:37
011 Plan Cabanes,1,11,12,2022,01-21,17:37
012 Boutonnet,2,10,12,2022,01-21,17:37
013 Emile Combes,8,0,8,2022,01-21,17:37
014 Beaux-Arts,3,5,8,2022,01-21,17:37
015 Les Aubes,5,3,8,2022,01-21,17:37
016 Antigone centre,9,7,16,2022,01-21,17:37
017 M�diath�que Emile Zola,5,11,16,2022,01-21,17:37
018 Nombre d'Or,11,5,16,2022,01-21,17:37
019 Louis Blanc,16,0,16,2022,01-21,17:37
020 Gambetta,1,7,8,2022,01-21,17:37
021 Port Marianne,16,0,16,2022,01-21,17:37
022 Clemenceau,6,6,12,2022,01-21,17:37
023 Les Arceaux,3,13,16,2022,01-21,17:37
024 Cit� Mion,4,4,8,2022,01-21,17:37
025 Nouveau Saint-Roch,7,1,8,2022,01-21,17:37
026 Renouvier,3,5,8,2022,01-21,17:37
027 Odysseum,3,5,8,2022,01-21,17:37
028 Saint-Denis,7,1,8,2022,01-21,17:37
029 Richter,10,6,16,2022,01-21,17:37
030 Charles Flahault,1,7,8,2022,01-21,17:37
031 Voltaire,4,4,8,2022,01-21,17:37
032 Pr�s d'Ar�nes,1,7,8,2022,01-21,17:37
033 Garcia Lorca,2,6,8,2022,01-21,17:37
034 Vert Bois,0,16,16,2022,01-21,17:37
035 Malbosc,0,8,8,2022,01-21,17:37
036 Occitanie,6,26,32,2022,01-21,17:37
037 FacdesSciences,3,21,24,2022,01-21,17:37
038 Fac de Lettres,0,16,16,2022,01-21,17:37
039 Aiguelongue,1,7,8,2022,01-21,17:37
040 Jeu de Mail des Abb�s,5,3,8,2022,01-21,17:37
041 Eurom�decine,1,7,8,2022,01-21,17:37
042 Marie Caizergues,8,0,8,2022,01-21,17:37
043 Sabines,6,2,8,2022,01-21,17:37
044 Celleneuve,0,8,8,2022,01-21,17:37
045 Jardin de la Lironde,6,2,8,2022,01-21,17:37
046 P�re Soulas,6,2,8,2022,01-21,17:37
047 Place Viala,0,8,8,2022,01-21,17:37
048 H�tel du D�partement,6,2,8,2022,01-21,17:37
049 Tonnelles,3,5,8,2022,01-21,17:37
050 Parvis Jules Ferry - Gare Saint-Roch,6,2,8,2022,01-21,17:37
051 Pont de Lattes - Gare Saint-Roch,0,12,12,2022,01-21,17:37
053 Deux Ponts - Gare Saint-Roch,0,8,8,2022,01-21,17:37
054 Providence - Ovalie,3,5,8,2022,01-21,17:37
055 P�rols Etang de l'Or,22,46,68,2022,01-21,17:37
056 Albert 1er - Cath�drale,5,7,12,2022,01-21,17:37
057 Saint-Guilhem - Courreau,2,6,8,2022,01-21,17:37
059 Sud De France,0,8,8,2022,01-21,17:37
001 Rue Jules Ferry - Gare Saint-Roch,4,8,12,2022,01-21,17:47
002 Com�die,14,10,24,2022,01-21,17:47
003 Esplanade,7,25,32,2022,01-21,17:47
004 H�tel de Ville,9,7,16,2022,01-21,17:47
005 Corum,8,4,12,2022,01-21,17:47
006 Place Albert 1er - St Charles,29,2,31,2022,01-21,17:47
007 Foch,2,6,8,2022,01-21,17:47
008 Halles Castellane,2,10,12,2022,01-21,17:47
009 Observatoire,3,5,8,2022,01-21,17:47
010 Rondelet,1,15,16,2022,01-21,17:47
011 Plan Cabanes,1,11,12,2022,01-21,17:47
012 Boutonnet,2,10,12,2022,01-21,17:47
013 Emile Combes,8,0,8,2022,01-21,17:47
014 Beaux-Arts,3,5,8,2022,01-21,17:47
015 Les Aubes,5,3,8,2022,01-21,17:47
016 Antigone centre,10,6,16,2022,01-21,17:47
017 M�diath�que Emile Zola,5,11,16,2022,01-21,17:47
018 Nombre d'Or,11,5,16,2022,01-21,17:47
019 Louis Blanc,16,0,16,2022,01-21,17:47
020 Gambetta,1,7,8,2022,01-21,17:47
021 Port Marianne,15,1,16,2022,01-21,17:47
022 Clemenceau,6,6,12,2022,01-21,17:47
023 Les Arceaux,3,13,16,2022,01-21,17:47
024 Cit� Mion,4,4,8,2022,01-21,17:47
025 Nouveau Saint-Roch,7,1,8,2022,01-21,17:47
026 Renouvier,3,5,8,2022,01-21,17:47
027 Odysseum,3,5,8,2022,01-21,17:47
028 Saint-Denis,7,1,8,2022,01-21,17:47
029 Richter,10,6,16,2022,01-21,17:47
030 Charles Flahault,1,7,8,2022,01-21,17:47
031 Voltaire,4,4,8,2022,01-21,17:47
032 Pr�s d'Ar�nes,1,7,8,2022,01-21,17:47
033 Garcia Lorca,2,6,8,2022,01-21,17:47
034 Vert Bois,0,16,16,2022,01-21,17:47
035 Malbosc,0,8,8,2022,01-21,17:47
036 Occitanie,6,26,32,2022,01-21,17:47
037 FacdesSciences,3,21,24,2022,01-21,17:47
038 Fac de Lettres,0,16,16,2022,01-21,17:47
039 Aiguelongue,1,7,8,2022,01-21,17:47
040 Jeu de Mail des Abb�s,5,3,8,2022,01-21,17:47
041 Eurom�decine,1,7,8,2022,01-21,17:47
042 Marie Caizergues,8,0,8,2022,01-21,17:47
043 Sabines,6,2,8,2022,01-21,17:47
044 Celleneuve,0,8,8,2022,01-21,17:47
045 Jardin de la Lironde,6,2,8,2022,01-21,17:47
046 P�re Soulas,6,2,8,2022,01-21,17:47
047 Place Viala,0,8,8,2022,01-21,17:47
048 H�tel du D�partement,6,2,8,2022,01-21,17:47
049 Tonnelles,3,5,8,2022,01-21,17:47
050 Parvis Jules Ferry - Gare Saint-Roch,5,3,8,2022,01-21,17:47
051 Pont de Lattes - Gare Saint-Roch,0,12,12,2022,01-21,17:47
053 Deux Ponts - Gare Saint-Roch,0,8,8,2022,01-21,17:47
054 Providence - Ovalie,3,5,8,2022,01-21,17:47
055 P�rols Etang de l'Or,23,45,68,2022,01-21,17:47
056 Albert 1er - Cath�drale,5,7,12,2022,01-21,17:47
057 Saint-Guilhem - Courreau,2,6,8,2022,01-21,17:47
059 Sud De France,0,8,8,2022,01-21,17:47
001 Rue Jules Ferry - Gare Saint-Roch,4,8,12,2022,01-21,17:58
002 Com�die,13,11,24,2022,01-21,17:58
003 Esplanade,6,26,32,2022,01-21,17:58
004 H�tel de Ville,9,7,16,2022,01-21,17:58
005 Corum,8,4,12,2022,01-21,17:58
006 Place Albert 1er - St Charles,28,3,31,2022,01-21,17:58
007 Foch,2,6,8,2022,01-21,17:58
008 Halles Castellane,2,10,12,2022,01-21,17:58
009 Observatoire,3,5,8,2022,01-21,17:58
010 Rondelet,1,15,16,2022,01-21,17:58
011 Plan Cabanes,1,11,12,2022,01-21,17:58
012 Boutonnet,2,10,12,2022,01-21,17:58
013 Emile Combes,8,0,8,2022,01-21,17:58
014 Beaux-Arts,3,5,8,2022,01-21,17:58
015 Les Aubes,5,3,8,2022,01-21,17:58
016 Antigone centre,10,6,16,2022,01-21,17:58
017 M�diath�que Emile Zola,3,13,16,2022,01-21,17:58
018 Nombre d'Or,12,4,16,2022,01-21,17:58
019 Louis Blanc,16,0,16,2022,01-21,17:58
020 Gambetta,1,7,8,2022,01-21,17:58
021 Port Marianne,15,1,16,2022,01-21,17:58
022 Clemenceau,6,6,12,2022,01-21,17:58
023 Les Arceaux,3,13,16,2022,01-21,17:58
024 Cit� Mion,4,4,8,2022,01-21,17:58
025 Nouveau Saint-Roch,6,2,8,2022,01-21,17:58
026 Renouvier,3,5,8,2022,01-21,17:58
027 Odysseum,3,5,8,2022,01-21,17:58
028 Saint-Denis,7,1,8,2022,01-21,17:58
029 Richter,10,6,16,2022,01-21,17:58
030 Charles Flahault,1,7,8,2022,01-21,17:58
031 Voltaire,4,4,8,2022,01-21,17:58
032 Pr�s d'Ar�nes,1,7,8,2022,01-21,17:58
033 Garcia Lorca,2,6,8,2022,01-21,17:58
034 Vert Bois,0,16,16,2022,01-21,17:58
035 Malbosc,0,8,8,2022,01-21,17:58
036 Occitanie,6,26,32,2022,01-21,17:58
037 FacdesSciences,3,21,24,2022,01-21,17:58
038 Fac de Lettres,0,16,16,2022,01-21,17:58
039 Aiguelongue,1,7,8,2022,01-21,17:58
040 Jeu de Mail des Abb�s,5,3,8,2022,01-21,17:58
041 Eurom�decine,1,7,8,2022,01-21,17:58
042 Marie Caizergues,8,0,8,2022,01-21,17:58
043 Sabines,6,2,8,2022,01-21,17:58
044 Celleneuve,0,8,8,2022,01-21,17:58
045 Jardin de la Lironde,6,2,8,2022,01-21,17:58
046 P�re Soulas,6,2,8,2022,01-21,17:58
047 Place Viala,0,8,8,2022,01-21,17:58
048 H�tel du D�partement,7,1,8,2022,01-21,17:58
049 Tonnelles,3,5,8,2022,01-21,17:58
050 Parvis Jules Ferry - Gare Saint-Roch,4,4,8,2022,01-21,17:58
051 Pont de Lattes - Gare Saint-Roch,0,12,12,2022,01-21,17:58
053 Deux Ponts - Gare Saint-Roch,0,8,8,2022,01-21,17:58
054 Providence - Ovalie,3,5,8,2022,01-21,17:58
055 P�rols Etang de l'Or,23,45,68,2022,01-21,17:58
056 Albert 1er - Cath�drale,5,7,12,2022,01-21,17:58
057 Saint-Guilhem - Courreau,1,7,8,2022,01-21,17:58
059 Sud De France,0,8,8,2022,01-21,17:58
001 Rue Jules Ferry - Gare Saint-Roch,4,8,12,2022,01-21,18:08
002 Com�die,12,12,24,2022,01-21,18:08
003 Esplanade,6,26,32,2022,01-21,18:08
004 H�tel de Ville,9,7,16,2022,01-21,18:08
005 Corum,8,4,12,2022,01-21,18:08
006 Place Albert 1er - St Charles,28,3,31,2022,01-21,18:08
007 Foch,2,6,8,2022,01-21,18:08
008 Halles Castellane,2,10,12,2022,01-21,18:08
009 Observatoire,3,5,8,2022,01-21,18:08
010 Rondelet,1,15,16,2022,01-21,18:08
011 Plan Cabanes,1,11,12,2022,01-21,18:08
012 Boutonnet,2,10,12,2022,01-21,18:08
013 Emile Combes,8,0,8,2022,01-21,18:08
014 Beaux-Arts,3,5,8,2022,01-21,18:08
015 Les Aubes,5,3,8,2022,01-21,18:08
016 Antigone centre,10,6,16,2022,01-21,18:08
017 M�diath�que Emile Zola,3,13,16,2022,01-21,18:08
018 Nombre d'Or,13,3,16,2022,01-21,18:08
019 Louis Blanc,16,0,16,2022,01-21,18:08
020 Gambetta,1,7,8,2022,01-21,18:08
021 Port Marianne,15,1,16,2022,01-21,18:08
022 Clemenceau,6,6,12,2022,01-21,18:08
023 Les Arceaux,3,13,16,2022,01-21,18:08
024 Cit� Mion,4,4,8,2022,01-21,18:08
025 Nouveau Saint-Roch,6,2,8,2022,01-21,18:08
026 Renouvier,3,5,8,2022,01-21,18:08
027 Odysseum,3,5,8,2022,01-21,18:08
028 Saint-Denis,8,0,8,2022,01-21,18:08
029 Richter,9,7,16,2022,01-21,18:08
030 Charles Flahault,1,7,8,2022,01-21,18:08
031 Voltaire,4,4,8,2022,01-21,18:08
032 Pr�s d'Ar�nes,1,7,8,2022,01-21,18:08
033 Garcia Lorca,2,6,8,2022,01-21,18:08
034 Vert Bois,0,16,16,2022,01-21,18:08
035 Malbosc,0,8,8,2022,01-21,18:08
036 Occitanie,7,25,32,2022,01-21,18:08
037 FacdesSciences,3,21,24,2022,01-21,18:08
038 Fac de Lettres,0,16,16,2022,01-21,18:08
039 Aiguelongue,2,6,8,2022,01-21,18:08
040 Jeu de Mail des Abb�s,5,3,8,2022,01-21,18:08
041 Eurom�decine,0,8,8,2022,01-21,18:08
042 Marie Caizergues,8,0,8,2022,01-21,18:08
043 Sabines,6,2,8,2022,01-21,18:08
044 Celleneuve,0,8,8,2022,01-21,18:08
045 Jardin de la Lironde,6,2,8,2022,01-21,18:08
046 P�re Soulas,6,2,8,2022,01-21,18:08
047 Place Viala,0,8,8,2022,01-21,18:08
048 H�tel du D�partement,7,1,8,2022,01-21,18:08
049 Tonnelles,3,5,8,2022,01-21,18:08
050 Parvis Jules Ferry - Gare Saint-Roch,4,4,8,2022,01-21,18:08
051 Pont de Lattes - Gare Saint-Roch,0,12,12,2022,01-21,18:08
053 Deux Ponts - Gare Saint-Roch,0,8,8,2022,01-21,18:08
054 Providence - Ovalie,3,5,8,2022,01-21,18:08
055 P�rols Etang de l'Or,23,45,68,2022,01-21,18:08
056 Albert 1er - Cath�drale,5,7,12,2022,01-21,18:08
057 Saint-Guilhem - Courreau,1,7,8,2022,01-21,18:08
059 Sud De France,0,8,8,2022,01-21,18:08
001 Rue Jules Ferry - Gare Saint-Roch,4,8,12,2022,01-21,18:18
002 Com�die,11,13,24,2022,01-21,18:18
003 Esplanade,4,28,32,2022,01-21,18:18
004 H�tel de Ville,9,7,16,2022,01-21,18:18
005 Corum,8,4,12,2022,01-21,18:18
006 Place Albert 1er - St Charles,28,3,31,2022,01-21,18:18
007 Foch,2,6,8,2022,01-21,18:18
008 Halles Castellane,3,9,12,2022,01-21,18:18
009 Observatoire,4,4,8,2022,01-21,18:18
010 Rondelet,1,15,16,2022,01-21,18:18
011 Plan Cabanes,1,11,12,2022,01-21,18:18
012 Boutonnet,2,10,12,2022,01-21,18:18
013 Emile Combes,8,0,8,2022,01-21,18:18
014 Beaux-Arts,3,5,8,2022,01-21,18:18
015 Les Aubes,5,3,8,2022,01-21,18:18
016 Antigone centre,11,5,16,2022,01-21,18:18
017 M�diath�que Emile Zola,3,13,16,2022,01-21,18:18
018 Nombre d'Or,13,3,16,2022,01-21,18:18
019 Louis Blanc,16,0,16,2022,01-21,18:18
020 Gambetta,1,7,8,2022,01-21,18:18
021 Port Marianne,15,1,16,2022,01-21,18:18
022 Clemenceau,6,6,12,2022,01-21,18:18
023 Les Arceaux,2,14,16,2022,01-21,18:18
024 Cit� Mion,4,4,8,2022,01-21,18:18
025 Nouveau Saint-Roch,6,2,8,2022,01-21,18:18
026 Renouvier,3,5,8,2022,01-21,18:18
027 Odysseum,4,4,8,2022,01-21,18:18
028 Saint-Denis,8,0,8,2022,01-21,18:18
029 Richter,9,7,16,2022,01-21,18:18
030 Charles Flahault,1,7,8,2022,01-21,18:18
031 Voltaire,4,4,8,2022,01-21,18:18
032 Pr�s d'Ar�nes,1,7,8,2022,01-21,18:18
033 Garcia Lorca,2,6,8,2022,01-21,18:18
034 Vert Bois,0,16,16,2022,01-21,18:18
035 Malbosc,0,8,8,2022,01-21,18:18
036 Occitanie,7,25,32,2022,01-21,18:18
037 FacdesSciences,3,21,24,2022,01-21,18:18
038 Fac de Lettres,0,16,16,2022,01-21,18:18
039 Aiguelongue,2,6,8,2022,01-21,18:18
040 Jeu de Mail des Abb�s,7,1,8,2022,01-21,18:18
041 Eurom�decine,0,8,8,2022,01-21,18:18
042 Marie Caizergues,8,0,8,2022,01-21,18:18
043 Sabines,6,2,8,2022,01-21,18:18
044 Celleneuve,0,8,8,2022,01-21,18:18
045 Jardin de la Lironde,5,3,8,2022,01-21,18:18
046 P�re Soulas,6,2,8,2022,01-21,18:18
047 Place Viala,0,8,8,2022,01-21,18:18
048 H�tel du D�partement,7,1,8,2022,01-21,18:18
049 Tonnelles,3,5,8,2022,01-21,18:18
050 Parvis Jules Ferry - Gare Saint-Roch,5,3,8,2022,01-21,18:18
051 Pont de Lattes - Gare Saint-Roch,0,12,12,2022,01-21,18:18
053 Deux Ponts - Gare Saint-Roch,0,8,8,2022,01-21,18:18
054 Providence - Ovalie,3,5,8,2022,01-21,18:18
055 P�rols Etang de l'Or,24,44,68,2022,01-21,18:18
056 Albert 1er - Cath�drale,5,7,12,2022,01-21,18:18
057 Saint-Guilhem - Courreau,0,8,8,2022,01-21,18:18
059 Sud De France,0,8,8,2022,01-21,18:18
001 Rue Jules Ferry - Gare Saint-Roch,4,8,12,2022,01-21,18:28
002 Com�die,10,14,24,2022,01-21,18:28
003 Esplanade,4,28,32,2022,01-21,18:28
004 H�tel de Ville,9,7,16,2022,01-21,18:28
005 Corum,8,4,12,2022,01-21,18:28
006 Place Albert 1er - St Charles,26,5,31,2022,01-21,18:28
007 Foch,2,6,8,2022,01-21,18:28
008 Halles Castellane,3,9,12,2022,01-21,18:28
009 Observatoire,4,4,8,2022,01-21,18:28
010 Rondelet,1,15,16,2022,01-21,18:28
011 Plan Cabanes,1,11,12,2022,01-21,18:28
012 Boutonnet,2,10,12,2022,01-21,18:28
013 Emile Combes,8,0,8,2022,01-21,18:28
014 Beaux-Arts,3,5,8,2022,01-21,18:28
015 Les Aubes,5,3,8,2022,01-21,18:28
016 Antigone centre,11,5,16,2022,01-21,18:28
017 M�diath�que Emile Zola,3,13,16,2022,01-21,18:28
018 Nombre d'Or,13,3,16,2022,01-21,18:28
019 Louis Blanc,16,0,16,2022,01-21,18:28
020 Gambetta,1,7,8,2022,01-21,18:28
021 Port Marianne,15,1,16,2022,01-21,18:28
022 Clemenceau,6,6,12,2022,01-21,18:28
023 Les Arceaux,2,14,16,2022,01-21,18:28
024 Cit� Mion,4,4,8,2022,01-21,18:28
025 Nouveau Saint-Roch,6,2,8,2022,01-21,18:28
026 Renouvier,3,5,8,2022,01-21,18:28
027 Odysseum,5,3,8,2022,01-21,18:28
028 Saint-Denis,8,0,8,2022,01-21,18:28
029 Richter,9,7,16,2022,01-21,18:28
030 Charles Flahault,1,7,8,2022,01-21,18:28
031 Voltaire,4,4,8,2022,01-21,18:28
032 Pr�s d'Ar�nes,1,7,8,2022,01-21,18:28
033 Garcia Lorca,2,6,8,2022,01-21,18:28
034 Vert Bois,0,16,16,2022,01-21,18:28
035 Malbosc,0,8,8,2022,01-21,18:28
036 Occitanie,6,26,32,2022,01-21,18:28
037 FacdesSciences,1,23,24,2022,01-21,18:28
038 Fac de Lettres,0,16,16,2022,01-21,18:28
039 Aiguelongue,2,6,8,2022,01-21,18:28
040 Jeu de Mail des Abb�s,7,1,8,2022,01-21,18:28
041 Eurom�decine,0,8,8,2022,01-21,18:28
042 Marie Caizergues,8,0,8,2022,01-21,18:28
043 Sabines,6,2,8,2022,01-21,18:28
044 Celleneuve,1,7,8,2022,01-21,18:28
045 Jardin de la Lironde,5,3,8,2022,01-21,18:28
046 P�re Soulas,6,2,8,2022,01-21,18:28
047 Place Viala,0,8,8,2022,01-21,18:28
048 H�tel du D�partement,7,1,8,2022,01-21,18:28
049 Tonnelles,3,5,8,2022,01-21,18:28
050 Parvis Jules Ferry - Gare Saint-Roch,5,3,8,2022,01-21,18:28
051 Pont de Lattes - Gare Saint-Roch,0,12,12,2022,01-21,18:28
053 Deux Ponts - Gare Saint-Roch,0,8,8,2022,01-21,18:28
054 Providence - Ovalie,3,5,8,2022,01-21,18:28
055 P�rols Etang de l'Or,25,43,68,2022,01-21,18:28
056 Albert 1er - Cath�drale,5,7,12,2022,01-21,18:28
057 Saint-Guilhem - Courreau,0,8,8,2022,01-21,18:28
059 Sud De France,0,8,8,2022,01-21,18:28
001 Rue Jules Ferry - Gare Saint-Roch,4,8,12,2022,01-21,18:38
002 Com�die,10,14,24,2022,01-21,18:38
003 Esplanade,4,28,32,2022,01-21,18:38
004 H�tel de Ville,9,7,16,2022,01-21,18:38
005 Corum,8,4,12,2022,01-21,18:38
006 Place Albert 1er - St Charles,26,5,31,2022,01-21,18:38
007 Foch,2,6,8,2022,01-21,18:38
008 Halles Castellane,3,9,12,2022,01-21,18:38
009 Observatoire,4,4,8,2022,01-21,18:38
010 Rondelet,1,15,16,2022,01-21,18:38
011 Plan Cabanes,1,11,12,2022,01-21,18:38
012 Boutonnet,2,10,12,2022,01-21,18:38
013 Emile Combes,8,0,8,2022,01-21,18:38
014 Beaux-Arts,3,5,8,2022,01-21,18:38
015 Les Aubes,5,3,8,2022,01-21,18:38
016 Antigone centre,11,5,16,2022,01-21,18:38
017 M�diath�que Emile Zola,3,13,16,2022,01-21,18:38
018 Nombre d'Or,13,3,16,2022,01-21,18:38
019 Louis Blanc,16,0,16,2022,01-21,18:38
020 Gambetta,1,7,8,2022,01-21,18:38
021 Port Marianne,15,1,16,2022,01-21,18:38
022 Clemenceau,6,6,12,2022,01-21,18:38
023 Les Arceaux,2,14,16,2022,01-21,18:38
024 Cit� Mion,4,4,8,2022,01-21,18:38
025 Nouveau Saint-Roch,6,2,8,2022,01-21,18:38
026 Renouvier,3,5,8,2022,01-21,18:38
027 Odysseum,5,3,8,2022,01-21,18:38
028 Saint-Denis,8,0,8,2022,01-21,18:38
029 Richter,10,6,16,2022,01-21,18:38
030 Charles Flahault,1,7,8,2022,01-21,18:38
031 Voltaire,4,4,8,2022,01-21,18:38
032 Pr�s d'Ar�nes,1,7,8,2022,01-21,18:38
033 Garcia Lorca,2,6,8,2022,01-21,18:38
034 Vert Bois,0,16,16,2022,01-21,18:38
035 Malbosc,0,8,8,2022,01-21,18:38
036 Occitanie,8,24,32,2022,01-21,18:38
037 FacdesSciences,1,23,24,2022,01-21,18:38
038 Fac de Lettres,0,16,16,2022,01-21,18:38
039 Aiguelongue,2,6,8,2022,01-21,18:38
040 Jeu de Mail des Abb�s,7,1,8,2022,01-21,18:38
041 Eurom�decine,0,8,8,2022,01-21,18:38
042 Marie Caizergues,8,0,8,2022,01-21,18:38
043 Sabines,7,1,8,2022,01-21,18:38
044 Celleneuve,1,7,8,2022,01-21,18:38
045 Jardin de la Lironde,4,4,8,2022,01-21,18:38
046 P�re Soulas,4,4,8,2022,01-21,18:38
047 Place Viala,0,8,8,2022,01-21,18:38
048 H�tel du D�partement,7,1,8,2022,01-21,18:38
049 Tonnelles,3,5,8,2022,01-21,18:38
050 Parvis Jules Ferry - Gare Saint-Roch,5,3,8,2022,01-21,18:38
051 Pont de Lattes - Gare Saint-Roch,0,12,12,2022,01-21,18:38
053 Deux Ponts - Gare Saint-Roch,0,8,8,2022,01-21,18:38
054 Providence - Ovalie,3,5,8,2022,01-21,18:38
055 P�rols Etang de l'Or,25,43,68,2022,01-21,18:38
056 Albert 1er - Cath�drale,5,7,12,2022,01-21,18:38
057 Saint-Guilhem - Courreau,0,8,8,2022,01-21,18:38
059 Sud De France,0,8,8,2022,01-21,18:38
001 Rue Jules Ferry - Gare Saint-Roch,5,7,12,2022,01-21,18:49
002 Com�die,10,14,24,2022,01-21,18:49
003 Esplanade,4,28,32,2022,01-21,18:49
004 H�tel de Ville,9,7,16,2022,01-21,18:49
005 Corum,9,3,12,2022,01-21,18:49
006 Place Albert 1er - St Charles,26,5,31,2022,01-21,18:49
007 Foch,2,6,8,2022,01-21,18:49
008 Halles Castellane,2,10,12,2022,01-21,18:49
009 Observatoire,5,3,8,2022,01-21,18:49
010 Rondelet,2,14,16,2022,01-21,18:49
011 Plan Cabanes,1,11,12,2022,01-21,18:49
012 Boutonnet,4,8,12,2022,01-21,18:49
013 Emile Combes,8,0,8,2022,01-21,18:49
014 Beaux-Arts,3,5,8,2022,01-21,18:49
015 Les Aubes,5,3,8,2022,01-21,18:49
016 Antigone centre,11,5,16,2022,01-21,18:49
017 M�diath�que Emile Zola,3,13,16,2022,01-21,18:49
018 Nombre d'Or,13,3,16,2022,01-21,18:49
019 Louis Blanc,16,0,16,2022,01-21,18:49
020 Gambetta,1,7,8,2022,01-21,18:49
021 Port Marianne,16,0,16,2022,01-21,18:49
022 Clemenceau,7,5,12,2022,01-21,18:49
023 Les Arceaux,2,14,16,2022,01-21,18:49
024 Cit� Mion,4,4,8,2022,01-21,18:49
025 Nouveau Saint-Roch,6,2,8,2022,01-21,18:49
026 Renouvier,3,5,8,2022,01-21,18:49
027 Odysseum,4,4,8,2022,01-21,18:49
028 Saint-Denis,8,0,8,2022,01-21,18:49
029 Richter,10,6,16,2022,01-21,18:49
030 Charles Flahault,1,7,8,2022,01-21,18:49
031 Voltaire,4,4,8,2022,01-21,18:49
032 Pr�s d'Ar�nes,1,7,8,2022,01-21,18:49
033 Garcia Lorca,2,6,8,2022,01-21,18:49
034 Vert Bois,0,16,16,2022,01-21,18:49
035 Malbosc,0,8,8,2022,01-21,18:49
036 Occitanie,8,24,32,2022,01-21,18:49
037 FacdesSciences,1,23,24,2022,01-21,18:49
038 Fac de Lettres,0,16,16,2022,01-21,18:49
039 Aiguelongue,2,6,8,2022,01-21,18:49
040 Jeu de Mail des Abb�s,7,1,8,2022,01-21,18:49
041 Eurom�decine,0,8,8,2022,01-21,18:49
042 Marie Caizergues,7,1,8,2022,01-21,18:49
043 Sabines,7,1,8,2022,01-21,18:49
044 Celleneuve,1,7,8,2022,01-21,18:49
045 Jardin de la Lironde,4,4,8,2022,01-21,18:49
046 P�re Soulas,4,4,8,2022,01-21,18:49
047 Place Viala,0,8,8,2022,01-21,18:49
048 H�tel du D�partement,7,1,8,2022,01-21,18:49
049 Tonnelles,3,5,8,2022,01-21,18:49
050 Parvis Jules Ferry - Gare Saint-Roch,5,3,8,2022,01-21,18:49
051 Pont de Lattes - Gare Saint-Roch,0,12,12,2022,01-21,18:49
053 Deux Ponts - Gare Saint-Roch,0,8,8,2022,01-21,18:49
054 Providence - Ovalie,3,5,8,2022,01-21,18:49
055 P�rols Etang de l'Or,25,43,68,2022,01-21,18:49
056 Albert 1er - Cath�drale,5,7,12,2022,01-21,18:49
057 Saint-Guilhem - Courreau,0,8,8,2022,01-21,18:49
059 Sud De France,0,8,8,2022,01-21,18:49
001 Rue Jules Ferry - Gare Saint-Roch,5,7,12,2022,01-21,18:59
002 Com�die,9,15,24,2022,01-21,18:59
003 Esplanade,6,26,32,2022,01-21,18:59
004 H�tel de Ville,9,7,16,2022,01-21,18:59
005 Corum,9,3,12,2022,01-21,18:59
006 Place Albert 1er - St Charles,26,5,31,2022,01-21,18:59
007 Foch,2,6,8,2022,01-21,18:59
008 Halles Castellane,2,10,12,2022,01-21,18:59
009 Observatoire,5,3,8,2022,01-21,18:59
010 Rondelet,2,14,16,2022,01-21,18:59
011 Plan Cabanes,1,11,12,2022,01-21,18:59
012 Boutonnet,3,9,12,2022,01-21,18:59
013 Emile Combes,7,1,8,2022,01-21,18:59
014 Beaux-Arts,2,6,8,2022,01-21,18:59
015 Les Aubes,7,1,8,2022,01-21,18:59
016 Antigone centre,11,5,16,2022,01-21,18:59
017 M�diath�que Emile Zola,3,13,16,2022,01-21,18:59
018 Nombre d'Or,13,3,16,2022,01-21,18:59
019 Louis Blanc,16,0,16,2022,01-21,18:59
020 Gambetta,1,7,8,2022,01-21,18:59
021 Port Marianne,16,0,16,2022,01-21,18:59
022 Clemenceau,7,5,12,2022,01-21,18:59
023 Les Arceaux,3,13,16,2022,01-21,18:59
024 Cit� Mion,4,4,8,2022,01-21,18:59
025 Nouveau Saint-Roch,6,2,8,2022,01-21,18:59
026 Renouvier,3,5,8,2022,01-21,18:59
027 Odysseum,4,4,8,2022,01-21,18:59
028 Saint-Denis,8,0,8,2022,01-21,18:59
029 Richter,10,6,16,2022,01-21,18:59
030 Charles Flahault,1,7,8,2022,01-21,18:59
031 Voltaire,4,4,8,2022,01-21,18:59
032 Pr�s d'Ar�nes,1,7,8,2022,01-21,18:59
033 Garcia Lorca,3,5,8,2022,01-21,18:59
034 Vert Bois,0,16,16,2022,01-21,18:59
035 Malbosc,0,8,8,2022,01-21,18:59
036 Occitanie,8,24,32,2022,01-21,18:59
037 FacdesSciences,1,23,24,2022,01-21,18:59
038 Fac de Lettres,0,16,16,2022,01-21,18:59
039 Aiguelongue,2,6,8,2022,01-21,18:59
040 Jeu de Mail des Abb�s,7,1,8,2022,01-21,18:59
041 Eurom�decine,0,8,8,2022,01-21,18:59
042 Marie Caizergues,7,1,8,2022,01-21,18:59
043 Sabines,7,1,8,2022,01-21,18:59
044 Celleneuve,1,7,8,2022,01-21,18:59
045 Jardin de la Lironde,5,3,8,2022,01-21,18:59
046 P�re Soulas,3,5,8,2022,01-21,18:59
047 Place Viala,0,8,8,2022,01-21,18:59
048 H�tel du D�partement,7,1,8,2022,01-21,18:59
049 Tonnelles,3,5,8,2022,01-21,18:59
050 Parvis Jules Ferry - Gare Saint-Roch,5,3,8,2022,01-21,18:59
051 Pont de Lattes - Gare Saint-Roch,0,12,12,2022,01-21,18:59
053 Deux Ponts - Gare Saint-Roch,0,8,8,2022,01-21,18:59
054 Providence - Ovalie,3,5,8,2022,01-21,18:59
055 P�rols Etang de l'Or,27,41,68,2022,01-21,18:59
056 Albert 1er - Cath�drale,5,7,12,2022,01-21,18:59
057 Saint-Guilhem - Courreau,0,8,8,2022,01-21,18:59
059 Sud De France,0,8,8,2022,01-21,18:59
001 Rue Jules Ferry - Gare Saint-Roch,6,6,12,2022,01-21,19:09
002 Com�die,8,16,24,2022,01-21,19:09
003 Esplanade,5,27,32,2022,01-21,19:09
004 H�tel de Ville,9,7,16,2022,01-21,19:09
005 Corum,9,3,12,2022,01-21,19:09
006 Place Albert 1er - St Charles,26,5,31,2022,01-21,19:09
007 Foch,2,6,8,2022,01-21,19:09
008 Halles Castellane,2,10,12,2022,01-21,19:09
009 Observatoire,5,3,8,2022,01-21,19:09
010 Rondelet,2,14,16,2022,01-21,19:09
011 Plan Cabanes,1,11,12,2022,01-21,19:09
012 Boutonnet,4,8,12,2022,01-21,19:09
013 Emile Combes,8,0,8,2022,01-21,19:09
014 Beaux-Arts,2,6,8,2022,01-21,19:09
015 Les Aubes,7,1,8,2022,01-21,19:09
016 Antigone centre,11,5,16,2022,01-21,19:09
017 M�diath�que Emile Zola,3,13,16,2022,01-21,19:09
018 Nombre d'Or,12,4,16,2022,01-21,19:09
019 Louis Blanc,16,0,16,2022,01-21,19:09
020 Gambetta,1,7,8,2022,01-21,19:09
021 Port Marianne,16,0,16,2022,01-21,19:09
022 Clemenceau,7,5,12,2022,01-21,19:09
023 Les Arceaux,3,13,16,2022,01-21,19:09
024 Cit� Mion,3,5,8,2022,01-21,19:09
025 Nouveau Saint-Roch,6,2,8,2022,01-21,19:09
026 Renouvier,3,5,8,2022,01-21,19:09
027 Odysseum,4,4,8,2022,01-21,19:09
028 Saint-Denis,8,0,8,2022,01-21,19:09
029 Richter,10,6,16,2022,01-21,19:09
030 Charles Flahault,1,7,8,2022,01-21,19:09
031 Voltaire,4,4,8,2022,01-21,19:09
032 Pr�s d'Ar�nes,1,7,8,2022,01-21,19:09
033 Garcia Lorca,3,5,8,2022,01-21,19:09
034 Vert Bois,0,16,16,2022,01-21,19:09
035 Malbosc,0,8,8,2022,01-21,19:09
036 Occitanie,7,25,32,2022,01-21,19:09
037 FacdesSciences,0,24,24,2022,01-21,19:09
038 Fac de Lettres,0,16,16,2022,01-21,19:09
039 Aiguelongue,2,6,8,2022,01-21,19:09
040 Jeu de Mail des Abb�s,7,1,8,2022,01-21,19:09
041 Eurom�decine,0,8,8,2022,01-21,19:09
042 Marie Caizergues,7,1,8,2022,01-21,19:09
043 Sabines,7,1,8,2022,01-21,19:09
044 Celleneuve,1,7,8,2022,01-21,19:09
045 Jardin de la Lironde,5,3,8,2022,01-21,19:09
046 P�re Soulas,3,5,8,2022,01-21,19:09
047 Place Viala,0,8,8,2022,01-21,19:09
048 H�tel du D�partement,7,1,8,2022,01-21,19:09
049 Tonnelles,3,5,8,2022,01-21,19:09
050 Parvis Jules Ferry - Gare Saint-Roch,5,3,8,2022,01-21,19:09
051 Pont de Lattes - Gare Saint-Roch,0,12,12,2022,01-21,19:09
053 Deux Ponts - Gare Saint-Roch,0,8,8,2022,01-21,19:09
054 Providence - Ovalie,3,5,8,2022,01-21,19:09
055 P�rols Etang de l'Or,27,41,68,2022,01-21,19:09
056 Albert 1er - Cath�drale,5,7,12,2022,01-21,19:09
057 Saint-Guilhem - Courreau,0,8,8,2022,01-21,19:09
059 Sud De France,0,8,8,2022,01-21,19:09
001 Rue Jules Ferry - Gare Saint-Roch,7,5,12,2022,01-21,19:20
002 Com�die,8,16,24,2022,01-21,19:20
003 Esplanade,3,29,32,2022,01-21,19:20
004 H�tel de Ville,9,7,16,2022,01-21,19:20
005 Corum,9,3,12,2022,01-21,19:20
006 Place Albert 1er - St Charles,29,2,31,2022,01-21,19:20
007 Foch,2,6,8,2022,01-21,19:20
008 Halles Castellane,2,10,12,2022,01-21,19:20
009 Observatoire,5,3,8,2022,01-21,19:20
010 Rondelet,2,14,16,2022,01-21,19:20
011 Plan Cabanes,1,11,12,2022,01-21,19:20
012 Boutonnet,4,8,12,2022,01-21,19:20
013 Emile Combes,8,0,8,2022,01-21,19:20
014 Beaux-Arts,2,6,8,2022,01-21,19:20
015 Les Aubes,7,1,8,2022,01-21,19:20
016 Antigone centre,11,5,16,2022,01-21,19:20
017 M�diath�que Emile Zola,3,13,16,2022,01-21,19:20
018 Nombre d'Or,12,4,16,2022,01-21,19:20
019 Louis Blanc,13,3,16,2022,01-21,19:20
020 Gambetta,1,7,8,2022,01-21,19:20
021 Port Marianne,16,0,16,2022,01-21,19:20
022 Clemenceau,7,5,12,2022,01-21,19:20
023 Les Arceaux,3,13,16,2022,01-21,19:20
024 Cit� Mion,3,5,8,2022,01-21,19:20
025 Nouveau Saint-Roch,6,2,8,2022,01-21,19:20
026 Renouvier,3,5,8,2022,01-21,19:20
027 Odysseum,4,4,8,2022,01-21,19:20
028 Saint-Denis,8,0,8,2022,01-21,19:20
029 Richter,10,6,16,2022,01-21,19:20
030 Charles Flahault,1,7,8,2022,01-21,19:20
031 Voltaire,4,4,8,2022,01-21,19:20
032 Pr�s d'Ar�nes,1,7,8,2022,01-21,19:20
033 Garcia Lorca,3,5,8,2022,01-21,19:20
034 Vert Bois,0,16,16,2022,01-21,19:20
035 Malbosc,0,8,8,2022,01-21,19:20
036 Occitanie,7,25,32,2022,01-21,19:20
037 FacdesSciences,0,24,24,2022,01-21,19:20
038 Fac de Lettres,0,16,16,2022,01-21,19:20
039 Aiguelongue,2,6,8,2022,01-21,19:20
040 Jeu de Mail des Abb�s,7,1,8,2022,01-21,19:20
041 Eurom�decine,0,8,8,2022,01-21,19:20
042 Marie Caizergues,7,1,8,2022,01-21,19:20
043 Sabines,7,1,8,2022,01-21,19:20
044 Celleneuve,1,7,8,2022,01-21,19:20
045 Jardin de la Lironde,5,3,8,2022,01-21,19:20
046 P�re Soulas,3,5,8,2022,01-21,19:20
047 Place Viala,0,8,8,2022,01-21,19:20
048 H�tel du D�partement,7,1,8,2022,01-21,19:20
049 Tonnelles,3,5,8,2022,01-21,19:20
050 Parvis Jules Ferry - Gare Saint-Roch,5,3,8,2022,01-21,19:20
051 Pont de Lattes - Gare Saint-Roch,0,12,12,2022,01-21,19:20
053 Deux Ponts - Gare Saint-Roch,0,8,8,2022,01-21,19:20
054 Providence - Ovalie,3,5,8,2022,01-21,19:20
055 P�rols Etang de l'Or,27,41,68,2022,01-21,19:20
056 Albert 1er - Cath�drale,5,7,12,2022,01-21,19:20
057 Saint-Guilhem - Courreau,0,8,8,2022,01-21,19:20
059 Sud De France,0,8,8,2022,01-21,19:20
001 Rue Jules Ferry - Gare Saint-Roch,6,6,12,2022,01-21,19:30
002 Com�die,7,17,24,2022,01-21,19:30
003 Esplanade,3,29,32,2022,01-21,19:30
004 H�tel de Ville,9,7,16,2022,01-21,19:30
005 Corum,9,3,12,2022,01-21,19:30
006 Place Albert 1er - St Charles,29,2,31,2022,01-21,19:30
007 Foch,2,6,8,2022,01-21,19:30
008 Halles Castellane,2,10,12,2022,01-21,19:30
009 Observatoire,5,3,8,2022,01-21,19:30
010 Rondelet,2,14,16,2022,01-21,19:30
011 Plan Cabanes,1,11,12,2022,01-21,19:30
012 Boutonnet,4,8,12,2022,01-21,19:30
013 Emile Combes,8,0,8,2022,01-21,19:30
014 Beaux-Arts,0,8,8,2022,01-21,19:30
015 Les Aubes,7,1,8,2022,01-21,19:30
016 Antigone centre,11,5,16,2022,01-21,19:30
017 M�diath�que Emile Zola,3,13,16,2022,01-21,19:30
018 Nombre d'Or,12,4,16,2022,01-21,19:30
019 Louis Blanc,15,1,16,2022,01-21,19:30
020 Gambetta,1,7,8,2022,01-21,19:30
021 Port Marianne,16,0,16,2022,01-21,19:30
022 Clemenceau,7,5,12,2022,01-21,19:30
023 Les Arceaux,3,13,16,2022,01-21,19:30
024 Cit� Mion,4,4,8,2022,01-21,19:30
025 Nouveau Saint-Roch,6,2,8,2022,01-21,19:30
026 Renouvier,3,5,8,2022,01-21,19:30
027 Odysseum,4,4,8,2022,01-21,19:30
028 Saint-Denis,8,0,8,2022,01-21,19:30
029 Richter,10,6,16,2022,01-21,19:30
030 Charles Flahault,1,7,8,2022,01-21,19:30
031 Voltaire,4,4,8,2022,01-21,19:30
032 Pr�s d'Ar�nes,1,7,8,2022,01-21,19:30
033 Garcia Lorca,2,6,8,2022,01-21,19:30
034 Vert Bois,0,16,16,2022,01-21,19:30
035 Malbosc,0,8,8,2022,01-21,19:30
036 Occitanie,7,25,32,2022,01-21,19:30
037 FacdesSciences,0,24,24,2022,01-21,19:30
038 Fac de Lettres,0,16,16,2022,01-21,19:30
039 Aiguelongue,2,6,8,2022,01-21,19:30
040 Jeu de Mail des Abb�s,7,1,8,2022,01-21,19:30
041 Eurom�decine,0,8,8,2022,01-21,19:30
042 Marie Caizergues,8,0,8,2022,01-21,19:30
043 Sabines,7,1,8,2022,01-21,19:30
044 Celleneuve,1,7,8,2022,01-21,19:30
045 Jardin de la Lironde,5,3,8,2022,01-21,19:30
046 P�re Soulas,3,5,8,2022,01-21,19:30
047 Place Viala,0,8,8,2022,01-21,19:30
048 H�tel du D�partement,7,1,8,2022,01-21,19:30
049 Tonnelles,3,5,8,2022,01-21,19:30
050 Parvis Jules Ferry - Gare Saint-Roch,5,3,8,2022,01-21,19:30
051 Pont de Lattes - Gare Saint-Roch,0,12,12,2022,01-21,19:30
053 Deux Ponts - Gare Saint-Roch,0,8,8,2022,01-21,19:30
054 Providence - Ovalie,3,5,8,2022,01-21,19:30
055 P�rols Etang de l'Or,27,41,68,2022,01-21,19:30
056 Albert 1er - Cath�drale,5,7,12,2022,01-21,19:30
057 Saint-Guilhem - Courreau,0,8,8,2022,01-21,19:30
059 Sud De France,0,8,8,2022,01-21,19:30
001 Rue Jules Ferry - Gare Saint-Roch,6,6,12,2022,01-21,19:40
002 Com�die,7,17,24,2022,01-21,19:40
003 Esplanade,3,29,32,2022,01-21,19:40
004 H�tel de Ville,9,7,16,2022,01-21,19:40
005 Corum,9,3,12,2022,01-21,19:40
006 Place Albert 1er - St Charles,28,3,31,2022,01-21,19:40
007 Foch,2,6,8,2022,01-21,19:40
008 Halles Castellane,2,10,12,2022,01-21,19:40
009 Observatoire,5,3,8,2022,01-21,19:40
010 Rondelet,2,14,16,2022,01-21,19:40
011 Plan Cabanes,2,10,12,2022,01-21,19:40
012 Boutonnet,5,7,12,2022,01-21,19:40
013 Emile Combes,8,0,8,2022,01-21,19:40
014 Beaux-Arts,0,8,8,2022,01-21,19:40
015 Les Aubes,7,1,8,2022,01-21,19:40
016 Antigone centre,11,5,16,2022,01-21,19:40
017 M�diath�que Emile Zola,3,13,16,2022,01-21,19:40
018 Nombre d'Or,13,3,16,2022,01-21,19:40
019 Louis Blanc,15,1,16,2022,01-21,19:40
020 Gambetta,1,7,8,2022,01-21,19:40
021 Port Marianne,16,0,16,2022,01-21,19:40
022 Clemenceau,7,5,12,2022,01-21,19:40
023 Les Arceaux,2,14,16,2022,01-21,19:40
024 Cit� Mion,4,4,8,2022,01-21,19:40
025 Nouveau Saint-Roch,6,2,8,2022,01-21,19:40
026 Renouvier,3,5,8,2022,01-21,19:40
027 Odysseum,4,4,8,2022,01-21,19:40
028 Saint-Denis,7,1,8,2022,01-21,19:40
029 Richter,11,5,16,2022,01-21,19:40
030 Charles Flahault,1,7,8,2022,01-21,19:40
031 Voltaire,4,4,8,2022,01-21,19:40
032 Pr�s d'Ar�nes,1,7,8,2022,01-21,19:40
033 Garcia Lorca,2,6,8,2022,01-21,19:40
034 Vert Bois,0,16,16,2022,01-21,19:40
035 Malbosc,0,8,8,2022,01-21,19:40
036 Occitanie,8,24,32,2022,01-21,19:40
037 FacdesSciences,1,23,24,2022,01-21,19:40
038 Fac de Lettres,0,16,16,2022,01-21,19:40
039 Aiguelongue,2,6,8,2022,01-21,19:40
040 Jeu de Mail des Abb�s,7,1,8,2022,01-21,19:40
041 Eurom�decine,0,8,8,2022,01-21,19:40
042 Marie Caizergues,8,0,8,2022,01-21,19:40
043 Sabines,7,1,8,2022,01-21,19:40
044 Celleneuve,1,7,8,2022,01-21,19:40
045 Jardin de la Lironde,5,3,8,2022,01-21,19:40
046 P�re Soulas,3,5,8,2022,01-21,19:40
047 Place Viala,0,8,8,2022,01-21,19:40
048 H�tel du D�partement,7,1,8,2022,01-21,19:40
049 Tonnelles,3,5,8,2022,01-21,19:40
050 Parvis Jules Ferry - Gare Saint-Roch,5,3,8,2022,01-21,19:40
051 Pont de Lattes - Gare Saint-Roch,0,12,12,2022,01-21,19:40
053 Deux Ponts - Gare Saint-Roch,0,8,8,2022,01-21,19:40
054 Providence - Ovalie,3,5,8,2022,01-21,19:40
055 P�rols Etang de l'Or,27,41,68,2022,01-21,19:40
056 Albert 1er - Cath�drale,5,7,12,2022,01-21,19:40
057 Saint-Guilhem - Courreau,0,8,8,2022,01-21,19:40
059 Sud De France,0,8,8,2022,01-21,19:40
001 Rue Jules Ferry - Gare Saint-Roch,6,6,12,2022,01-21,19:50
002 Com�die,7,17,24,2022,01-21,19:50
003 Esplanade,3,29,32,2022,01-21,19:50
004 H�tel de Ville,9,7,16,2022,01-21,19:50
005 Corum,9,3,12,2022,01-21,19:50
006 Place Albert 1er - St Charles,28,3,31,2022,01-21,19:50
007 Foch,2,6,8,2022,01-21,19:50
008 Halles Castellane,2,10,12,2022,01-21,19:50
009 Observatoire,5,3,8,2022,01-21,19:50
010 Rondelet,2,14,16,2022,01-21,19:50
011 Plan Cabanes,1,11,12,2022,01-21,19:50
012 Boutonnet,5,7,12,2022,01-21,19:50
013 Emile Combes,8,0,8,2022,01-21,19:50
014 Beaux-Arts,0,8,8,2022,01-21,19:50
015 Les Aubes,7,1,8,2022,01-21,19:50
016 Antigone centre,11,5,16,2022,01-21,19:50
017 M�diath�que Emile Zola,3,13,16,2022,01-21,19:50
018 Nombre d'Or,13,3,16,2022,01-21,19:50
019 Louis Blanc,15,1,16,2022,01-21,19:50
020 Gambetta,1,7,8,2022,01-21,19:50
021 Port Marianne,16,0,16,2022,01-21,19:50
022 Clemenceau,7,5,12,2022,01-21,19:50
023 Les Arceaux,2,14,16,2022,01-21,19:50
024 Cit� Mion,4,4,8,2022,01-21,19:50
025 Nouveau Saint-Roch,6,2,8,2022,01-21,19:50
026 Renouvier,3,5,8,2022,01-21,19:50
027 Odysseum,4,4,8,2022,01-21,19:50
028 Saint-Denis,6,2,8,2022,01-21,19:50
029 Richter,11,5,16,2022,01-21,19:50
030 Charles Flahault,0,8,8,2022,01-21,19:50
031 Voltaire,5,3,8,2022,01-21,19:50
032 Pr�s d'Ar�nes,1,7,8,2022,01-21,19:50
033 Garcia Lorca,2,6,8,2022,01-21,19:50
034 Vert Bois,0,16,16,2022,01-21,19:50
035 Malbosc,0,8,8,2022,01-21,19:50
036 Occitanie,8,24,32,2022,01-21,19:50
037 FacdesSciences,1,23,24,2022,01-21,19:50
038 Fac de Lettres,0,16,16,2022,01-21,19:50
039 Aiguelongue,2,6,8,2022,01-21,19:50
040 Jeu de Mail des Abb�s,6,2,8,2022,01-21,19:50
041 Eurom�decine,0,8,8,2022,01-21,19:50
042 Marie Caizergues,8,0,8,2022,01-21,19:50
043 Sabines,7,1,8,2022,01-21,19:50
044 Celleneuve,1,7,8,2022,01-21,19:50
045 Jardin de la Lironde,5,3,8,2022,01-21,19:50
046 P�re Soulas,3,5,8,2022,01-21,19:50
047 Place Viala,0,8,8,2022,01-21,19:50
048 H�tel du D�partement,7,1,8,2022,01-21,19:50
049 Tonnelles,3,5,8,2022,01-21,19:50
050 Parvis Jules Ferry - Gare Saint-Roch,5,3,8,2022,01-21,19:50
051 Pont de Lattes - Gare Saint-Roch,0,12,12,2022,01-21,19:50
053 Deux Ponts - Gare Saint-Roch,0,8,8,2022,01-21,19:50
054 Providence - Ovalie,3,5,8,2022,01-21,19:50
055 P�rols Etang de l'Or,27,41,68,2022,01-21,19:50
056 Albert 1er - Cath�drale,6,6,12,2022,01-21,19:50
057 Saint-Guilhem - Courreau,0,8,8,2022,01-21,19:50
059 Sud De France,0,8,8,2022,01-21,19:50
001 Rue Jules Ferry - Gare Saint-Roch,6,6,12,2022,01-21,20:00
002 Com�die,7,17,24,2022,01-21,20:00
003 Esplanade,3,29,32,2022,01-21,20:00
004 H�tel de Ville,9,7,16,2022,01-21,20:00
005 Corum,8,4,12,2022,01-21,20:00
006 Place Albert 1er - St Charles,27,4,31,2022,01-21,20:00
007 Foch,2,6,8,2022,01-21,20:00
008 Halles Castellane,2,10,12,2022,01-21,20:00
009 Observatoire,5,3,8,2022,01-21,20:00
010 Rondelet,2,14,16,2022,01-21,20:00
011 Plan Cabanes,2,10,12,2022,01-21,20:00
012 Boutonnet,6,6,12,2022,01-21,20:00
013 Emile Combes,8,0,8,2022,01-21,20:00
014 Beaux-Arts,0,8,8,2022,01-21,20:00
015 Les Aubes,7,1,8,2022,01-21,20:00
016 Antigone centre,11,5,16,2022,01-21,20:00
017 M�diath�que Emile Zola,4,12,16,2022,01-21,20:00
018 Nombre d'Or,13,3,16,2022,01-21,20:00
019 Louis Blanc,16,0,16,2022,01-21,20:00
020 Gambetta,1,7,8,2022,01-21,20:00
021 Port Marianne,16,0,16,2022,01-21,20:00
022 Clemenceau,7,5,12,2022,01-21,20:00
023 Les Arceaux,3,13,16,2022,01-21,20:00
024 Cit� Mion,4,4,8,2022,01-21,20:00
025 Nouveau Saint-Roch,5,3,8,2022,01-21,20:00
026 Renouvier,3,5,8,2022,01-21,20:00
027 Odysseum,4,4,8,2022,01-21,20:00
028 Saint-Denis,6,2,8,2022,01-21,20:00
029 Richter,11,5,16,2022,01-21,20:00
030 Charles Flahault,0,8,8,2022,01-21,20:00
031 Voltaire,5,3,8,2022,01-21,20:00
032 Pr�s d'Ar�nes,1,7,8,2022,01-21,20:00
033 Garcia Lorca,2,6,8,2022,01-21,20:00
034 Vert Bois,0,16,16,2022,01-21,20:00
035 Malbosc,0,8,8,2022,01-21,20:00
036 Occitanie,8,24,32,2022,01-21,20:00
037 FacdesSciences,1,23,24,2022,01-21,20:00
038 Fac de Lettres,0,16,16,2022,01-21,20:00
039 Aiguelongue,2,6,8,2022,01-21,20:00
040 Jeu de Mail des Abb�s,6,2,8,2022,01-21,20:00
041 Eurom�decine,0,8,8,2022,01-21,20:00
042 Marie Caizergues,8,0,8,2022,01-21,20:00
043 Sabines,7,1,8,2022,01-21,20:00
044 Celleneuve,1,7,8,2022,01-21,20:00
045 Jardin de la Lironde,5,3,8,2022,01-21,20:00
046 P�re Soulas,2,6,8,2022,01-21,20:00
047 Place Viala,0,8,8,2022,01-21,20:00
048 H�tel du D�partement,7,1,8,2022,01-21,20:00
049 Tonnelles,3,5,8,2022,01-21,20:00
050 Parvis Jules Ferry - Gare Saint-Roch,5,3,8,2022,01-21,20:00
051 Pont de Lattes - Gare Saint-Roch,0,12,12,2022,01-21,20:00
053 Deux Ponts - Gare Saint-Roch,0,8,8,2022,01-21,20:00
054 Providence - Ovalie,3,5,8,2022,01-21,20:00
055 P�rols Etang de l'Or,27,41,68,2022,01-21,20:00
056 Albert 1er - Cath�drale,6,6,12,2022,01-21,20:00
057 Saint-Guilhem - Courreau,0,8,8,2022,01-21,20:00
059 Sud De France,0,8,8,2022,01-21,20:00
001 Rue Jules Ferry - Gare Saint-Roch,6,6,12,2022,01-21,20:11
002 Com�die,7,17,24,2022,01-21,20:11
003 Esplanade,3,29,32,2022,01-21,20:11
004 H�tel de Ville,9,7,16,2022,01-21,20:11
005 Corum,9,3,12,2022,01-21,20:11
006 Place Albert 1er - St Charles,27,4,31,2022,01-21,20:11
007 Foch,2,6,8,2022,01-21,20:11
008 Halles Castellane,2,10,12,2022,01-21,20:11
009 Observatoire,5,3,8,2022,01-21,20:11
010 Rondelet,2,14,16,2022,01-21,20:11
011 Plan Cabanes,2,10,12,2022,01-21,20:11
012 Boutonnet,6,6,12,2022,01-21,20:11
013 Emile Combes,8,0,8,2022,01-21,20:11
014 Beaux-Arts,0,8,8,2022,01-21,20:11
015 Les Aubes,7,1,8,2022,01-21,20:11
016 Antigone centre,11,5,16,2022,01-21,20:11
017 M�diath�que Emile Zola,4,12,16,2022,01-21,20:11
018 Nombre d'Or,13,3,16,2022,01-21,20:11
019 Louis Blanc,16,0,16,2022,01-21,20:11
020 Gambetta,1,7,8,2022,01-21,20:11
021 Port Marianne,16,0,16,2022,01-21,20:11
022 Clemenceau,7,5,12,2022,01-21,20:11
023 Les Arceaux,3,13,16,2022,01-21,20:11
024 Cit� Mion,4,4,8,2022,01-21,20:11
025 Nouveau Saint-Roch,5,3,8,2022,01-21,20:11
026 Renouvier,3,5,8,2022,01-21,20:11
027 Odysseum,4,4,8,2022,01-21,20:11
028 Saint-Denis,6,2,8,2022,01-21,20:11
029 Richter,9,7,16,2022,01-21,20:11
030 Charles Flahault,0,8,8,2022,01-21,20:11
031 Voltaire,5,3,8,2022,01-21,20:11
032 Pr�s d'Ar�nes,1,7,8,2022,01-21,20:11
033 Garcia Lorca,2,6,8,2022,01-21,20:11
034 Vert Bois,0,16,16,2022,01-21,20:11
035 Malbosc,0,8,8,2022,01-21,20:11
036 Occitanie,7,25,32,2022,01-21,20:11
037 FacdesSciences,1,23,24,2022,01-21,20:11
038 Fac de Lettres,0,16,16,2022,01-21,20:11
039 Aiguelongue,2,6,8,2022,01-21,20:11
040 Jeu de Mail des Abb�s,6,2,8,2022,01-21,20:11
041 Eurom�decine,0,8,8,2022,01-21,20:11
042 Marie Caizergues,8,0,8,2022,01-21,20:11
043 Sabines,7,1,8,2022,01-21,20:11
044 Celleneuve,1,7,8,2022,01-21,20:11
045 Jardin de la Lironde,5,3,8,2022,01-21,20:11
046 P�re Soulas,2,6,8,2022,01-21,20:11
047 Place Viala,0,8,8,2022,01-21,20:11
048 H�tel du D�partement,7,1,8,2022,01-21,20:11
049 Tonnelles,3,5,8,2022,01-21,20:11
050 Parvis Jules Ferry - Gare Saint-Roch,5,3,8,2022,01-21,20:11
051 Pont de Lattes - Gare Saint-Roch,0,12,12,2022,01-21,20:11
053 Deux Ponts - Gare Saint-Roch,0,8,8,2022,01-21,20:11
054 Providence - Ovalie,3,5,8,2022,01-21,20:11
055 P�rols Etang de l'Or,27,41,68,2022,01-21,20:11
056 Albert 1er - Cath�drale,5,7,12,2022,01-21,20:11
057 Saint-Guilhem - Courreau,0,8,8,2022,01-21,20:11
059 Sud De France,0,8,8,2022,01-21,20:11
00-00,00-00,00-00,00-00,00-00,00-00,00-00